dateday,year,month,hr,holiday,weekday,workingday,casual,registered,count
2011-01-01,0,Jan,0,0,Sat,0,3,13,16
2011-01-01,0,Jan,1,0,Sat,0,8,32,40
2011-01-01,0,Jan,2,0,Sat,0,5,27,32
2011-01-01,0,Jan,3,0,Sat,0,3,10,13
2011-01-01,0,Jan,4,0,Sat,0,0,1,1
2011-01-01,0,Jan,5,0,Sat,0,0,1,1
2011-01-01,0,Jan,6,0,Sat,0,2,0,2
2011-01-01,0,Jan,7,0,Sat,0,1,2,3
2011-01-01,0,Jan,8,0,Sat,0,1,7,8
2011-01-01,0,Jan,9,0,Sat,0,8,6,14
2011-01-01,0,Jan,10,0,Sat,0,12,24,36
2011-01-01,0,Jan,11,0,Sat,0,26,30,56
2011-01-01,0,Jan,12,0,Sat,0,29,55,84
2011-01-01,0,Jan,13,0,Sat,0,47,47,94
2011-01-01,0,Jan,14,0,Sat,0,35,71,106
2011-01-01,0,Jan,15,0,Sat,0,40,70,110
2011-01-01,0,Jan,16,0,Sat,0,41,52,93
2011-01-01,0,Jan,17,0,Sat,0,15,52,67
2011-01-01,0,Jan,18,0,Sat,0,9,26,35
2011-01-01,0,Jan,19,0,Sat,0,6,31,37
2011-01-01,0,Jan,20,0,Sat,0,11,25,36
2011-01-01,0,Jan,21,0,Sat,0,3,31,34
2011-01-01,0,Jan,22,0,Sat,0,11,17,28
2011-01-01,0,Jan,23,0,Sat,0,15,24,39
2011-01-02,0,Jan,0,0,Sun,0,4,13,17
2011-01-02,0,Jan,1,0,Sun,0,1,16,17
2011-01-02,0,Jan,2,0,Sun,0,1,8,9
2011-01-02,0,Jan,3,0,Sun,0,2,4,6
2011-01-02,0,Jan,4,0,Sun,0,2,1,3
2011-01-02,0,Jan,6,0,Sun,0,0,2,2
2011-01-02,0,Jan,7,0,Sun,0,0,1,1
2011-01-02,0,Jan,8,0,Sun,0,0,8,8
2011-01-02,0,Jan,9,0,Sun,0,1,19,20
2011-01-02,0,Jan,10,0,Sun,0,7,46,53
2011-01-02,0,Jan,11,0,Sun,0,16,54,70
2011-01-02,0,Jan,12,0,Sun,0,20,73,93
2011-01-02,0,Jan,13,0,Sun,0,11,64,75
2011-01-02,0,Jan,14,0,Sun,0,4,55,59
2011-01-02,0,Jan,15,0,Sun,0,19,55,74
2011-01-02,0,Jan,16,0,Sun,0,9,67,76
2011-01-02,0,Jan,17,0,Sun,0,7,58,65
2011-01-02,0,Jan,18,0,Sun,0,10,43,53
2011-01-02,0,Jan,19,0,Sun,0,1,29,30
2011-01-02,0,Jan,20,0,Sun,0,5,17,22
2011-01-02,0,Jan,21,0,Sun,0,11,20,31
2011-01-02,0,Jan,22,0,Sun,0,0,9,9
2011-01-02,0,Jan,23,0,Sun,0,0,8,8
2011-01-03,0,Jan,0,0,Mon,1,0,5,5
2011-01-03,0,Jan,1,0,Mon,1,0,2,2
2011-01-03,0,Jan,4,0,Mon,1,0,1,1
2011-01-03,0,Jan,5,0,Mon,1,0,3,3
2011-01-03,0,Jan,6,0,Mon,1,0,30,30
2011-01-03,0,Jan,7,0,Mon,1,1,63,64
2011-01-03,0,Jan,8,0,Mon,1,1,153,154
2011-01-03,0,Jan,9,0,Mon,1,7,81,88
2011-01-03,0,Jan,10,0,Mon,1,11,33,44
2011-01-03,0,Jan,11,0,Mon,1,10,41,51
2011-01-03,0,Jan,12,0,Mon,1,13,48,61
2011-01-03,0,Jan,13,0,Mon,1,8,53,61
2011-01-03,0,Jan,14,0,Mon,1,11,66,77
2011-01-03,0,Jan,15,0,Mon,1,14,58,72
2011-01-03,0,Jan,16,0,Mon,1,9,67,76
2011-01-03,0,Jan,17,0,Mon,1,11,146,157
2011-01-03,0,Jan,18,0,Mon,1,9,148,157
2011-01-03,0,Jan,19,0,Mon,1,8,102,110
2011-01-03,0,Jan,20,0,Mon,1,3,49,52
2011-01-03,0,Jan,21,0,Mon,1,3,49,52
2011-01-03,0,Jan,22,0,Mon,1,0,20,20
2011-01-03,0,Jan,23,0,Mon,1,1,11,12
2011-01-04,0,Jan,0,0,Tue,1,0,5,5
2011-01-04,0,Jan,1,0,Tue,1,0,2,2
2011-01-04,0,Jan,2,0,Tue,1,0,1,1
2011-01-04,0,Jan,4,0,Tue,1,0,2,2
2011-01-04,0,Jan,5,0,Tue,1,0,4,4
2011-01-04,0,Jan,6,0,Tue,1,0,36,36
2011-01-04,0,Jan,7,0,Tue,1,2,92,94
2011-01-04,0,Jan,8,0,Tue,1,2,177,179
2011-01-04,0,Jan,9,0,Tue,1,2,98,100
2011-01-04,0,Jan,10,0,Tue,1,5,37,42
2011-01-04,0,Jan,11,0,Tue,1,7,50,57
2011-01-04,0,Jan,12,0,Tue,1,12,66,78
2011-01-04,0,Jan,13,0,Tue,1,18,79,97
2011-01-04,0,Jan,14,0,Tue,1,9,54,63
2011-01-04,0,Jan,15,0,Tue,1,17,48,65
2011-01-04,0,Jan,16,0,Tue,1,15,68,83
2011-01-04,0,Jan,17,0,Tue,1,10,202,212
2011-01-04,0,Jan,18,0,Tue,1,3,179,182
2011-01-04,0,Jan,19,0,Tue,1,2,110,112
2011-01-04,0,Jan,20,0,Tue,1,1,53,54
2011-01-04,0,Jan,21,0,Tue,1,0,48,48
2011-01-04,0,Jan,22,0,Tue,1,1,34,35
2011-01-04,0,Jan,23,0,Tue,1,2,9,11
2011-01-05,0,Jan,0,0,Wed,1,0,6,6
2011-01-05,0,Jan,1,0,Wed,1,0,6,6
2011-01-05,0,Jan,2,0,Wed,1,0,2,2
2011-01-05,0,Jan,4,0,Wed,1,0,2,2
2011-01-05,0,Jan,5,0,Wed,1,0,3,3
2011-01-05,0,Jan,6,0,Wed,1,0,33,33
2011-01-05,0,Jan,7,0,Wed,1,1,87,88
2011-01-05,0,Jan,8,0,Wed,1,3,192,195
2011-01-05,0,Jan,9,0,Wed,1,6,109,115
2011-01-05,0,Jan,10,0,Wed,1,4,53,57
2011-01-05,0,Jan,11,0,Wed,1,12,34,46
2011-01-05,0,Jan,12,0,Wed,1,5,74,79
2011-01-05,0,Jan,13,0,Wed,1,6,65,71
2011-01-05,0,Jan,14,0,Wed,1,10,52,62
2011-01-05,0,Jan,15,0,Wed,1,7,55,62
2011-01-05,0,Jan,16,0,Wed,1,4,85,89
2011-01-05,0,Jan,17,0,Wed,1,4,186,190
2011-01-05,0,Jan,18,0,Wed,1,3,166,169
2011-01-05,0,Jan,19,0,Wed,1,5,127,132
2011-01-05,0,Jan,20,0,Wed,1,7,82,89
2011-01-05,0,Jan,21,0,Wed,1,3,40,43
2011-01-05,0,Jan,22,0,Wed,1,1,41,42
2011-01-05,0,Jan,23,0,Wed,1,1,18,19
2011-01-06,0,Jan,0,0,Thur,1,0,11,11
2011-01-06,0,Jan,1,0,Thur,1,0,4,4
2011-01-06,0,Jan,2,0,Thur,1,0,2,2
2011-01-06,0,Jan,4,0,Thur,1,0,1,1
2011-01-06,0,Jan,5,0,Thur,1,0,4,4
2011-01-06,0,Jan,6,0,Thur,1,0,36,36
2011-01-06,0,Jan,7,0,Thur,1,0,95,95
2011-01-06,0,Jan,8,0,Thur,1,3,216,219
2011-01-06,0,Jan,9,0,Thur,1,6,116,122
2011-01-06,0,Jan,10,0,Thur,1,3,42,45
2011-01-06,0,Jan,11,0,Thur,1,2,57,59
2011-01-06,0,Jan,12,0,Thur,1,6,78,84
2011-01-06,0,Jan,13,0,Thur,1,12,55,67
2011-01-06,0,Jan,14,0,Thur,1,11,59,70
2011-01-06,0,Jan,15,0,Thur,1,8,54,62
2011-01-06,0,Jan,16,0,Thur,1,12,74,86
2011-01-06,0,Jan,17,0,Thur,1,9,163,172
2011-01-06,0,Jan,18,0,Thur,1,5,158,163
2011-01-06,0,Jan,19,0,Thur,1,3,109,112
2011-01-06,0,Jan,20,0,Thur,1,3,66,69
2011-01-06,0,Jan,21,0,Thur,1,0,48,48
2011-01-06,0,Jan,22,0,Thur,1,1,51,52
2011-01-06,0,Jan,23,0,Thur,1,4,19,23
2011-01-07,0,Jan,0,0,Fri,1,4,13,17
2011-01-07,0,Jan,1,0,Fri,1,2,5,7
2011-01-07,0,Jan,2,0,Fri,1,0,1,1
2011-01-07,0,Jan,4,0,Fri,1,0,1,1
2011-01-07,0,Jan,5,0,Fri,1,0,5,5
2011-01-07,0,Jan,6,0,Fri,1,8,26,34
2011-01-07,0,Jan,7,0,Fri,1,8,76,84
2011-01-07,0,Jan,8,0,Fri,1,20,190,210
2011-01-07,0,Jan,9,0,Fri,1,9,125,134
2011-01-07,0,Jan,10,0,Fri,1,16,47,63
2011-01-07,0,Jan,11,0,Fri,1,19,48,67
2011-01-07,0,Jan,12,0,Fri,1,9,50,59
2011-01-07,0,Jan,13,0,Fri,1,9,64,73
2011-01-07,0,Jan,14,0,Fri,1,7,43,50
2011-01-07,0,Jan,15,0,Fri,1,9,63,72
2011-01-07,0,Jan,16,0,Fri,1,5,82,87
2011-01-07,0,Jan,17,0,Fri,1,9,178,187
2011-01-07,0,Jan,18,0,Fri,1,7,116,123
2011-01-07,0,Jan,19,0,Fri,1,3,92,95
2011-01-07,0,Jan,20,0,Fri,1,1,50,51
2011-01-07,0,Jan,21,0,Fri,1,0,39,39
2011-01-07,0,Jan,22,0,Fri,1,2,34,36
2011-01-07,0,Jan,23,0,Fri,1,1,14,15
2011-01-08,0,Jan,0,0,Sat,0,1,24,25
2011-01-08,0,Jan,1,0,Sat,0,1,15,16
2011-01-08,0,Jan,2,0,Sat,0,3,13,16
2011-01-08,0,Jan,3,0,Sat,0,0,7,7
2011-01-08,0,Jan,4,0,Sat,0,0,1,1
2011-01-08,0,Jan,5,0,Sat,0,0,5,5
2011-01-08,0,Jan,6,0,Sat,0,0,2,2
2011-01-08,0,Jan,7,0,Sat,0,1,8,9
2011-01-08,0,Jan,8,0,Sat,0,0,15,15
2011-01-08,0,Jan,9,0,Sat,0,0,20,20
2011-01-08,0,Jan,10,0,Sat,0,5,56,61
2011-01-08,0,Jan,11,0,Sat,0,2,60,62
2011-01-08,0,Jan,12,0,Sat,0,8,90,98
2011-01-08,0,Jan,13,0,Sat,0,7,95,102
2011-01-08,0,Jan,14,0,Sat,0,12,83,95
2011-01-08,0,Jan,15,0,Sat,0,5,69,74
2011-01-08,0,Jan,16,0,Sat,0,8,68,76
2011-01-08,0,Jan,17,0,Sat,0,5,64,69
2011-01-08,0,Jan,18,0,Sat,0,3,52,55
2011-01-08,0,Jan,19,0,Sat,0,4,26,30
2011-01-08,0,Jan,20,0,Sat,0,0,28,28
2011-01-08,0,Jan,21,0,Sat,0,2,35,37
2011-01-08,0,Jan,22,0,Sat,0,1,33,34
2011-01-08,0,Jan,23,0,Sat,0,0,22,22
2011-01-09,0,Jan,0,0,Sun,0,1,24,25
2011-01-09,0,Jan,1,0,Sun,0,0,12,12
2011-01-09,0,Jan,2,0,Sun,0,0,11,11
2011-01-09,0,Jan,3,0,Sun,0,0,4,4
2011-01-09,0,Jan,4,0,Sun,0,0,1,1
2011-01-09,0,Jan,5,0,Sun,0,0,1,1
2011-01-09,0,Jan,6,0,Sun,0,0,1,1
2011-01-09,0,Jan,7,0,Sun,0,1,5,6
2011-01-09,0,Jan,8,0,Sun,0,0,10,10
2011-01-09,0,Jan,9,0,Sun,0,0,19,19
2011-01-09,0,Jan,10,0,Sun,0,0,49,49
2011-01-09,0,Jan,11,0,Sun,0,2,47,49
2011-01-09,0,Jan,12,0,Sun,0,4,79,83
2011-01-09,0,Jan,13,0,Sun,0,6,69,75
2011-01-09,0,Jan,14,0,Sun,0,8,64,72
2011-01-09,0,Jan,15,0,Sun,0,5,77,82
2011-01-09,0,Jan,16,0,Sun,0,13,79,92
2011-01-09,0,Jan,17,0,Sun,0,3,59,62
2011-01-09,0,Jan,18,0,Sun,0,4,44,48
2011-01-09,0,Jan,19,0,Sun,0,1,40,41
2011-01-09,0,Jan,20,0,Sun,0,0,38,38
2011-01-09,0,Jan,21,0,Sun,0,1,19,20
2011-01-09,0,Jan,22,0,Sun,0,5,10,15
2011-01-09,0,Jan,23,0,Sun,0,0,6,6
2011-01-10,0,Jan,0,0,Mon,1,2,3,5
2011-01-10,0,Jan,1,0,Mon,1,1,0,1
2011-01-10,0,Jan,2,0,Mon,1,0,3,3
2011-01-10,0,Jan,3,0,Mon,1,0,1,1
2011-01-10,0,Jan,4,0,Mon,1,1,2,3
2011-01-10,0,Jan,5,0,Mon,1,0,3,3
2011-01-10,0,Jan,6,0,Mon,1,0,31,31
2011-01-10,0,Jan,7,0,Mon,1,2,75,77
2011-01-10,0,Jan,8,0,Mon,1,4,184,188
2011-01-10,0,Jan,9,0,Mon,1,2,92,94
2011-01-10,0,Jan,10,0,Mon,1,0,31,31
2011-01-10,0,Jan,11,0,Mon,1,2,28,30
2011-01-10,0,Jan,12,0,Mon,1,5,47,52
2011-01-10,0,Jan,13,0,Mon,1,4,50,54
2011-01-10,0,Jan,14,0,Mon,1,0,47,47
2011-01-10,0,Jan,15,0,Mon,1,2,43,45
2011-01-10,0,Jan,16,0,Mon,1,4,70,74
2011-01-10,0,Jan,17,0,Mon,1,4,174,178
2011-01-10,0,Jan,18,0,Mon,1,1,154,155
2011-01-10,0,Jan,19,0,Mon,1,3,92,95
2011-01-10,0,Jan,20,0,Mon,1,1,73,74
2011-01-10,0,Jan,21,0,Mon,1,1,37,38
2011-01-10,0,Jan,22,0,Mon,1,2,22,24
2011-01-10,0,Jan,23,0,Mon,1,0,18,18
2011-01-11,0,Jan,0,0,Tue,1,2,10,12
2011-01-11,0,Jan,1,0,Tue,1,0,3,3
2011-01-11,0,Jan,2,0,Tue,1,0,3,3
2011-01-11,0,Jan,5,0,Tue,1,0,6,6
2011-01-11,0,Jan,6,0,Tue,1,0,27,27
2011-01-11,0,Jan,7,0,Tue,1,2,97,99
2011-01-11,0,Jan,8,0,Tue,1,3,214,217
2011-01-11,0,Jan,9,0,Tue,1,3,127,130
2011-01-11,0,Jan,10,0,Tue,1,3,51,54
2011-01-11,0,Jan,11,0,Tue,1,4,31,35
2011-01-11,0,Jan,12,0,Tue,1,2,55,57
2011-01-11,0,Jan,13,0,Tue,1,6,46,52
2011-01-11,0,Jan,14,0,Tue,1,3,60,63
2011-01-11,0,Jan,15,0,Tue,1,2,45,47
2011-01-11,0,Jan,16,0,Tue,1,4,72,76
2011-01-11,0,Jan,17,0,Tue,1,6,130,136
2011-01-11,0,Jan,18,0,Tue,1,1,94,95
2011-01-11,0,Jan,19,0,Tue,1,0,51,51
2011-01-11,0,Jan,20,0,Tue,1,0,32,32
2011-01-11,0,Jan,21,0,Tue,1,0,20,20
2011-01-11,0,Jan,22,0,Tue,1,1,28,29
2011-01-11,0,Jan,23,0,Tue,1,1,18,19
2011-01-12,0,Jan,0,0,Wed,1,0,7,7
2011-01-12,0,Jan,1,0,Wed,1,0,6,6
2011-01-12,0,Jan,2,0,Wed,1,0,1,1
2011-01-12,0,Jan,5,0,Wed,1,0,5,5
2011-01-12,0,Jan,6,0,Wed,1,0,16,16
2011-01-12,0,Jan,7,0,Wed,1,0,54,54
2011-01-12,0,Jan,8,0,Wed,1,3,125,128
2011-01-12,0,Jan,9,0,Wed,1,3,78,81
2011-01-12,0,Jan,10,0,Wed,1,0,39,39
2011-01-12,0,Jan,11,0,Wed,1,3,32,35
2011-01-12,0,Jan,12,0,Wed,1,3,52,55
2011-01-12,0,Jan,13,0,Wed,1,0,49,49
2011-01-12,0,Jan,14,0,Wed,1,0,44,44
2011-01-12,0,Jan,15,0,Wed,1,1,48,49
2011-01-12,0,Jan,16,0,Wed,1,5,63,68
2011-01-12,0,Jan,17,0,Wed,1,0,139,139
2011-01-12,0,Jan,18,0,Wed,1,2,135,137
2011-01-12,0,Jan,19,0,Wed,1,1,82,83
2011-01-12,0,Jan,20,0,Wed,1,2,54,56
2011-01-12,0,Jan,21,0,Wed,1,0,57,57
2011-01-12,0,Jan,22,0,Wed,1,1,32,33
2011-01-12,0,Jan,23,0,Wed,1,1,19,20
2011-01-13,0,Jan,0,0,Thur,1,1,6,7
2011-01-13,0,Jan,1,0,Thur,1,0,2,2
2011-01-13,0,Jan,2,0,Thur,1,0,2,2
2011-01-13,0,Jan,3,0,Thur,1,0,3,3
2011-01-13,0,Jan,4,0,Thur,1,0,4,4
2011-01-13,0,Jan,5,0,Thur,1,0,3,3
2011-01-13,0,Jan,6,0,Thur,1,0,28,28
2011-01-13,0,Jan,7,0,Thur,1,0,72,72
2011-01-13,0,Jan,8,0,Thur,1,5,197,202
2011-01-13,0,Jan,9,0,Thur,1,2,137,139
2011-01-13,0,Jan,10,0,Thur,1,2,36,38
2011-01-13,0,Jan,11,0,Thur,1,4,33,37
2011-01-13,0,Jan,12,0,Thur,1,3,49,52
2011-01-13,0,Jan,13,0,Thur,1,2,81,83
2011-01-13,0,Jan,14,0,Thur,1,3,39,42
2011-01-13,0,Jan,15,0,Thur,1,5,55,60
2011-01-13,0,Jan,16,0,Thur,1,2,76,78
2011-01-13,0,Jan,17,0,Thur,1,4,158,162
2011-01-13,0,Jan,18,0,Thur,1,3,141,144
2011-01-13,0,Jan,19,0,Thur,1,1,98,99
2011-01-13,0,Jan,20,0,Thur,1,0,64,64
2011-01-13,0,Jan,21,0,Thur,1,0,40,40
2011-01-13,0,Jan,22,0,Thur,1,0,30,30
2011-01-13,0,Jan,23,0,Thur,1,1,14,15
2011-01-14,0,Jan,0,0,Fri,1,0,14,14
2011-01-14,0,Jan,1,0,Fri,1,0,5,5
2011-01-14,0,Jan,2,0,Fri,1,0,1,1
2011-01-14,0,Jan,3,0,Fri,1,0,1,1
2011-01-14,0,Jan,5,0,Fri,1,0,8,8
2011-01-14,0,Jan,6,0,Fri,1,0,17,17
2011-01-14,0,Jan,7,0,Fri,1,0,70,70
2011-01-14,0,Jan,8,0,Fri,1,2,156,158
2011-01-14,0,Jan,9,0,Fri,1,0,117,117
2011-01-14,0,Jan,10,0,Fri,1,4,40,44
2011-01-14,0,Jan,11,0,Fri,1,6,47,53
2011-01-14,0,Jan,12,0,Fri,1,2,59,61
2011-01-14,0,Jan,13,0,Fri,1,4,73,77
2011-01-14,0,Jan,14,0,Fri,1,5,59,64
2011-01-14,0,Jan,15,0,Fri,1,9,59,68
2011-01-14,0,Jan,16,0,Fri,1,3,87,90
2011-01-14,0,Jan,17,0,Fri,1,4,155,159
2011-01-14,0,Jan,18,0,Fri,1,5,134,139
2011-01-14,0,Jan,19,0,Fri,1,3,89,92
2011-01-14,0,Jan,20,0,Fri,1,0,68,68
2011-01-14,0,Jan,21,0,Fri,1,4,48,52
2011-01-14,0,Jan,22,0,Fri,1,2,34,36
2011-01-14,0,Jan,23,0,Fri,1,1,26,27
2011-01-15,0,Jan,0,0,Sat,0,3,25,28
2011-01-15,0,Jan,1,0,Sat,0,2,18,20
2011-01-15,0,Jan,2,0,Sat,0,0,12,12
2011-01-15,0,Jan,3,0,Sat,0,1,7,8
2011-01-15,0,Jan,4,0,Sat,0,0,5,5
2011-01-15,0,Jan,5,0,Sat,0,0,1,1
2011-01-15,0,Jan,6,0,Sat,0,1,2,3
2011-01-15,0,Jan,7,0,Sat,0,1,9,10
2011-01-15,0,Jan,8,0,Sat,0,1,22,23
2011-01-15,0,Jan,9,0,Sat,0,2,31,33
2011-01-15,0,Jan,10,0,Sat,0,2,57,59
2011-01-15,0,Jan,11,0,Sat,0,18,54,72
2011-01-15,0,Jan,12,0,Sat,0,15,74,89
2011-01-15,0,Jan,13,0,Sat,0,21,80,101
2011-01-15,0,Jan,14,0,Sat,0,26,92,118
2011-01-15,0,Jan,15,0,Sat,0,21,108,129
2011-01-15,0,Jan,16,0,Sat,0,33,95,128
2011-01-15,0,Jan,17,0,Sat,0,29,54,83
2011-01-15,0,Jan,18,0,Sat,0,15,69,84
2011-01-15,0,Jan,19,0,Sat,0,14,60,74
2011-01-15,0,Jan,20,0,Sat,0,6,35,41
2011-01-15,0,Jan,21,0,Sat,0,6,51,57
2011-01-15,0,Jan,22,0,Sat,0,0,26,26
2011-01-15,0,Jan,23,0,Sat,0,5,39,44
2011-01-16,0,Jan,0,0,Sun,0,6,33,39
2011-01-16,0,Jan,1,0,Sun,0,4,19,23
2011-01-16,0,Jan,2,0,Sun,0,3,13,16
2011-01-16,0,Jan,3,0,Sun,0,9,6,15
2011-01-16,0,Jan,4,0,Sun,0,0,1,1
2011-01-16,0,Jan,5,0,Sun,0,1,1,2
2011-01-16,0,Jan,6,0,Sun,0,0,1,1
2011-01-16,0,Jan,7,0,Sun,0,0,3,3
2011-01-16,0,Jan,8,0,Sun,0,0,18,18
2011-01-16,0,Jan,9,0,Sun,0,3,29,32
2011-01-16,0,Jan,10,0,Sun,0,8,71,79
2011-01-16,0,Jan,11,0,Sun,0,23,70,93
2011-01-16,0,Jan,12,0,Sun,0,29,75,104
2011-01-16,0,Jan,13,0,Sun,0,23,95,118
2011-01-16,0,Jan,14,0,Sun,0,22,69,91
2011-01-16,0,Jan,15,0,Sun,0,35,78,113
2011-01-16,0,Jan,16,0,Sun,0,22,77,99
2011-01-16,0,Jan,17,0,Sun,0,23,82,105
2011-01-16,0,Jan,18,0,Sun,0,11,56,67
2011-01-16,0,Jan,19,0,Sun,0,14,47,61
2011-01-16,0,Jan,20,0,Sun,0,7,50,57
2011-01-16,0,Jan,21,0,Sun,0,6,22,28
2011-01-16,0,Jan,22,0,Sun,0,2,19,21
2011-01-16,0,Jan,23,0,Sun,0,0,18,18
2011-01-17,0,Jan,0,1,Mon,0,1,16,17
2011-01-17,0,Jan,1,1,Mon,0,1,15,16
2011-01-17,0,Jan,2,1,Mon,0,0,8,8
2011-01-17,0,Jan,3,1,Mon,0,0,2,2
2011-01-17,0,Jan,4,1,Mon,0,1,2,3
2011-01-17,0,Jan,5,1,Mon,0,0,1,1
2011-01-17,0,Jan,6,1,Mon,0,0,5,5
2011-01-17,0,Jan,7,1,Mon,0,4,9,13
2011-01-17,0,Jan,8,1,Mon,0,3,30,33
2011-01-17,0,Jan,9,1,Mon,0,8,39,47
2011-01-17,0,Jan,10,1,Mon,0,7,50,57
2011-01-17,0,Jan,11,1,Mon,0,9,55,64
2011-01-17,0,Jan,12,1,Mon,0,10,70,80
2011-01-17,0,Jan,13,1,Mon,0,13,80,93
2011-01-17,0,Jan,14,1,Mon,0,12,74,86
2011-01-17,0,Jan,15,1,Mon,0,21,72,93
2011-01-17,0,Jan,16,1,Mon,0,6,76,82
2011-01-17,0,Jan,17,1,Mon,0,4,67,71
2011-01-17,0,Jan,18,1,Mon,0,7,85,92
2011-01-17,0,Jan,19,1,Mon,0,2,58,60
2011-01-17,0,Jan,20,1,Mon,0,4,29,33
2011-01-17,0,Jan,21,1,Mon,0,3,24,27
2011-01-17,0,Jan,22,1,Mon,0,0,13,13
2011-01-17,0,Jan,23,1,Mon,0,1,3,4
2011-01-18,0,Jan,12,0,Tue,1,0,3,3
2011-01-18,0,Jan,13,0,Tue,1,0,22,22
2011-01-18,0,Jan,14,0,Tue,1,2,26,28
2011-01-18,0,Jan,15,0,Tue,1,3,32,35
2011-01-18,0,Jan,16,0,Tue,1,0,61,61
2011-01-18,0,Jan,17,0,Tue,1,1,124,125
2011-01-18,0,Jan,18,0,Tue,1,1,132,133
2011-01-18,0,Jan,19,0,Tue,1,1,98,99
2011-01-18,0,Jan,20,0,Tue,1,0,83,83
2011-01-18,0,Jan,21,0,Tue,1,0,41,41
2011-01-18,0,Jan,22,0,Tue,1,0,33,33
2011-01-18,0,Jan,23,0,Tue,1,1,19,20
2011-01-19,0,Jan,0,0,Wed,1,0,3,3
2011-01-19,0,Jan,1,0,Wed,1,1,6,7
2011-01-19,0,Jan,2,0,Wed,1,0,3,3
2011-01-19,0,Jan,4,0,Wed,1,1,1,2
2011-01-19,0,Jan,5,0,Wed,1,0,7,7
2011-01-19,0,Jan,6,0,Wed,1,0,32,32
2011-01-19,0,Jan,7,0,Wed,1,1,89,90
2011-01-19,0,Jan,8,0,Wed,1,1,196,197
2011-01-19,0,Jan,9,0,Wed,1,2,107,109
2011-01-19,0,Jan,10,0,Wed,1,1,46,47
2011-01-19,0,Jan,11,0,Wed,1,5,47,52
2011-01-19,0,Jan,12,0,Wed,1,5,65,70
2011-01-19,0,Jan,13,0,Wed,1,11,67,78
2011-01-19,0,Jan,14,0,Wed,1,7,68,75
2011-01-19,0,Jan,15,0,Wed,1,4,78,82
2011-01-19,0,Jan,16,0,Wed,1,10,94,104
2011-01-19,0,Jan,17,0,Wed,1,7,190,197
2011-01-19,0,Jan,18,0,Wed,1,5,156,161
2011-01-19,0,Jan,19,0,Wed,1,4,108,112
2011-01-19,0,Jan,20,0,Wed,1,2,74,76
2011-01-19,0,Jan,21,0,Wed,1,4,55,59
2011-01-19,0,Jan,22,0,Wed,1,6,53,59
2011-01-19,0,Jan,23,0,Wed,1,1,27,28
2011-01-20,0,Jan,0,0,Thur,1,5,8,13
2011-01-20,0,Jan,1,0,Thur,1,2,3,5
2011-01-20,0,Jan,2,0,Thur,1,0,2,2
2011-01-20,0,Jan,3,0,Thur,1,0,1,1
2011-01-20,0,Jan,4,0,Thur,1,0,1,1
2011-01-20,0,Jan,5,0,Thur,1,0,6,6
2011-01-20,0,Jan,6,0,Thur,1,0,35,35
2011-01-20,0,Jan,7,0,Thur,1,1,100,101
2011-01-20,0,Jan,8,0,Thur,1,2,247,249
2011-01-20,0,Jan,9,0,Thur,1,3,140,143
2011-01-20,0,Jan,10,0,Thur,1,1,56,57
2011-01-20,0,Jan,11,0,Thur,1,5,63,68
2011-01-20,0,Jan,12,0,Thur,1,7,77,84
2011-01-20,0,Jan,13,0,Thur,1,12,86,98
2011-01-20,0,Jan,14,0,Thur,1,6,75,81
2011-01-20,0,Jan,15,0,Thur,1,8,62,70
2011-01-20,0,Jan,16,0,Thur,1,8,83,91
2011-01-20,0,Jan,17,0,Thur,1,8,207,215
2011-01-20,0,Jan,18,0,Thur,1,1,184,185
2011-01-20,0,Jan,19,0,Thur,1,6,146,152
2011-01-20,0,Jan,20,0,Thur,1,2,124,126
2011-01-20,0,Jan,21,0,Thur,1,3,54,57
2011-01-20,0,Jan,22,0,Thur,1,0,56,56
2011-01-20,0,Jan,23,0,Thur,1,3,28,31
2011-01-21,0,Jan,0,0,Fri,1,1,20,21
2011-01-21,0,Jan,1,0,Fri,1,0,6,6
2011-01-21,0,Jan,2,0,Fri,1,0,2,2
2011-01-21,0,Jan,3,0,Fri,1,0,1,1
2011-01-21,0,Jan,4,0,Fri,1,0,1,1
2011-01-21,0,Jan,5,0,Fri,1,1,4,5
2011-01-21,0,Jan,6,0,Fri,1,0,27,27
2011-01-21,0,Jan,7,0,Fri,1,2,66,68
2011-01-21,0,Jan,8,0,Fri,1,7,210,217
2011-01-21,0,Jan,9,0,Fri,1,7,159,166
2011-01-21,0,Jan,10,0,Fri,1,6,57,63
2011-01-21,0,Jan,11,0,Fri,1,6,53,59
2011-01-21,0,Jan,12,0,Fri,1,11,67,78
2011-01-21,0,Jan,13,0,Fri,1,8,65,73
2011-01-21,0,Jan,14,0,Fri,1,6,56,62
2011-01-21,0,Jan,15,0,Fri,1,4,61,65
2011-01-21,0,Jan,16,0,Fri,1,0,97,97
2011-01-21,0,Jan,17,0,Fri,1,10,151,161
2011-01-21,0,Jan,18,0,Fri,1,1,119,120
2011-01-21,0,Jan,19,0,Fri,1,3,93,96
2011-01-21,0,Jan,20,0,Fri,1,1,52,53
2011-01-21,0,Jan,21,0,Fri,1,0,41,41
2011-01-21,0,Jan,22,0,Fri,1,1,33,34
2011-01-21,0,Jan,23,0,Fri,1,0,27,27
2011-01-22,0,Jan,0,0,Sat,0,0,13,13
2011-01-22,0,Jan,1,0,Sat,0,3,9,12
2011-01-22,0,Jan,2,0,Sat,0,0,11,11
2011-01-22,0,Jan,3,0,Sat,0,1,6,7
2011-01-22,0,Jan,4,0,Sat,0,0,3,3
2011-01-22,0,Jan,6,0,Sat,0,0,2,2
2011-01-22,0,Jan,7,0,Sat,0,0,8,8
2011-01-22,0,Jan,8,0,Sat,0,1,26,27
2011-01-22,0,Jan,9,0,Sat,0,3,37,40
2011-01-22,0,Jan,10,0,Sat,0,3,50,53
2011-01-22,0,Jan,11,0,Sat,0,4,59,63
2011-01-22,0,Jan,12,0,Sat,0,10,60,70
2011-01-22,0,Jan,13,0,Sat,0,12,72,84
2011-01-22,0,Jan,14,0,Sat,0,11,64,75
2011-01-22,0,Jan,15,0,Sat,0,10,93,103
2011-01-22,0,Jan,16,0,Sat,0,11,72,83
2011-01-22,0,Jan,17,0,Sat,0,8,59,67
2011-01-22,0,Jan,18,0,Sat,0,0,54,54
2011-01-22,0,Jan,19,0,Sat,0,6,53,59
2011-01-22,0,Jan,20,0,Sat,0,1,44,45
2011-01-22,0,Jan,21,0,Sat,0,0,39,39
2011-01-22,0,Jan,22,0,Sat,0,7,23,30
2011-01-22,0,Jan,23,0,Sat,0,2,31,33
2011-01-23,0,Jan,0,0,Sun,0,2,20,22
2011-01-23,0,Jan,1,0,Sun,0,1,12,13
2011-01-23,0,Jan,2,0,Sun,0,3,15,18
2011-01-23,0,Jan,3,0,Sun,0,1,4,5
2011-01-23,0,Jan,5,0,Sun,0,0,3,3
2011-01-23,0,Jan,6,0,Sun,0,0,1,1
2011-01-23,0,Jan,7,0,Sun,0,1,1,2
2011-01-23,0,Jan,8,0,Sun,0,2,17,19
2011-01-23,0,Jan,9,0,Sun,0,3,25,28
2011-01-23,0,Jan,10,0,Sun,0,7,51,58
2011-01-23,0,Jan,11,0,Sun,0,22,77,99
2011-01-23,0,Jan,12,0,Sun,0,24,92,116
2011-01-23,0,Jan,13,0,Sun,0,12,75,87
2011-01-23,0,Jan,14,0,Sun,0,17,93,110
2011-01-23,0,Jan,15,0,Sun,0,13,64,77
2011-01-23,0,Jan,16,0,Sun,0,9,56,65
2011-01-23,0,Jan,17,0,Sun,0,5,50,55
2011-01-23,0,Jan,18,0,Sun,0,5,44,49
2011-01-23,0,Jan,19,0,Sun,0,5,45,50
2011-01-23,0,Jan,20,0,Sun,0,4,31,35
2011-01-23,0,Jan,21,0,Sun,0,5,20,25
2011-01-23,0,Jan,22,0,Sun,0,5,23,28
2011-01-23,0,Jan,23,0,Sun,0,4,17,21
2011-01-24,0,Jan,0,0,Mon,1,0,7,7
2011-01-24,0,Jan,1,0,Mon,1,0,1,1
2011-01-24,0,Jan,3,0,Mon,1,0,1,1
2011-01-24,0,Jan,4,0,Mon,1,0,1,1
2011-01-24,0,Jan,5,0,Mon,1,0,5,5
2011-01-24,0,Jan,6,0,Mon,1,0,15,15
2011-01-24,0,Jan,7,0,Mon,1,5,79,84
2011-01-24,0,Jan,8,0,Mon,1,6,171,177
2011-01-24,0,Jan,9,0,Mon,1,4,98,102
2011-01-24,0,Jan,10,0,Mon,1,6,34,40
2011-01-24,0,Jan,11,0,Mon,1,3,43,46
2011-01-24,0,Jan,12,0,Mon,1,11,52,63
2011-01-24,0,Jan,13,0,Mon,1,6,54,60
2011-01-24,0,Jan,14,0,Mon,1,2,43,45
2011-01-24,0,Jan,15,0,Mon,1,7,50,57
2011-01-24,0,Jan,16,0,Mon,1,4,66,70
2011-01-24,0,Jan,17,0,Mon,1,6,178,184
2011-01-24,0,Jan,18,0,Mon,1,8,145,153
2011-01-24,0,Jan,19,0,Mon,1,5,101,106
2011-01-24,0,Jan,20,0,Mon,1,1,80,81
2011-01-24,0,Jan,21,0,Mon,1,6,53,59
2011-01-24,0,Jan,22,0,Mon,1,3,32,35
2011-01-24,0,Jan,23,0,Mon,1,3,21,24
2011-01-25,0,Jan,0,0,Tue,1,3,6,9
2011-01-25,0,Jan,1,0,Tue,1,0,5,5
2011-01-25,0,Jan,2,0,Tue,1,0,2,2
2011-01-25,0,Jan,4,0,Tue,1,0,1,1
2011-01-25,0,Jan,5,0,Tue,1,0,9,9
2011-01-25,0,Jan,6,0,Tue,1,1,35,36
2011-01-25,0,Jan,7,0,Tue,1,5,103,108
2011-01-25,0,Jan,8,0,Tue,1,5,233,238
2011-01-25,0,Jan,9,0,Tue,1,10,134,144
2011-01-25,0,Jan,10,0,Tue,1,6,49,55
2011-01-25,0,Jan,11,0,Tue,1,6,55,61
2011-01-25,0,Jan,12,0,Tue,1,21,85,106
2011-01-25,0,Jan,13,0,Tue,1,21,72,93
2011-01-25,0,Jan,14,0,Tue,1,11,57,68
2011-01-25,0,Jan,15,0,Tue,1,21,63,84
2011-01-25,0,Jan,16,0,Tue,1,14,102,116
2011-01-25,0,Jan,17,0,Tue,1,14,208,222
2011-01-25,0,Jan,18,0,Tue,1,7,218,225
2011-01-25,0,Jan,19,0,Tue,1,13,133,146
2011-01-25,0,Jan,20,0,Tue,1,16,103,119
2011-01-25,0,Jan,21,0,Tue,1,5,40,45
2011-01-25,0,Jan,22,0,Tue,1,4,49,53
2011-01-25,0,Jan,23,0,Tue,1,3,37,40
2011-01-26,0,Jan,0,0,Wed,1,3,14,17
2011-01-26,0,Jan,1,0,Wed,1,0,5,5
2011-01-26,0,Jan,2,0,Wed,1,3,7,10
2011-01-26,0,Jan,5,0,Wed,1,0,1,1
2011-01-26,0,Jan,6,0,Wed,1,0,8,8
2011-01-26,0,Jan,7,0,Wed,1,1,29,30
2011-01-26,0,Jan,8,0,Wed,1,3,69,72
2011-01-26,0,Jan,9,0,Wed,1,3,55,58
2011-01-26,0,Jan,10,0,Wed,1,2,26,28
2011-01-26,0,Jan,11,0,Wed,1,6,35,41
2011-01-26,0,Jan,12,0,Wed,1,7,41,48
2011-01-26,0,Jan,13,0,Wed,1,4,43,47
2011-01-26,0,Jan,14,0,Wed,1,0,36,36
2011-01-26,0,Jan,15,0,Wed,1,1,42,43
2011-01-26,0,Jan,16,0,Wed,1,1,35,36
2011-01-26,0,Jan,17,0,Wed,1,0,26,26
2011-01-27,0,Jan,16,0,Thur,1,1,23,24
2011-01-27,0,Jan,17,0,Thur,1,2,82,84
2011-01-27,0,Jan,18,0,Thur,1,3,101,104
2011-01-27,0,Jan,19,0,Thur,1,3,76,79
2011-01-27,0,Jan,20,0,Thur,1,4,55,59
2011-01-27,0,Jan,21,0,Thur,1,2,36,38
2011-01-27,0,Jan,22,0,Thur,1,0,27,27
2011-01-27,0,Jan,23,0,Thur,1,0,16,16
2011-01-28,0,Jan,0,0,Fri,1,0,9,9
2011-01-28,0,Jan,1,0,Fri,1,1,2,3
2011-01-28,0,Jan,2,0,Fri,1,0,2,2
2011-01-28,0,Jan,3,0,Fri,1,1,0,1
2011-01-28,0,Jan,5,0,Fri,1,0,4,4
2011-01-28,0,Jan,6,0,Fri,1,0,16,16
2011-01-28,0,Jan,7,0,Fri,1,2,58,60
2011-01-28,0,Jan,8,0,Fri,1,2,155,157
2011-01-28,0,Jan,9,0,Fri,1,6,95,101
2011-01-28,0,Jan,10,0,Fri,1,0,49,49
2011-01-28,0,Jan,11,0,Fri,1,0,30,30
2011-01-28,0,Jan,12,0,Fri,1,1,28,29
2011-01-28,0,Jan,13,0,Fri,1,0,31,31
2011-01-28,0,Jan,14,0,Fri,1,2,36,38
2011-01-28,0,Jan,15,0,Fri,1,1,40,41
2011-01-28,0,Jan,16,0,Fri,1,10,70,80
2011-01-28,0,Jan,17,0,Fri,1,2,147,149
2011-01-28,0,Jan,18,0,Fri,1,2,107,109
2011-01-28,0,Jan,19,0,Fri,1,5,84,89
2011-01-28,0,Jan,20,0,Fri,1,1,61,62
2011-01-28,0,Jan,21,0,Fri,1,1,57,58
2011-01-28,0,Jan,22,0,Fri,1,0,26,26
2011-01-28,0,Jan,23,0,Fri,1,1,22,23
2011-01-29,0,Jan,0,0,Sat,0,2,26,28
2011-01-29,0,Jan,1,0,Sat,0,0,20,20
2011-01-29,0,Jan,2,0,Sat,0,0,15,15
2011-01-29,0,Jan,3,0,Sat,0,3,5,8
2011-01-29,0,Jan,4,0,Sat,0,1,2,3
2011-01-29,0,Jan,6,0,Sat,0,0,2,2
2011-01-29,0,Jan,7,0,Sat,0,1,4,5
2011-01-29,0,Jan,8,0,Sat,0,3,31,34
2011-01-29,0,Jan,9,0,Sat,0,0,34,34
2011-01-29,0,Jan,10,0,Sat,0,4,51,55
2011-01-29,0,Jan,11,0,Sat,0,4,60,64
2011-01-29,0,Jan,12,0,Sat,0,12,66,78
2011-01-29,0,Jan,13,0,Sat,0,9,56,65
2011-01-29,0,Jan,14,0,Sat,0,10,89,99
2011-01-29,0,Jan,15,0,Sat,0,22,98,120
2011-01-29,0,Jan,16,0,Sat,0,19,88,107
2011-01-29,0,Jan,17,0,Sat,0,9,82,91
2011-01-29,0,Jan,18,0,Sat,0,9,59,68
2011-01-29,0,Jan,19,0,Sat,0,6,52,58
2011-01-29,0,Jan,20,0,Sat,0,1,42,43
2011-01-29,0,Jan,21,0,Sat,0,1,35,36
2011-01-29,0,Jan,22,0,Sat,0,4,28,32
2011-01-29,0,Jan,23,0,Sat,0,3,30,33
2011-01-30,0,Jan,0,0,Sun,0,0,33,33
2011-01-30,0,Jan,1,0,Sun,0,7,22,29
2011-01-30,0,Jan,2,0,Sun,0,1,10,11
2011-01-30,0,Jan,3,0,Sun,0,1,7,8
2011-01-30,0,Jan,4,0,Sun,0,0,1,1
2011-01-30,0,Jan,5,0,Sun,0,0,3,3
2011-01-30,0,Jan,7,0,Sun,0,0,3,3
2011-01-30,0,Jan,8,0,Sun,0,1,11,12
2011-01-30,0,Jan,9,0,Sun,0,4,34,38
2011-01-30,0,Jan,10,0,Sun,0,7,57,64
2011-01-30,0,Jan,11,0,Sun,0,9,50,59
2011-01-30,0,Jan,12,0,Sun,0,10,87,97
2011-01-30,0,Jan,13,0,Sun,0,13,71,84
2011-01-30,0,Jan,14,0,Sun,0,18,104,122
2011-01-30,0,Jan,15,0,Sun,0,14,95,109
2011-01-30,0,Jan,16,0,Sun,0,19,104,123
2011-01-30,0,Jan,17,0,Sun,0,6,71,77
2011-01-30,0,Jan,18,0,Sun,0,8,57,65
2011-01-30,0,Jan,19,0,Sun,0,9,46,55
2011-01-30,0,Jan,20,0,Sun,0,3,30,33
2011-01-30,0,Jan,21,0,Sun,0,3,25,28
2011-01-30,0,Jan,22,0,Sun,0,2,19,21
2011-01-30,0,Jan,23,0,Sun,0,5,16,21
2011-01-31,0,Jan,0,0,Mon,1,1,6,7
2011-01-31,0,Jan,1,0,Mon,1,2,5,7
2011-01-31,0,Jan,2,0,Mon,1,0,1,1
2011-01-31,0,Jan,3,0,Mon,1,0,2,2
2011-01-31,0,Jan,4,0,Mon,1,0,2,2
2011-01-31,0,Jan,5,0,Mon,1,0,8,8
2011-01-31,0,Jan,6,0,Mon,1,0,37,37
2011-01-31,0,Jan,7,0,Mon,1,1,71,72
2011-01-31,0,Jan,8,0,Mon,1,3,182,185
2011-01-31,0,Jan,9,0,Mon,1,0,112,112
2011-01-31,0,Jan,10,0,Mon,1,1,68,69
2011-01-31,0,Jan,11,0,Mon,1,2,46,48
2011-01-31,0,Jan,12,0,Mon,1,6,62,68
2011-01-31,0,Jan,13,0,Mon,1,2,52,54
2011-01-31,0,Jan,14,0,Mon,1,1,85,86
2011-01-31,0,Jan,15,0,Mon,1,3,41,44
2011-01-31,0,Jan,16,0,Mon,1,3,83,86
2011-01-31,0,Jan,17,0,Mon,1,6,155,161
2011-01-31,0,Jan,18,0,Mon,1,3,153,156
2011-01-31,0,Jan,19,0,Mon,1,3,108,111
2011-01-31,0,Jan,20,0,Mon,1,0,78,78
2011-01-31,0,Jan,21,0,Mon,1,3,53,56
2011-01-31,0,Jan,22,0,Mon,1,0,34,34
2011-01-31,0,Jan,23,0,Mon,1,2,15,17
2011-02-01,0,Feb,0,0,Tue,1,2,6,8
2011-02-01,0,Feb,1,0,Tue,1,0,3,3
2011-02-01,0,Feb,2,0,Tue,1,0,2,2
2011-02-01,0,Feb,3,0,Tue,1,0,2,2
2011-02-01,0,Feb,5,0,Tue,1,0,3,3
2011-02-01,0,Feb,6,0,Tue,1,0,22,22
2011-02-01,0,Feb,7,0,Tue,1,0,52,52
2011-02-01,0,Feb,8,0,Tue,1,3,132,135
2011-02-01,0,Feb,9,0,Tue,1,2,114,116
2011-02-01,0,Feb,10,0,Tue,1,0,47,47
2011-02-01,0,Feb,11,0,Tue,1,2,49,51
2011-02-01,0,Feb,12,0,Tue,1,2,53,55
2011-02-01,0,Feb,13,0,Tue,1,3,49,52
2011-02-01,0,Feb,14,0,Tue,1,5,49,54
2011-02-01,0,Feb,15,0,Tue,1,7,45,52
2011-02-01,0,Feb,16,0,Tue,1,3,61,64
2011-02-01,0,Feb,17,0,Tue,1,4,172,176
2011-02-01,0,Feb,18,0,Tue,1,3,165,168
2011-02-01,0,Feb,19,0,Tue,1,3,105,108
2011-02-01,0,Feb,20,0,Tue,1,5,69,74
2011-02-01,0,Feb,21,0,Tue,1,0,64,64
2011-02-01,0,Feb,22,0,Tue,1,2,34,36
2011-02-01,0,Feb,23,0,Tue,1,1,15,16
2011-02-02,0,Feb,0,0,Wed,1,0,2,2
2011-02-02,0,Feb,1,0,Wed,1,0,3,3
2011-02-02,0,Feb,2,0,Wed,1,4,0,4
2011-02-02,0,Feb,3,0,Wed,1,0,1,1
2011-02-02,0,Feb,4,0,Wed,1,0,1,1
2011-02-02,0,Feb,5,0,Wed,1,0,3,3
2011-02-02,0,Feb,6,0,Wed,1,1,17,18
2011-02-02,0,Feb,7,0,Wed,1,1,48,49
2011-02-02,0,Feb,8,0,Wed,1,1,154,155
2011-02-02,0,Feb,9,0,Wed,1,4,119,123
2011-02-02,0,Feb,10,0,Wed,1,2,59,61
2011-02-02,0,Feb,11,0,Wed,1,5,47,52
2011-02-02,0,Feb,12,0,Wed,1,3,61,64
2011-02-02,0,Feb,13,0,Wed,1,1,74,75
2011-02-02,0,Feb,14,0,Wed,1,2,61,63
2011-02-02,0,Feb,15,0,Wed,1,10,66,76
2011-02-02,0,Feb,16,0,Wed,1,8,95,103
2011-02-02,0,Feb,17,0,Wed,1,7,183,190
2011-02-02,0,Feb,18,0,Wed,1,7,175,182
2011-02-02,0,Feb,19,0,Wed,1,3,88,91
2011-02-02,0,Feb,20,0,Wed,1,4,71,75
2011-02-02,0,Feb,21,0,Wed,1,1,62,63
2011-02-02,0,Feb,22,0,Wed,1,5,35,40
2011-02-02,0,Feb,23,0,Wed,1,3,29,32
2011-02-03,0,Feb,0,0,Thur,1,1,11,12
2011-02-03,0,Feb,1,0,Thur,1,0,5,5
2011-02-03,0,Feb,2,0,Thur,1,0,2,2
2011-02-03,0,Feb,3,0,Thur,1,0,1,1
2011-02-03,0,Feb,5,0,Thur,1,0,2,2
2011-02-03,0,Feb,6,0,Thur,1,0,39,39
2011-02-03,0,Feb,7,0,Thur,1,1,86,87
2011-02-03,0,Feb,8,0,Thur,1,4,184,188
2011-02-03,0,Feb,9,0,Thur,1,6,127,133
2011-02-03,0,Feb,10,0,Thur,1,2,50,52
2011-02-03,0,Feb,11,0,Thur,1,9,55,64
2011-02-03,0,Feb,12,0,Thur,1,2,67,69
2011-02-03,0,Feb,13,0,Thur,1,4,47,51
2011-02-03,0,Feb,14,0,Thur,1,4,43,47
2011-02-03,0,Feb,15,0,Thur,1,4,56,60
2011-02-03,0,Feb,16,0,Thur,1,5,73,78
2011-02-03,0,Feb,17,0,Thur,1,5,170,175
2011-02-03,0,Feb,18,0,Thur,1,2,145,147
2011-02-03,0,Feb,19,0,Thur,1,4,92,96
2011-02-03,0,Feb,20,0,Thur,1,1,108,109
2011-02-03,0,Feb,21,0,Thur,1,1,53,54
2011-02-03,0,Feb,22,0,Thur,1,2,39,41
2011-02-03,0,Feb,23,0,Thur,1,4,34,38
2011-02-04,0,Feb,0,0,Fri,1,3,10,13
2011-02-04,0,Feb,1,0,Fri,1,0,7,7
2011-02-04,0,Feb,2,0,Fri,1,0,1,1
2011-02-04,0,Feb,3,0,Fri,1,0,1,1
2011-02-04,0,Feb,5,0,Fri,1,0,7,7
2011-02-04,0,Feb,6,0,Fri,1,2,26,28
2011-02-04,0,Feb,7,0,Fri,1,0,87,87
2011-02-04,0,Feb,8,0,Fri,1,3,217,220
2011-02-04,0,Feb,9,0,Fri,1,3,124,127
2011-02-04,0,Feb,10,0,Fri,1,5,46,51
2011-02-04,0,Feb,11,0,Fri,1,3,61,64
2011-02-04,0,Feb,12,0,Fri,1,8,78,86
2011-02-04,0,Feb,13,0,Fri,1,9,73,82
2011-02-04,0,Feb,14,0,Fri,1,15,76,91
2011-02-04,0,Feb,15,0,Fri,1,9,81,90
2011-02-04,0,Feb,16,0,Fri,1,8,91,99
2011-02-04,0,Feb,17,0,Fri,1,10,195,205
2011-02-04,0,Feb,18,0,Fri,1,3,152,155
2011-02-04,0,Feb,19,0,Fri,1,1,102,103
2011-02-04,0,Feb,20,0,Fri,1,2,69,71
2011-02-04,0,Feb,21,0,Fri,1,2,41,43
2011-02-04,0,Feb,22,0,Fri,1,1,45,46
2011-02-04,0,Feb,23,0,Fri,1,1,30,31
2011-02-05,0,Feb,0,0,Sat,0,3,36,39
2011-02-05,0,Feb,1,0,Sat,0,1,17,18
2011-02-05,0,Feb,2,0,Sat,0,5,12,17
2011-02-05,0,Feb,3,0,Sat,0,1,10,11
2011-02-05,0,Feb,4,0,Sat,0,0,8,8
2011-02-05,0,Feb,5,0,Sat,0,0,9,9
2011-02-05,0,Feb,6,0,Sat,0,0,4,4
2011-02-05,0,Feb,7,0,Sat,0,0,4,4
2011-02-05,0,Feb,8,0,Sat,0,0,10,10
2011-02-05,0,Feb,9,0,Sat,0,3,17,20
2011-02-05,0,Feb,10,0,Sat,0,3,31,34
2011-02-05,0,Feb,11,0,Sat,0,1,46,47
2011-02-05,0,Feb,12,0,Sat,0,10,42,52
2011-02-05,0,Feb,13,0,Sat,0,10,62,72
2011-02-05,0,Feb,14,0,Sat,0,5,50,55
2011-02-05,0,Feb,15,0,Sat,0,11,49,60
2011-02-05,0,Feb,16,0,Sat,0,8,63,71
2011-02-05,0,Feb,17,0,Sat,0,14,64,78
2011-02-05,0,Feb,18,0,Sat,0,2,81,83
2011-02-05,0,Feb,19,0,Sat,0,6,78,84
2011-02-05,0,Feb,20,0,Sat,0,5,64,69
2011-02-05,0,Feb,21,0,Sat,0,3,53,56
2011-02-05,0,Feb,22,0,Sat,0,2,43,45
2011-02-05,0,Feb,23,0,Sat,0,7,52,59
2011-02-06,0,Feb,0,0,Sun,0,2,37,39
2011-02-06,0,Feb,1,0,Sun,0,4,40,44
2011-02-06,0,Feb,2,0,Sun,0,0,20,20
2011-02-06,0,Feb,3,0,Sun,0,3,10,13
2011-02-06,0,Feb,4,0,Sun,0,0,2,2
2011-02-06,0,Feb,5,0,Sun,0,0,1,1
2011-02-06,0,Feb,6,0,Sun,0,0,1,1
2011-02-06,0,Feb,7,0,Sun,0,0,8,8
2011-02-06,0,Feb,8,0,Sun,0,2,21,23
2011-02-06,0,Feb,9,0,Sun,0,7,38,45
2011-02-06,0,Feb,10,0,Sun,0,15,74,89
2011-02-06,0,Feb,11,0,Sun,0,28,89,117
2011-02-06,0,Feb,12,0,Sun,0,48,126,174
2011-02-06,0,Feb,13,0,Sun,0,47,135,182
2011-02-06,0,Feb,14,0,Sun,0,47,114,161
2011-02-06,0,Feb,15,0,Sun,0,52,130,182
2011-02-06,0,Feb,16,0,Sun,0,42,115,157
2011-02-06,0,Feb,17,0,Sun,0,24,97,121
2011-02-06,0,Feb,18,0,Sun,0,13,65,78
2011-02-06,0,Feb,19,0,Sun,0,1,20,21
2011-02-06,0,Feb,20,0,Sun,0,5,21,26
2011-02-06,0,Feb,21,0,Sun,0,5,22,27
2011-02-06,0,Feb,22,0,Sun,0,5,57,62
2011-02-06,0,Feb,23,0,Sun,0,4,26,30
2011-02-07,0,Feb,0,0,Mon,1,1,14,15
2011-02-07,0,Feb,1,0,Mon,1,1,4,5
2011-02-07,0,Feb,2,0,Mon,1,0,3,3
2011-02-07,0,Feb,3,0,Mon,1,0,1,1
2011-02-07,0,Feb,4,0,Mon,1,1,1,2
2011-02-07,0,Feb,5,0,Mon,1,1,9,10
2011-02-07,0,Feb,6,0,Mon,1,1,29,30
2011-02-07,0,Feb,7,0,Mon,1,6,89,95
2011-02-07,0,Feb,8,0,Mon,1,7,223,230
2011-02-07,0,Feb,9,0,Mon,1,3,115,118
2011-02-07,0,Feb,10,0,Mon,1,6,49,55
2011-02-07,0,Feb,11,0,Mon,1,11,36,47
2011-02-07,0,Feb,12,0,Mon,1,7,59,66
2011-02-07,0,Feb,13,0,Mon,1,10,54,64
2011-02-07,0,Feb,14,0,Mon,1,8,52,60
2011-02-07,0,Feb,15,0,Mon,1,4,46,50
2011-02-07,0,Feb,16,0,Mon,1,16,98,114
2011-02-07,0,Feb,17,0,Mon,1,9,207,216
2011-02-07,0,Feb,18,0,Mon,1,5,170,175
2011-02-07,0,Feb,19,0,Mon,1,5,123,128
2011-02-07,0,Feb,20,0,Mon,1,6,82,88
2011-02-07,0,Feb,21,0,Mon,1,3,75,78
2011-02-07,0,Feb,22,0,Mon,1,3,34,37
2011-02-07,0,Feb,23,0,Mon,1,6,19,25
2011-02-08,0,Feb,0,0,Tue,1,4,6,10
2011-02-08,0,Feb,1,0,Tue,1,0,4,4
2011-02-08,0,Feb,2,0,Tue,1,1,1,2
2011-02-08,0,Feb,3,0,Tue,1,0,1,1
2011-02-08,0,Feb,4,0,Tue,1,0,3,3
2011-02-08,0,Feb,5,0,Tue,1,0,2,2
2011-02-08,0,Feb,6,0,Tue,1,0,39,39
2011-02-08,0,Feb,7,0,Tue,1,3,97,100
2011-02-08,0,Feb,8,0,Tue,1,7,236,243
2011-02-08,0,Feb,9,0,Tue,1,7,128,135
2011-02-08,0,Feb,10,0,Tue,1,4,44,48
2011-02-08,0,Feb,11,0,Tue,1,1,49,50
2011-02-08,0,Feb,12,0,Tue,1,2,63,65
2011-02-08,0,Feb,13,0,Tue,1,2,48,50
2011-02-08,0,Feb,14,0,Tue,1,3,61,64
2011-02-08,0,Feb,15,0,Tue,1,6,45,51
2011-02-08,0,Feb,16,0,Tue,1,4,79,83
2011-02-08,0,Feb,17,0,Tue,1,4,172,176
2011-02-08,0,Feb,18,0,Tue,1,1,151,152
2011-02-08,0,Feb,19,0,Tue,1,1,100,101
2011-02-08,0,Feb,20,0,Tue,1,3,53,56
2011-02-08,0,Feb,21,0,Tue,1,8,46,54
2011-02-08,0,Feb,22,0,Tue,1,0,29,29
2011-02-08,0,Feb,23,0,Tue,1,3,9,12
2011-02-09,0,Feb,0,0,Wed,1,0,17,17
2011-02-09,0,Feb,1,0,Wed,1,0,7,7
2011-02-09,0,Feb,2,0,Wed,1,1,2,3
2011-02-09,0,Feb,3,0,Wed,1,0,2,2
2011-02-09,0,Feb,5,0,Wed,1,0,7,7
2011-02-09,0,Feb,6,0,Wed,1,0,43,43
2011-02-09,0,Feb,7,0,Wed,1,4,95,99
2011-02-09,0,Feb,8,0,Wed,1,1,198,199
2011-02-09,0,Feb,9,0,Wed,1,4,119,123
2011-02-09,0,Feb,10,0,Wed,1,8,51,59
2011-02-09,0,Feb,11,0,Wed,1,1,40,41
2011-02-09,0,Feb,12,0,Wed,1,4,57,61
2011-02-09,0,Feb,13,0,Wed,1,2,67,69
2011-02-09,0,Feb,14,0,Wed,1,2,56,58
2011-02-09,0,Feb,15,0,Wed,1,3,61,64
2011-02-09,0,Feb,16,0,Wed,1,7,72,79
2011-02-09,0,Feb,17,0,Wed,1,9,157,166
2011-02-09,0,Feb,18,0,Wed,1,2,168,170
2011-02-09,0,Feb,19,0,Wed,1,1,87,88
2011-02-09,0,Feb,20,0,Wed,1,0,84,84
2011-02-09,0,Feb,21,0,Wed,1,0,83,83
2011-02-09,0,Feb,22,0,Wed,1,4,42,46
2011-02-09,0,Feb,23,0,Wed,1,0,37,37
2011-02-10,0,Feb,0,0,Thur,1,0,16,16
2011-02-10,0,Feb,1,0,Thur,1,0,7,7
2011-02-10,0,Feb,2,0,Thur,1,0,3,3
2011-02-10,0,Feb,4,0,Thur,1,0,1,1
2011-02-10,0,Feb,5,0,Thur,1,0,6,6
2011-02-10,0,Feb,6,0,Thur,1,0,26,26
2011-02-10,0,Feb,7,0,Thur,1,0,99,99
2011-02-10,0,Feb,8,0,Thur,1,5,173,178
2011-02-10,0,Feb,9,0,Thur,1,1,121,122
2011-02-10,0,Feb,10,0,Thur,1,1,34,35
2011-02-10,0,Feb,11,0,Thur,1,1,44,45
2011-02-10,0,Feb,12,0,Thur,1,4,65,69
2011-02-10,0,Feb,13,0,Thur,1,3,59,62
2011-02-10,0,Feb,14,0,Thur,1,6,42,48
2011-02-10,0,Feb,15,0,Thur,1,0,50,50
2011-02-10,0,Feb,16,0,Thur,1,4,76,80
2011-02-10,0,Feb,17,0,Thur,1,6,159,165
2011-02-10,0,Feb,18,0,Thur,1,3,157,160
2011-02-10,0,Feb,19,0,Thur,1,2,110,112
2011-02-10,0,Feb,20,0,Thur,1,4,93,97
2011-02-10,0,Feb,21,0,Thur,1,2,70,72
2011-02-10,0,Feb,22,0,Thur,1,4,47,51
2011-02-10,0,Feb,23,0,Thur,1,1,33,34
2011-02-11,0,Feb,0,0,Fri,1,2,12,14
2011-02-11,0,Feb,1,0,Fri,1,1,6,7
2011-02-11,0,Feb,2,0,Fri,1,0,3,3
2011-02-11,0,Feb,5,0,Fri,1,0,4,4
2011-02-11,0,Feb,6,0,Fri,1,1,23,24
2011-02-11,0,Feb,7,0,Fri,1,1,73,74
2011-02-11,0,Feb,8,0,Fri,1,4,212,216
2011-02-11,0,Feb,9,0,Fri,1,8,132,140
2011-02-11,0,Feb,10,0,Fri,1,5,39,44
2011-02-11,0,Feb,11,0,Fri,1,12,52,64
2011-02-11,0,Feb,12,0,Fri,1,7,64,71
2011-02-11,0,Feb,13,0,Fri,1,21,89,110
2011-02-11,0,Feb,14,0,Fri,1,17,67,84
2011-02-11,0,Feb,15,0,Fri,1,12,62,74
2011-02-11,0,Feb,16,0,Fri,1,14,111,125
2011-02-11,0,Feb,17,0,Fri,1,18,193,211
2011-02-11,0,Feb,18,0,Fri,1,9,165,174
2011-02-11,0,Feb,19,0,Fri,1,7,94,101
2011-02-11,0,Feb,20,0,Fri,1,2,61,63
2011-02-11,0,Feb,21,0,Fri,1,1,46,47
2011-02-11,0,Feb,22,0,Fri,1,2,41,43
2011-02-11,0,Feb,23,0,Fri,1,5,48,53
2011-02-12,0,Feb,0,0,Sat,0,3,27,30
2011-02-12,0,Feb,1,0,Sat,0,2,22,24
2011-02-12,0,Feb,2,0,Sat,0,2,13,15
2011-02-12,0,Feb,3,0,Sat,0,3,7,10
2011-02-12,0,Feb,4,0,Sat,0,0,4,4
2011-02-12,0,Feb,5,0,Sat,0,0,1,1
2011-02-12,0,Feb,6,0,Sat,0,1,1,2
2011-02-12,0,Feb,7,0,Sat,0,2,9,11
2011-02-12,0,Feb,8,0,Sat,0,2,28,30
2011-02-12,0,Feb,9,0,Sat,0,5,38,43
2011-02-12,0,Feb,10,0,Sat,0,13,71,84
2011-02-12,0,Feb,11,0,Sat,0,30,84,114
2011-02-12,0,Feb,12,0,Sat,0,27,93,120
2011-02-12,0,Feb,13,0,Sat,0,32,103,135
2011-02-12,0,Feb,14,0,Sat,0,30,90,120
2011-02-12,0,Feb,15,0,Sat,0,47,127,174
2011-02-12,0,Feb,16,0,Sat,0,42,103,145
2011-02-12,0,Feb,17,0,Sat,0,24,113,137
2011-02-12,0,Feb,18,0,Sat,0,4,60,64
2011-02-12,0,Feb,19,0,Sat,0,2,39,41
2011-02-12,0,Feb,20,0,Sat,0,1,39,40
2011-02-12,0,Feb,21,0,Sat,0,9,42,51
2011-02-12,0,Feb,22,0,Sat,0,6,39,45
2011-02-12,0,Feb,23,0,Sat,0,1,31,32
2011-02-13,0,Feb,0,0,Sun,0,5,34,39
2011-02-13,0,Feb,1,0,Sun,0,1,23,24
2011-02-13,0,Feb,2,0,Sun,0,1,19,20
2011-02-13,0,Feb,3,0,Sun,0,4,8,12
2011-02-13,0,Feb,4,0,Sun,0,0,2,2
2011-02-13,0,Feb,6,0,Sun,0,2,3,5
2011-02-13,0,Feb,7,0,Sun,0,0,3,3
2011-02-13,0,Feb,8,0,Sun,0,1,11,12
2011-02-13,0,Feb,9,0,Sun,0,12,35,47
2011-02-13,0,Feb,10,0,Sun,0,19,86,105
2011-02-13,0,Feb,11,0,Sun,0,26,86,112
2011-02-13,0,Feb,12,0,Sun,0,58,94,152
2011-02-13,0,Feb,13,0,Sun,0,62,92,154
2011-02-13,0,Feb,14,0,Sun,0,51,110,161
2011-02-13,0,Feb,15,0,Sun,0,40,122,162
2011-02-13,0,Feb,16,0,Sun,0,28,106,134
2011-02-13,0,Feb,17,0,Sun,0,30,95,125
2011-02-13,0,Feb,18,0,Sun,0,17,78,95
2011-02-13,0,Feb,19,0,Sun,0,11,50,61
2011-02-13,0,Feb,20,0,Sun,0,15,32,47
2011-02-13,0,Feb,21,0,Sun,0,6,45,51
2011-02-13,0,Feb,22,0,Sun,0,5,31,36
2011-02-13,0,Feb,23,0,Sun,0,3,27,30
2011-02-14,0,Feb,0,0,Mon,1,3,8,11
2011-02-14,0,Feb,1,0,Mon,1,1,6,7
2011-02-14,0,Feb,2,0,Mon,1,0,2,2
2011-02-14,0,Feb,3,0,Mon,1,1,1,2
2011-02-14,0,Feb,4,0,Mon,1,0,2,2
2011-02-14,0,Feb,5,0,Mon,1,0,3,3
2011-02-14,0,Feb,6,0,Mon,1,1,25,26
2011-02-14,0,Feb,7,0,Mon,1,2,96,98
2011-02-14,0,Feb,8,0,Mon,1,7,249,256
2011-02-14,0,Feb,9,0,Mon,1,8,122,130
2011-02-14,0,Feb,10,0,Mon,1,9,46,55
2011-02-14,0,Feb,11,0,Mon,1,10,43,53
2011-02-14,0,Feb,12,0,Mon,1,27,99,126
2011-02-14,0,Feb,13,0,Mon,1,27,93,120
2011-02-14,0,Feb,14,0,Mon,1,14,76,90
2011-02-14,0,Feb,15,0,Mon,1,19,71,90
2011-02-14,0,Feb,16,0,Mon,1,16,102,118
2011-02-14,0,Feb,17,0,Mon,1,25,218,243
2011-02-14,0,Feb,18,0,Mon,1,11,194,205
2011-02-14,0,Feb,19,0,Mon,1,12,86,98
2011-02-14,0,Feb,20,0,Mon,1,5,65,70
2011-02-14,0,Feb,21,0,Mon,1,8,35,43
2011-02-14,0,Feb,22,0,Mon,1,1,44,45
2011-02-14,0,Feb,23,0,Mon,1,1,19,20
2011-02-15,0,Feb,0,0,Tue,1,7,12,19
2011-02-15,0,Feb,1,0,Tue,1,0,5,5
2011-02-15,0,Feb,2,0,Tue,1,1,2,3
2011-02-15,0,Feb,4,0,Tue,1,0,1,1
2011-02-15,0,Feb,5,0,Tue,1,0,4,4
2011-02-15,0,Feb,6,0,Tue,1,0,30,30
2011-02-15,0,Feb,7,0,Tue,1,2,103,105
2011-02-15,0,Feb,8,0,Tue,1,10,213,223
2011-02-15,0,Feb,9,0,Tue,1,2,108,110
2011-02-15,0,Feb,10,0,Tue,1,5,47,52
2011-02-15,0,Feb,11,0,Tue,1,11,46,57
2011-02-15,0,Feb,12,0,Tue,1,6,65,71
2011-02-15,0,Feb,13,0,Tue,1,14,68,82
2011-02-15,0,Feb,14,0,Tue,1,10,69,79
2011-02-15,0,Feb,15,0,Tue,1,11,74,85
2011-02-15,0,Feb,16,0,Tue,1,21,77,98
2011-02-15,0,Feb,17,0,Tue,1,15,191,206
2011-02-15,0,Feb,18,0,Tue,1,14,198,212
2011-02-15,0,Feb,19,0,Tue,1,3,142,145
2011-02-15,0,Feb,20,0,Tue,1,3,98,101
2011-02-15,0,Feb,21,0,Tue,1,5,61,66
2011-02-15,0,Feb,22,0,Tue,1,0,41,41
2011-02-15,0,Feb,23,0,Tue,1,0,20,20
2011-02-16,0,Feb,0,0,Wed,1,0,15,15
2011-02-16,0,Feb,1,0,Wed,1,0,9,9
2011-02-16,0,Feb,3,0,Wed,1,0,1,1
2011-02-16,0,Feb,4,0,Wed,1,0,1,1
2011-02-16,0,Feb,5,0,Wed,1,0,5,5
2011-02-16,0,Feb,6,0,Wed,1,1,32,33
2011-02-16,0,Feb,7,0,Wed,1,5,103,108
2011-02-16,0,Feb,8,0,Wed,1,6,224,230
2011-02-16,0,Feb,9,0,Wed,1,2,122,124
2011-02-16,0,Feb,10,0,Wed,1,14,55,69
2011-02-16,0,Feb,11,0,Wed,1,7,59,66
2011-02-16,0,Feb,12,0,Wed,1,14,72,86
2011-02-16,0,Feb,13,0,Wed,1,13,80,93
2011-02-16,0,Feb,14,0,Wed,1,17,65,82
2011-02-16,0,Feb,15,0,Wed,1,35,82,117
2011-02-16,0,Feb,16,0,Wed,1,26,96,122
2011-02-16,0,Feb,17,0,Wed,1,11,244,255
2011-02-16,0,Feb,18,0,Wed,1,20,202,222
2011-02-16,0,Feb,19,0,Wed,1,18,143,161
2011-02-16,0,Feb,20,0,Wed,1,10,108,118
2011-02-16,0,Feb,21,0,Wed,1,5,87,92
2011-02-16,0,Feb,22,0,Wed,1,12,61,73
2011-02-16,0,Feb,23,0,Wed,1,2,31,33
2011-02-17,0,Feb,0,0,Thur,1,1,16,17
2011-02-17,0,Feb,1,0,Thur,1,0,6,6
2011-02-17,0,Feb,2,0,Thur,1,2,4,6
2011-02-17,0,Feb,3,0,Thur,1,3,1,4
2011-02-17,0,Feb,4,0,Thur,1,3,1,4
2011-02-17,0,Feb,5,0,Thur,1,1,11,12
2011-02-17,0,Feb,6,0,Thur,1,3,44,47
2011-02-17,0,Feb,7,0,Thur,1,7,119,126
2011-02-17,0,Feb,8,0,Thur,1,18,267,285
2011-02-17,0,Feb,9,0,Thur,1,16,163,179
2011-02-17,0,Feb,10,0,Thur,1,18,70,88
2011-02-17,0,Feb,11,0,Thur,1,19,71,90
2011-02-17,0,Feb,12,0,Thur,1,15,86,101
2011-02-17,0,Feb,13,0,Thur,1,15,108,123
2011-02-17,0,Feb,14,0,Thur,1,26,55,81
2011-02-17,0,Feb,15,0,Thur,1,15,91,106
2011-02-17,0,Feb,16,0,Thur,1,29,117,146
2011-02-17,0,Feb,17,0,Thur,1,18,256,274
2011-02-17,0,Feb,18,0,Thur,1,11,211,222
2011-02-17,0,Feb,19,0,Thur,1,14,161,175
2011-02-17,0,Feb,20,0,Thur,1,8,131,139
2011-02-17,0,Feb,21,0,Thur,1,5,119,124
2011-02-17,0,Feb,22,0,Thur,1,8,68,76
2011-02-17,0,Feb,23,0,Thur,1,4,40,44
2011-02-18,0,Feb,0,0,Fri,1,12,20,32
2011-02-18,0,Feb,1,0,Fri,1,1,7,8
2011-02-18,0,Feb,2,0,Fri,1,2,5,7
2011-02-18,0,Feb,3,0,Fri,1,2,6,8
2011-02-18,0,Feb,4,0,Fri,1,0,1,1
2011-02-18,0,Feb,5,0,Fri,1,1,6,7
2011-02-18,0,Feb,6,0,Fri,1,2,48,50
2011-02-18,0,Feb,7,0,Fri,1,8,108,116
2011-02-18,0,Feb,8,0,Fri,1,26,246,272
2011-02-18,0,Feb,9,0,Fri,1,15,154,169
2011-02-18,0,Feb,10,0,Fri,1,17,78,95
2011-02-18,0,Feb,11,0,Fri,1,31,82,113
2011-02-18,0,Feb,12,0,Fri,1,59,126,185
2011-02-18,0,Feb,13,0,Fri,1,45,131,176
2011-02-18,0,Feb,14,0,Fri,1,73,118,191
2011-02-18,0,Feb,15,0,Fri,1,55,117,172
2011-02-18,0,Feb,16,0,Fri,1,68,164,232
2011-02-18,0,Feb,17,0,Fri,1,52,275,327
2011-02-18,0,Feb,18,0,Fri,1,29,195,224
2011-02-18,0,Feb,19,0,Fri,1,16,146,162
2011-02-18,0,Feb,20,0,Fri,1,19,105,124
2011-02-18,0,Feb,21,0,Fri,1,11,61,72
2011-02-18,0,Feb,22,0,Fri,1,19,88,107
2011-02-18,0,Feb,23,0,Fri,1,16,61,77
2011-02-19,0,Feb,0,0,Sat,0,6,23,29
2011-02-19,0,Feb,1,0,Sat,0,10,21,31
2011-02-19,0,Feb,2,0,Sat,0,3,14,17
2011-02-19,0,Feb,3,0,Sat,0,0,7,7
2011-02-19,0,Feb,4,0,Sat,0,0,3,3
2011-02-19,0,Feb,5,0,Sat,0,0,3,3
2011-02-19,0,Feb,6,0,Sat,0,3,3,6
2011-02-19,0,Feb,7,0,Sat,0,6,16,22
2011-02-19,0,Feb,8,0,Sat,0,9,36,45
2011-02-19,0,Feb,9,0,Sat,0,18,37,55
2011-02-19,0,Feb,10,0,Sat,0,34,72,106
2011-02-19,0,Feb,11,0,Sat,0,47,76,123
2011-02-19,0,Feb,12,0,Sat,0,38,81,119
2011-02-19,0,Feb,13,0,Sat,0,52,103,155
2011-02-19,0,Feb,14,0,Sat,0,102,94,196
2011-02-19,0,Feb,15,0,Sat,0,84,87,171
2011-02-19,0,Feb,16,0,Sat,0,39,81,120
2011-02-19,0,Feb,17,0,Sat,0,36,91,127
2011-02-19,0,Feb,18,0,Sat,0,21,67,88
2011-02-19,0,Feb,19,0,Sat,0,5,54,59
2011-02-19,0,Feb,20,0,Sat,0,9,38,47
2011-02-19,0,Feb,21,0,Sat,0,4,29,33
2011-02-19,0,Feb,22,0,Sat,0,2,42,44
2011-02-19,0,Feb,23,0,Sat,0,4,25,29
2011-02-20,0,Feb,0,0,Sun,0,3,14,17
2011-02-20,0,Feb,1,0,Sun,0,5,11,16
2011-02-20,0,Feb,2,0,Sun,0,0,17,17
2011-02-20,0,Feb,3,0,Sun,0,9,9,18
2011-02-20,0,Feb,4,0,Sun,0,0,1,1
2011-02-20,0,Feb,6,0,Sun,0,1,1,2
2011-02-20,0,Feb,7,0,Sun,0,0,2,2
2011-02-20,0,Feb,8,0,Sun,0,2,22,24
2011-02-20,0,Feb,9,0,Sun,0,7,48,55
2011-02-20,0,Feb,10,0,Sun,0,34,70,104
2011-02-20,0,Feb,11,0,Sun,0,72,89,161
2011-02-20,0,Feb,12,0,Sun,0,62,120,182
2011-02-20,0,Feb,13,0,Sun,0,76,122,198
2011-02-20,0,Feb,14,0,Sun,0,108,104,212
2011-02-20,0,Feb,15,0,Sun,0,66,102,168
2011-02-20,0,Feb,16,0,Sun,0,59,88,147
2011-02-20,0,Feb,17,0,Sun,0,60,86,146
2011-02-20,0,Feb,18,0,Sun,0,30,71,101
2011-02-20,0,Feb,19,0,Sun,0,3,39,42
2011-02-20,0,Feb,20,0,Sun,0,12,30,42
2011-02-20,0,Feb,21,0,Sun,0,17,39,56
2011-02-20,0,Feb,22,0,Sun,0,4,43,47
2011-02-20,0,Feb,23,0,Sun,0,9,45,54
2011-02-21,0,Feb,0,1,Mon,0,7,30,37
2011-02-21,0,Feb,1,1,Mon,0,2,11,13
2011-02-21,0,Feb,2,1,Mon,0,1,3,4
2011-02-21,0,Feb,3,1,Mon,0,2,3,5
2011-02-21,0,Feb,4,1,Mon,0,1,0,1
2011-02-21,0,Feb,5,1,Mon,0,1,2,3
2011-02-21,0,Feb,6,1,Mon,0,2,6,8
2011-02-21,0,Feb,7,1,Mon,0,3,16,19
2011-02-21,0,Feb,8,1,Mon,0,7,56,63
2011-02-21,0,Feb,9,1,Mon,0,11,46,57
2011-02-21,0,Feb,10,1,Mon,0,29,52,81
2011-02-21,0,Feb,11,1,Mon,0,20,70,90
2011-02-21,0,Feb,12,1,Mon,0,26,67,93
2011-02-21,0,Feb,13,1,Mon,0,28,75,103
2011-02-21,0,Feb,14,1,Mon,0,15,101,116
2011-02-21,0,Feb,15,1,Mon,0,11,76,87
2011-02-21,0,Feb,16,1,Mon,0,8,48,56
2011-02-21,0,Feb,17,1,Mon,0,18,62,80
2011-02-21,0,Feb,18,1,Mon,0,2,64,66
2011-02-21,0,Feb,19,1,Mon,0,0,49,49
2011-02-21,0,Feb,20,1,Mon,0,0,29,29
2011-02-21,0,Feb,21,1,Mon,0,1,33,34
2011-02-21,0,Feb,22,1,Mon,0,0,11,11
2011-02-21,0,Feb,23,1,Mon,0,0,2,2
2011-02-22,0,Feb,6,0,Tue,1,0,7,7
2011-02-22,0,Feb,7,0,Tue,1,0,40,40
2011-02-22,0,Feb,8,0,Tue,1,7,107,114
2011-02-22,0,Feb,9,0,Tue,1,5,101,106
2011-02-22,0,Feb,10,0,Tue,1,0,44,44
2011-02-22,0,Feb,11,0,Tue,1,7,43,50
2011-02-22,0,Feb,12,0,Tue,1,7,48,55
2011-02-22,0,Feb,13,0,Tue,1,3,52,55
2011-02-22,0,Feb,14,0,Tue,1,9,49,58
2011-02-22,0,Feb,15,0,Tue,1,2,67,69
2011-02-22,0,Feb,16,0,Tue,1,7,79,86
2011-02-22,0,Feb,17,0,Tue,1,8,188,196
2011-02-22,0,Feb,18,0,Tue,1,6,161,167
2011-02-22,0,Feb,19,0,Tue,1,4,114,118
2011-02-22,0,Feb,20,0,Tue,1,3,102,105
2011-02-22,0,Feb,21,0,Tue,1,2,80,82
2011-02-22,0,Feb,22,0,Tue,1,1,76,77
2011-02-22,0,Feb,23,0,Tue,1,3,18,21
2011-02-23,0,Feb,0,0,Wed,1,0,6,6
2011-02-23,0,Feb,1,0,Wed,1,0,4,4
2011-02-23,0,Feb,2,0,Wed,1,0,1,1
2011-02-23,0,Feb,3,0,Wed,1,0,2,2
2011-02-23,0,Feb,5,0,Wed,1,0,8,8
2011-02-23,0,Feb,6,0,Wed,1,0,36,36
2011-02-23,0,Feb,7,0,Wed,1,2,94,96
2011-02-23,0,Feb,8,0,Wed,1,8,227,235
2011-02-23,0,Feb,9,0,Wed,1,9,130,139
2011-02-23,0,Feb,10,0,Wed,1,4,47,51
2011-02-23,0,Feb,11,0,Wed,1,16,53,69
2011-02-23,0,Feb,12,0,Wed,1,11,56,67
2011-02-23,0,Feb,13,0,Wed,1,9,78,87
2011-02-23,0,Feb,14,0,Wed,1,17,61,78
2011-02-23,0,Feb,15,0,Wed,1,18,54,72
2011-02-23,0,Feb,16,0,Wed,1,15,79,94
2011-02-23,0,Feb,17,0,Wed,1,15,207,222
2011-02-23,0,Feb,18,0,Wed,1,3,206,209
2011-02-23,0,Feb,19,0,Wed,1,6,135,141
2011-02-23,0,Feb,20,0,Wed,1,2,107,109
2011-02-23,0,Feb,21,0,Wed,1,2,89,91
2011-02-23,0,Feb,22,0,Wed,1,1,60,61
2011-02-23,0,Feb,23,0,Wed,1,1,38,39
2011-02-24,0,Feb,0,0,Thur,1,0,11,11
2011-02-24,0,Feb,1,0,Thur,1,0,7,7
2011-02-24,0,Feb,2,0,Thur,1,0,4,4
2011-02-24,0,Feb,3,0,Thur,1,0,2,2
2011-02-24,0,Feb,5,0,Thur,1,1,3,4
2011-02-24,0,Feb,6,0,Thur,1,0,58,58
2011-02-24,0,Feb,7,0,Thur,1,0,104,104
2011-02-24,0,Feb,8,0,Thur,1,8,244,252
2011-02-24,0,Feb,9,0,Thur,1,4,133,137
2011-02-24,0,Feb,10,0,Thur,1,8,49,57
2011-02-24,0,Feb,11,0,Thur,1,8,71,79
2011-02-24,0,Feb,12,0,Thur,1,10,85,95
2011-02-24,0,Feb,13,0,Thur,1,16,72,88
2011-02-24,0,Feb,14,0,Thur,1,2,67,69
2011-02-24,0,Feb,15,0,Thur,1,5,58,63
2011-02-24,0,Feb,16,0,Thur,1,4,67,71
2011-02-24,0,Feb,17,0,Thur,1,9,168,177
2011-02-24,0,Feb,18,0,Thur,1,5,132,137
2011-02-24,0,Feb,19,0,Thur,1,3,112,115
2011-02-24,0,Feb,20,0,Thur,1,2,87,89
2011-02-24,0,Feb,21,0,Thur,1,7,76,83
2011-02-24,0,Feb,22,0,Thur,1,5,50,55
2011-02-24,0,Feb,23,0,Thur,1,3,47,50
2011-02-25,0,Feb,0,0,Fri,1,1,8,9
2011-02-25,0,Feb,1,0,Fri,1,1,9,10
2011-02-25,0,Feb,2,0,Fri,1,0,3,3
2011-02-25,0,Feb,3,0,Fri,1,1,1,2
2011-02-25,0,Feb,5,0,Fri,1,1,5,6
2011-02-25,0,Feb,6,0,Fri,1,0,11,11
2011-02-25,0,Feb,7,0,Fri,1,1,34,35
2011-02-25,0,Feb,8,0,Fri,1,3,70,73
2011-02-25,0,Feb,9,0,Fri,1,3,111,114
2011-02-25,0,Feb,10,0,Fri,1,7,42,49
2011-02-25,0,Feb,11,0,Fri,1,9,50,59
2011-02-25,0,Feb,12,0,Fri,1,20,95,115
2011-02-25,0,Feb,13,0,Fri,1,6,77,83
2011-02-25,0,Feb,14,0,Fri,1,14,71,85
2011-02-25,0,Feb,15,0,Fri,1,5,50,55
2011-02-25,0,Feb,16,0,Fri,1,11,91,102
2011-02-25,0,Feb,17,0,Fri,1,8,181,189
2011-02-25,0,Feb,18,0,Fri,1,7,150,157
2011-02-25,0,Feb,19,0,Fri,1,4,86,90
2011-02-25,0,Feb,20,0,Fri,1,2,60,62
2011-02-25,0,Feb,21,0,Fri,1,7,56,63
2011-02-25,0,Feb,22,0,Fri,1,7,43,50
2011-02-25,0,Feb,23,0,Fri,1,2,37,39
2011-02-26,0,Feb,0,0,Sat,0,3,25,28
2011-02-26,0,Feb,1,0,Sat,0,2,25,27
2011-02-26,0,Feb,2,0,Sat,0,3,9,12
2011-02-26,0,Feb,3,0,Sat,0,1,7,8
2011-02-26,0,Feb,4,0,Sat,0,1,1,2
2011-02-26,0,Feb,5,0,Sat,0,1,9,10
2011-02-26,0,Feb,6,0,Sat,0,1,6,7
2011-02-26,0,Feb,7,0,Sat,0,1,21,22
2011-02-26,0,Feb,8,0,Sat,0,2,55,57
2011-02-26,0,Feb,9,0,Sat,0,9,65,74
2011-02-26,0,Feb,10,0,Sat,0,14,71,85
2011-02-26,0,Feb,11,0,Sat,0,26,100,126
2011-02-26,0,Feb,12,0,Sat,0,45,115,160
2011-02-26,0,Feb,13,0,Sat,0,38,136,174
2011-02-26,0,Feb,14,0,Sat,0,57,154,211
2011-02-26,0,Feb,15,0,Sat,0,40,125,165
2011-02-26,0,Feb,16,0,Sat,0,41,130,171
2011-02-26,0,Feb,17,0,Sat,0,53,130,183
2011-02-26,0,Feb,18,0,Sat,0,26,111,137
2011-02-26,0,Feb,19,0,Sat,0,30,64,94
2011-02-26,0,Feb,20,0,Sat,0,8,60,68
2011-02-26,0,Feb,21,0,Sat,0,9,59,68
2011-02-26,0,Feb,22,0,Sat,0,8,38,46
2011-02-26,0,Feb,23,0,Sat,0,5,29,34
2011-02-27,0,Feb,0,0,Sun,0,8,26,34
2011-02-27,0,Feb,1,0,Sun,0,7,30,37
2011-02-27,0,Feb,2,0,Sun,0,2,20,22
2011-02-27,0,Feb,3,0,Sun,0,3,8,11
2011-02-27,0,Feb,4,0,Sun,0,0,2,2
2011-02-27,0,Feb,6,0,Sun,0,2,1,3
2011-02-27,0,Feb,7,0,Sun,0,6,8,14
2011-02-27,0,Feb,8,0,Sun,0,9,26,35
2011-02-27,0,Feb,9,0,Sun,0,17,42,59
2011-02-27,0,Feb,10,0,Sun,0,24,79,103
2011-02-27,0,Feb,11,0,Sun,0,33,92,125
2011-02-27,0,Feb,12,0,Sun,0,61,132,193
2011-02-27,0,Feb,13,0,Sun,0,90,169,259
2011-02-27,0,Feb,14,0,Sun,0,105,177,282
2011-02-27,0,Feb,15,0,Sun,0,98,163,261
2011-02-27,0,Feb,16,0,Sun,0,98,170,268
2011-02-27,0,Feb,17,0,Sun,0,66,121,187
2011-02-27,0,Feb,18,0,Sun,0,24,103,127
2011-02-27,0,Feb,19,0,Sun,0,16,86,102
2011-02-27,0,Feb,20,0,Sun,0,9,72,81
2011-02-27,0,Feb,21,0,Sun,0,8,61,69
2011-02-27,0,Feb,22,0,Sun,0,2,67,69
2011-02-27,0,Feb,23,0,Sun,0,6,53,59
2011-02-28,0,Feb,0,0,Mon,1,5,25,30
2011-02-28,0,Feb,1,0,Mon,1,1,7,8
2011-02-28,0,Feb,3,0,Mon,1,0,1,1
2011-02-28,0,Feb,5,0,Mon,1,1,4,5
2011-02-28,0,Feb,6,0,Mon,1,1,27,28
2011-02-28,0,Feb,7,0,Mon,1,2,90,92
2011-02-28,0,Feb,8,0,Mon,1,13,242,255
2011-02-28,0,Feb,9,0,Mon,1,15,127,142
2011-02-28,0,Feb,10,0,Mon,1,13,79,92
2011-02-28,0,Feb,11,0,Mon,1,13,74,87
2011-02-28,0,Feb,12,0,Mon,1,0,36,36
2011-02-28,0,Feb,13,0,Mon,1,1,31,32
2011-02-28,0,Feb,14,0,Mon,1,1,24,25
2011-02-28,0,Feb,15,0,Mon,1,0,35,35
2011-02-28,0,Feb,16,0,Mon,1,2,40,42
2011-02-28,0,Feb,17,0,Mon,1,2,77,79
2011-02-28,0,Feb,18,0,Mon,1,4,127,131
2011-02-28,0,Feb,19,0,Mon,1,1,79,80
2011-02-28,0,Feb,20,0,Mon,1,0,45,45
2011-02-28,0,Feb,21,0,Mon,1,2,78,80
2011-02-28,0,Feb,22,0,Mon,1,4,72,76
2011-02-28,0,Feb,23,0,Mon,1,0,45,45
2011-03-01,0,Mar,0,0,Tue,1,0,7,7
2011-03-01,0,Mar,1,0,Tue,1,0,3,3
2011-03-01,0,Mar,2,0,Tue,1,0,4,4
2011-03-01,0,Mar,3,0,Tue,1,0,2,2
2011-03-01,0,Mar,4,0,Tue,1,0,1,1
2011-03-01,0,Mar,5,0,Tue,1,1,1,2
2011-03-01,0,Mar,6,0,Tue,1,0,46,46
2011-03-01,0,Mar,7,0,Tue,1,2,105,107
2011-03-01,0,Mar,8,0,Tue,1,10,204,214
2011-03-01,0,Mar,9,0,Tue,1,8,116,124
2011-03-01,0,Mar,10,0,Tue,1,13,55,68
2011-03-01,0,Mar,11,0,Tue,1,8,48,56
2011-03-01,0,Mar,12,0,Tue,1,6,80,86
2011-03-01,0,Mar,13,0,Tue,1,13,65,78
2011-03-01,0,Mar,14,0,Tue,1,18,61,79
2011-03-01,0,Mar,15,0,Tue,1,7,57,64
2011-03-01,0,Mar,16,0,Tue,1,10,92,102
2011-03-01,0,Mar,17,0,Tue,1,12,230,242
2011-03-01,0,Mar,18,0,Tue,1,10,214,224
2011-03-01,0,Mar,19,0,Tue,1,4,115,119
2011-03-01,0,Mar,20,0,Tue,1,2,86,88
2011-03-01,0,Mar,21,0,Tue,1,8,55,63
2011-03-01,0,Mar,22,0,Tue,1,3,44,47
2011-03-01,0,Mar,23,0,Tue,1,2,23,25
2011-03-02,0,Mar,0,0,Wed,1,3,5,8
2011-03-02,0,Mar,1,0,Wed,1,0,4,4
2011-03-02,0,Mar,2,0,Wed,1,0,2,2
2011-03-02,0,Mar,3,0,Wed,1,3,1,4
2011-03-02,0,Mar,4,0,Wed,1,1,0,1
2011-03-02,0,Mar,5,0,Wed,1,0,5,5
2011-03-02,0,Mar,6,0,Wed,1,1,39,40
2011-03-02,0,Mar,7,0,Wed,1,2,108,110
2011-03-02,0,Mar,8,0,Wed,1,13,243,256
2011-03-02,0,Mar,9,0,Wed,1,7,141,148
2011-03-02,0,Mar,10,0,Wed,1,11,65,76
2011-03-02,0,Mar,11,0,Wed,1,8,65,73
2011-03-02,0,Mar,12,0,Wed,1,20,62,82
2011-03-02,0,Mar,13,0,Wed,1,35,90,125
2011-03-02,0,Mar,14,0,Wed,1,21,75,96
2011-03-02,0,Mar,15,0,Wed,1,19,91,110
2011-03-02,0,Mar,16,0,Wed,1,27,112,139
2011-03-02,0,Mar,17,0,Wed,1,30,238,268
2011-03-02,0,Mar,18,0,Wed,1,8,193,201
2011-03-02,0,Mar,19,0,Wed,1,6,144,150
2011-03-02,0,Mar,20,0,Wed,1,9,86,95
2011-03-02,0,Mar,21,0,Wed,1,3,68,71
2011-03-02,0,Mar,22,0,Wed,1,4,44,48
2011-03-02,0,Mar,23,0,Wed,1,0,22,22
2011-03-03,0,Mar,0,0,Thur,1,3,10,13
2011-03-03,0,Mar,1,0,Thur,1,0,1,1
2011-03-03,0,Mar,2,0,Thur,1,1,2,3
2011-03-03,0,Mar,3,0,Thur,1,0,1,1
2011-03-03,0,Mar,4,0,Thur,1,0,1,1
2011-03-03,0,Mar,5,0,Thur,1,1,7,8
2011-03-03,0,Mar,6,0,Thur,1,1,34,35
2011-03-03,0,Mar,7,0,Thur,1,1,110,111
2011-03-03,0,Mar,8,0,Thur,1,4,216,220
2011-03-03,0,Mar,9,0,Thur,1,10,135,145
2011-03-03,0,Mar,10,0,Thur,1,7,49,56
2011-03-03,0,Mar,11,0,Thur,1,10,40,50
2011-03-03,0,Mar,12,0,Thur,1,7,65,72
2011-03-03,0,Mar,13,0,Thur,1,13,67,80
2011-03-03,0,Mar,14,0,Thur,1,18,60,78
2011-03-03,0,Mar,15,0,Thur,1,6,62,68
2011-03-03,0,Mar,16,0,Thur,1,6,65,71
2011-03-03,0,Mar,17,0,Thur,1,17,185,202
2011-03-03,0,Mar,18,0,Thur,1,6,161,167
2011-03-03,0,Mar,19,0,Thur,1,5,101,106
2011-03-03,0,Mar,20,0,Thur,1,1,69,70
2011-03-03,0,Mar,21,0,Thur,1,3,48,51
2011-03-03,0,Mar,22,0,Thur,1,3,50,53
2011-03-03,0,Mar,23,0,Thur,1,0,23,23
2011-03-04,0,Mar,0,0,Fri,1,0,12,12
2011-03-04,0,Mar,1,0,Fri,1,0,4,4
2011-03-04,0,Mar,2,0,Fri,1,0,2,2
2011-03-04,0,Mar,3,0,Fri,1,0,1,1
2011-03-04,0,Mar,4,0,Fri,1,1,0,1
2011-03-04,0,Mar,5,0,Fri,1,0,7,7
2011-03-04,0,Mar,6,0,Fri,1,1,28,29
2011-03-04,0,Mar,7,0,Fri,1,0,83,83
2011-03-04,0,Mar,8,0,Fri,1,6,222,228
2011-03-04,0,Mar,9,0,Fri,1,12,138,150
2011-03-04,0,Mar,10,0,Fri,1,10,56,66
2011-03-04,0,Mar,11,0,Fri,1,16,73,89
2011-03-04,0,Mar,12,0,Fri,1,10,87,97
2011-03-04,0,Mar,13,0,Fri,1,13,74,87
2011-03-04,0,Mar,14,0,Fri,1,30,65,95
2011-03-04,0,Mar,15,0,Fri,1,31,75,106
2011-03-04,0,Mar,16,0,Fri,1,17,101,118
2011-03-04,0,Mar,17,0,Fri,1,22,206,228
2011-03-04,0,Mar,18,0,Fri,1,15,172,187
2011-03-04,0,Mar,19,0,Fri,1,5,102,107
2011-03-04,0,Mar,20,0,Fri,1,9,78,87
2011-03-04,0,Mar,21,0,Fri,1,6,64,70
2011-03-04,0,Mar,22,0,Fri,1,4,40,44
2011-03-04,0,Mar,23,0,Fri,1,6,40,46
2011-03-05,0,Mar,0,0,Sat,0,4,15,19
2011-03-05,0,Mar,1,0,Sat,0,5,20,25
2011-03-05,0,Mar,2,0,Sat,0,5,15,20
2011-03-05,0,Mar,3,0,Sat,0,0,2,2
2011-03-05,0,Mar,4,0,Sat,0,0,1,1
2011-03-05,0,Mar,5,0,Sat,0,0,3,3
2011-03-05,0,Mar,6,0,Sat,0,1,3,4
2011-03-05,0,Mar,7,0,Sat,0,5,10,15
2011-03-05,0,Mar,8,0,Sat,0,11,34,45
2011-03-05,0,Mar,9,0,Sat,0,15,48,63
2011-03-05,0,Mar,10,0,Sat,0,34,69,103
2011-03-05,0,Mar,11,0,Sat,0,43,116,159
2011-03-05,0,Mar,12,0,Sat,0,46,121,167
2011-03-05,0,Mar,13,0,Sat,0,60,130,190
2011-03-05,0,Mar,14,0,Sat,0,80,118,198
2011-03-05,0,Mar,15,0,Sat,0,83,122,205
2011-03-05,0,Mar,16,0,Sat,0,74,130,204
2011-03-05,0,Mar,17,0,Sat,0,60,104,164
2011-03-05,0,Mar,18,0,Sat,0,37,115,152
2011-03-05,0,Mar,19,0,Sat,0,27,62,89
2011-03-05,0,Mar,20,0,Sat,0,12,58,70
2011-03-05,0,Mar,21,0,Sat,0,12,60,72
2011-03-05,0,Mar,22,0,Sat,0,16,47,63
2011-03-05,0,Mar,23,0,Sat,0,10,34,44
2011-03-06,0,Mar,0,0,Sun,0,11,41,52
2011-03-06,0,Mar,1,0,Sun,0,12,27,39
2011-03-06,0,Mar,2,0,Sun,0,5,27,32
2011-03-06,0,Mar,3,0,Sun,0,2,9,11
2011-03-06,0,Mar,4,0,Sun,0,0,3,3
2011-03-06,0,Mar,6,0,Sun,0,1,1,2
2011-03-06,0,Mar,7,0,Sun,0,0,5,5
2011-03-06,0,Mar,8,0,Sun,0,1,8,9
2011-03-06,0,Mar,9,0,Sun,0,4,18,22
2011-03-06,0,Mar,10,0,Sun,0,4,27,31
2011-03-06,0,Mar,11,0,Sun,0,18,44,62
2011-03-06,0,Mar,12,0,Sun,0,10,69,79
2011-03-06,0,Mar,13,0,Sun,0,22,83,105
2011-03-06,0,Mar,14,0,Sun,0,12,27,39
2011-03-06,0,Mar,15,0,Sun,0,3,4,7
2011-03-06,0,Mar,16,0,Sun,0,3,8,11
2011-03-06,0,Mar,17,0,Sun,0,2,23,25
2011-03-06,0,Mar,18,0,Sun,0,0,23,23
2011-03-06,0,Mar,19,0,Sun,0,0,11,11
2011-03-06,0,Mar,20,0,Sun,0,3,8,11
2011-03-06,0,Mar,21,0,Sun,0,1,6,7
2011-03-06,0,Mar,22,0,Sun,0,0,10,10
2011-03-06,0,Mar,23,0,Sun,0,0,9,9
2011-03-07,0,Mar,0,0,Mon,1,0,4,4
2011-03-07,0,Mar,1,0,Mon,1,0,2,2
2011-03-07,0,Mar,3,0,Mon,1,0,1,1
2011-03-07,0,Mar,4,0,Mon,1,1,0,1
2011-03-07,0,Mar,5,0,Mon,1,0,1,1
2011-03-07,0,Mar,6,0,Mon,1,3,31,34
2011-03-07,0,Mar,7,0,Mon,1,3,88,91
2011-03-07,0,Mar,8,0,Mon,1,11,200,211
2011-03-07,0,Mar,9,0,Mon,1,5,129,134
2011-03-07,0,Mar,10,0,Mon,1,15,43,58
2011-03-07,0,Mar,11,0,Mon,1,19,41,60
2011-03-07,0,Mar,12,0,Mon,1,28,68,96
2011-03-07,0,Mar,13,0,Mon,1,16,54,70
2011-03-07,0,Mar,14,0,Mon,1,21,56,77
2011-03-07,0,Mar,15,0,Mon,1,32,64,96
2011-03-07,0,Mar,16,0,Mon,1,26,96,122
2011-03-07,0,Mar,17,0,Mon,1,27,206,233
2011-03-07,0,Mar,18,0,Mon,1,19,214,233
2011-03-07,0,Mar,19,0,Mon,1,11,134,145
2011-03-07,0,Mar,20,0,Mon,1,5,87,92
2011-03-07,0,Mar,21,0,Mon,1,1,53,54
2011-03-07,0,Mar,22,0,Mon,1,1,34,35
2011-03-07,0,Mar,23,0,Mon,1,0,22,22
2011-03-08,0,Mar,0,0,Tue,1,1,9,10
2011-03-08,0,Mar,1,0,Tue,1,0,4,4
2011-03-08,0,Mar,2,0,Tue,1,1,0,1
2011-03-08,0,Mar,3,0,Tue,1,5,2,7
2011-03-08,0,Mar,4,0,Tue,1,0,2,2
2011-03-08,0,Mar,5,0,Tue,1,2,8,10
2011-03-08,0,Mar,6,0,Tue,1,3,42,45
2011-03-08,0,Mar,7,0,Tue,1,9,119,128
2011-03-08,0,Mar,8,0,Tue,1,10,247,257
2011-03-08,0,Mar,9,0,Tue,1,11,140,151
2011-03-08,0,Mar,10,0,Tue,1,25,46,71
2011-03-08,0,Mar,11,0,Tue,1,26,52,78
2011-03-08,0,Mar,12,0,Tue,1,29,70,99
2011-03-08,0,Mar,13,0,Tue,1,25,73,98
2011-03-08,0,Mar,14,0,Tue,1,16,56,72
2011-03-08,0,Mar,15,0,Tue,1,35,77,112
2011-03-08,0,Mar,16,0,Tue,1,26,82,108
2011-03-08,0,Mar,17,0,Tue,1,39,209,248
2011-03-08,0,Mar,18,0,Tue,1,21,214,235
2011-03-08,0,Mar,19,0,Tue,1,9,141,150
2011-03-08,0,Mar,20,0,Tue,1,2,74,76
2011-03-08,0,Mar,21,0,Tue,1,7,68,75
2011-03-08,0,Mar,22,0,Tue,1,11,44,55
2011-03-08,0,Mar,23,0,Tue,1,3,38,41
2011-03-09,0,Mar,0,0,Wed,1,0,9,9
2011-03-09,0,Mar,1,0,Wed,1,0,4,4
2011-03-09,0,Mar,2,0,Wed,1,1,1,2
2011-03-09,0,Mar,3,0,Wed,1,1,2,3
2011-03-09,0,Mar,4,0,Wed,1,0,2,2
2011-03-09,0,Mar,5,0,Wed,1,1,7,8
2011-03-09,0,Mar,6,0,Wed,1,5,44,49
2011-03-09,0,Mar,7,0,Wed,1,18,123,141
2011-03-09,0,Mar,8,0,Wed,1,11,238,249
2011-03-09,0,Mar,9,0,Wed,1,5,136,141
2011-03-09,0,Mar,10,0,Wed,1,8,49,57
2011-03-09,0,Mar,11,0,Wed,1,15,44,59
2011-03-09,0,Mar,12,0,Wed,1,14,84,98
2011-03-09,0,Mar,13,0,Wed,1,17,82,99
2011-03-09,0,Mar,14,0,Wed,1,10,61,71
2011-03-09,0,Mar,15,0,Wed,1,15,64,79
2011-03-09,0,Mar,16,0,Wed,1,10,102,112
2011-03-09,0,Mar,17,0,Wed,1,18,176,194
2011-03-09,0,Mar,18,0,Wed,1,12,176,188
2011-03-09,0,Mar,19,0,Wed,1,11,123,134
2011-03-09,0,Mar,20,0,Wed,1,4,87,91
2011-03-09,0,Mar,21,0,Wed,1,10,52,62
2011-03-09,0,Mar,22,0,Wed,1,4,17,21
2011-03-09,0,Mar,23,0,Wed,1,1,17,18
2011-03-10,0,Mar,0,0,Thur,1,3,0,3
2011-03-10,0,Mar,1,0,Thur,1,0,2,2
2011-03-10,0,Mar,2,0,Thur,1,0,1,1
2011-03-10,0,Mar,5,0,Thur,1,1,2,3
2011-03-10,0,Mar,6,0,Thur,1,0,12,12
2011-03-10,0,Mar,7,0,Thur,1,1,36,37
2011-03-10,0,Mar,8,0,Thur,1,1,43,44
2011-03-10,0,Mar,9,0,Thur,1,1,23,24
2011-03-10,0,Mar,10,0,Thur,1,0,17,17
2011-03-10,0,Mar,11,0,Thur,1,6,5,11
2011-03-10,0,Mar,12,0,Thur,1,4,30,34
2011-03-10,0,Mar,13,0,Thur,1,1,11,12
2011-03-10,0,Mar,14,0,Thur,1,0,12,12
2011-03-10,0,Mar,15,0,Thur,1,3,11,14
2011-03-10,0,Mar,16,0,Thur,1,1,20,21
2011-03-10,0,Mar,17,0,Thur,1,2,109,111
2011-03-10,0,Mar,18,0,Thur,1,2,80,82
2011-03-10,0,Mar,19,0,Thur,1,5,51,56
2011-03-10,0,Mar,20,0,Thur,1,9,29,38
2011-03-10,0,Mar,21,0,Thur,1,1,27,28
2011-03-10,0,Mar,22,0,Thur,1,4,30,34
2011-03-10,0,Mar,23,0,Thur,1,1,26,27
2011-03-11,0,Mar,0,0,Fri,1,0,6,6
2011-03-11,0,Mar,1,0,Fri,1,0,8,8
2011-03-11,0,Mar,2,0,Fri,1,2,3,5
2011-03-11,0,Mar,3,0,Fri,1,0,2,2
2011-03-11,0,Mar,5,0,Fri,1,1,6,7
2011-03-11,0,Mar,6,0,Fri,1,1,31,32
2011-03-11,0,Mar,7,0,Fri,1,10,104,114
2011-03-11,0,Mar,8,0,Fri,1,15,244,259
2011-03-11,0,Mar,9,0,Fri,1,13,143,156
2011-03-11,0,Mar,10,0,Fri,1,18,60,78
2011-03-11,0,Mar,11,0,Fri,1,14,67,81
2011-03-11,0,Mar,12,0,Fri,1,15,96,111
2011-03-11,0,Mar,13,0,Fri,1,15,92,107
2011-03-11,0,Mar,14,0,Fri,1,25,64,89
2011-03-11,0,Mar,15,0,Fri,1,21,64,85
2011-03-11,0,Mar,16,0,Fri,1,18,95,113
2011-03-11,0,Mar,17,0,Fri,1,23,200,223
2011-03-11,0,Mar,18,0,Fri,1,19,134,153
2011-03-11,0,Mar,19,0,Fri,1,7,111,118
2011-03-11,0,Mar,20,0,Fri,1,6,70,76
2011-03-11,0,Mar,21,0,Fri,1,10,43,53
2011-03-11,0,Mar,22,0,Fri,1,11,53,64
2011-03-11,0,Mar,23,0,Fri,1,3,34,37
2011-03-12,0,Mar,0,0,Sat,0,4,30,34
2011-03-12,0,Mar,1,0,Sat,0,3,15,18
2011-03-12,0,Mar,2,0,Sat,0,0,14,14
2011-03-12,0,Mar,3,0,Sat,0,1,6,7
2011-03-12,0,Mar,4,0,Sat,0,0,1,1
2011-03-12,0,Mar,5,0,Sat,0,0,2,2
2011-03-12,0,Mar,6,0,Sat,0,2,2,4
2011-03-12,0,Mar,7,0,Sat,0,4,19,23
2011-03-12,0,Mar,8,0,Sat,0,9,44,53
2011-03-12,0,Mar,9,0,Sat,0,25,76,101
2011-03-12,0,Mar,10,0,Sat,0,21,78,99
2011-03-12,0,Mar,11,0,Sat,0,36,83,119
2011-03-12,0,Mar,12,0,Sat,0,51,107,158
2011-03-12,0,Mar,13,0,Sat,0,62,95,157
2011-03-12,0,Mar,14,0,Sat,0,70,96,166
2011-03-12,0,Mar,15,0,Sat,0,81,101,182
2011-03-12,0,Mar,16,0,Sat,0,100,144,244
2011-03-12,0,Mar,17,0,Sat,0,99,114,213
2011-03-12,0,Mar,18,0,Sat,0,54,91,145
2011-03-12,0,Mar,19,0,Sat,0,26,86,112
2011-03-12,0,Mar,20,0,Sat,0,22,64,86
2011-03-12,0,Mar,21,0,Sat,0,36,46,82
2011-03-12,0,Mar,22,0,Sat,0,7,56,63
2011-03-12,0,Mar,23,0,Sat,0,11,38,49
2011-03-13,0,Mar,0,0,Sun,0,3,35,38
2011-03-13,0,Mar,1,0,Sun,0,10,23,33
2011-03-13,0,Mar,3,0,Sun,0,6,17,23
2011-03-13,0,Mar,4,0,Sun,0,4,9,13
2011-03-13,0,Mar,5,0,Sun,0,0,3,3
2011-03-13,0,Mar,6,0,Sun,0,0,2,2
2011-03-13,0,Mar,7,0,Sun,0,2,8,10
2011-03-13,0,Mar,8,0,Sun,0,11,23,34
2011-03-13,0,Mar,9,0,Sun,0,8,36,44
2011-03-13,0,Mar,10,0,Sun,0,36,86,122
2011-03-13,0,Mar,11,0,Sun,0,88,93,181
2011-03-13,0,Mar,12,0,Sun,0,74,120,194
2011-03-13,0,Mar,13,0,Sun,0,97,124,221
2011-03-13,0,Mar,14,0,Sun,0,144,106,250
2011-03-13,0,Mar,15,0,Sun,0,149,155,304
2011-03-13,0,Mar,16,0,Sun,0,124,132,256
2011-03-13,0,Mar,17,0,Sun,0,98,143,241
2011-03-13,0,Mar,18,0,Sun,0,55,92,147
2011-03-13,0,Mar,19,0,Sun,0,28,73,101
2011-03-13,0,Mar,20,0,Sun,0,23,54,77
2011-03-13,0,Mar,21,0,Sun,0,9,49,58
2011-03-13,0,Mar,22,0,Sun,0,8,29,37
2011-03-13,0,Mar,23,0,Sun,0,5,23,28
2011-03-14,0,Mar,0,0,Mon,1,4,7,11
2011-03-14,0,Mar,1,0,Mon,1,0,1,1
2011-03-14,0,Mar,2,0,Mon,1,0,1,1
2011-03-14,0,Mar,3,0,Mon,1,0,3,3
2011-03-14,0,Mar,5,0,Mon,1,0,8,8
2011-03-14,0,Mar,6,0,Mon,1,1,27,28
2011-03-14,0,Mar,7,0,Mon,1,4,84,88
2011-03-14,0,Mar,8,0,Mon,1,24,217,241
2011-03-14,0,Mar,9,0,Mon,1,13,127,140
2011-03-14,0,Mar,10,0,Mon,1,27,57,84
2011-03-14,0,Mar,11,0,Mon,1,26,45,71
2011-03-14,0,Mar,12,0,Mon,1,40,54,94
2011-03-14,0,Mar,13,0,Mon,1,24,51,75
2011-03-14,0,Mar,14,0,Mon,1,27,52,79
2011-03-14,0,Mar,15,0,Mon,1,24,77,101
2011-03-14,0,Mar,16,0,Mon,1,27,80,107
2011-03-14,0,Mar,17,0,Mon,1,42,229,271
2011-03-14,0,Mar,18,0,Mon,1,25,210,235
2011-03-14,0,Mar,19,0,Mon,1,17,133,150
2011-03-14,0,Mar,20,0,Mon,1,23,106,129
2011-03-14,0,Mar,21,0,Mon,1,5,58,63
2011-03-14,0,Mar,22,0,Mon,1,4,43,47
2011-03-14,0,Mar,23,0,Mon,1,2,17,19
2011-03-15,0,Mar,0,0,Tue,1,7,7,14
2011-03-15,0,Mar,1,0,Tue,1,4,6,10
2011-03-15,0,Mar,2,0,Tue,1,1,2,3
2011-03-15,0,Mar,4,0,Tue,1,1,1,2
2011-03-15,0,Mar,5,0,Tue,1,0,11,11
2011-03-15,0,Mar,6,0,Tue,1,3,32,35
2011-03-15,0,Mar,7,0,Tue,1,10,109,119
2011-03-15,0,Mar,8,0,Tue,1,23,259,282
2011-03-15,0,Mar,9,0,Tue,1,10,147,157
2011-03-15,0,Mar,10,0,Tue,1,22,56,78
2011-03-15,0,Mar,11,0,Tue,1,27,51,78
2011-03-15,0,Mar,12,0,Tue,1,32,70,102
2011-03-15,0,Mar,13,0,Tue,1,23,74,97
2011-03-15,0,Mar,14,0,Tue,1,14,74,88
2011-03-15,0,Mar,15,0,Tue,1,24,66,90
2011-03-15,0,Mar,16,0,Tue,1,21,93,114
2011-03-15,0,Mar,17,0,Tue,1,22,195,217
2011-03-15,0,Mar,18,0,Tue,1,18,207,225
2011-03-15,0,Mar,19,0,Tue,1,14,138,152
2011-03-15,0,Mar,20,0,Tue,1,9,79,88
2011-03-15,0,Mar,21,0,Tue,1,2,53,55
2011-03-15,0,Mar,22,0,Tue,1,1,20,21
2011-03-15,0,Mar,23,0,Tue,1,1,17,18
2011-03-16,0,Mar,0,0,Wed,1,0,8,8
2011-03-16,0,Mar,1,0,Wed,1,1,2,3
2011-03-16,0,Mar,3,0,Wed,1,1,2,3
2011-03-16,0,Mar,4,0,Wed,1,0,1,1
2011-03-16,0,Mar,5,0,Wed,1,0,3,3
2011-03-16,0,Mar,6,0,Wed,1,1,30,31
2011-03-16,0,Mar,7,0,Wed,1,10,101,111
2011-03-16,0,Mar,8,0,Wed,1,26,227,253
2011-03-16,0,Mar,9,0,Wed,1,10,144,154
2011-03-16,0,Mar,10,0,Wed,1,19,49,68
2011-03-16,0,Mar,11,0,Wed,1,13,62,75
2011-03-16,0,Mar,12,0,Wed,1,23,65,88
2011-03-16,0,Mar,13,0,Wed,1,18,81,99
2011-03-16,0,Mar,14,0,Wed,1,33,67,100
2011-03-16,0,Mar,15,0,Wed,1,22,79,101
2011-03-16,0,Mar,16,0,Wed,1,30,121,151
2011-03-16,0,Mar,17,0,Wed,1,37,216,253
2011-03-16,0,Mar,18,0,Wed,1,26,211,237
2011-03-16,0,Mar,19,0,Wed,1,18,150,168
2011-03-16,0,Mar,20,0,Wed,1,10,111,121
2011-03-16,0,Mar,21,0,Wed,1,3,75,78
2011-03-16,0,Mar,22,0,Wed,1,11,48,59
2011-03-16,0,Mar,23,0,Wed,1,9,18,27
2011-03-17,0,Mar,0,0,Thur,1,4,19,23
2011-03-17,0,Mar,1,0,Thur,1,1,11,12
2011-03-17,0,Mar,2,0,Thur,1,3,5,8
2011-03-17,0,Mar,3,0,Thur,1,1,1,2
2011-03-17,0,Mar,4,0,Thur,1,0,3,3
2011-03-17,0,Mar,5,0,Thur,1,0,13,13
2011-03-17,0,Mar,6,0,Thur,1,4,47,51
2011-03-17,0,Mar,7,0,Thur,1,12,128,140
2011-03-17,0,Mar,8,0,Thur,1,17,282,299
2011-03-17,0,Mar,9,0,Thur,1,23,162,185
2011-03-17,0,Mar,10,0,Thur,1,9,69,78
2011-03-17,0,Mar,11,0,Thur,1,20,66,86
2011-03-17,0,Mar,12,0,Thur,1,24,81,105
2011-03-17,0,Mar,13,0,Thur,1,26,85,111
2011-03-17,0,Mar,14,0,Thur,1,32,87,119
2011-03-17,0,Mar,15,0,Thur,1,30,95,125
2011-03-17,0,Mar,16,0,Thur,1,34,108,142
2011-03-17,0,Mar,17,0,Thur,1,48,265,313
2011-03-17,0,Mar,18,0,Thur,1,50,260,310
2011-03-17,0,Mar,19,0,Thur,1,18,189,207
2011-03-17,0,Mar,20,0,Thur,1,25,112,137
2011-03-17,0,Mar,21,0,Thur,1,19,119,138
2011-03-17,0,Mar,22,0,Thur,1,17,70,87
2011-03-17,0,Mar,23,0,Thur,1,7,43,50
2011-03-18,0,Mar,0,0,Fri,1,5,24,29
2011-03-18,0,Mar,1,0,Fri,1,4,12,16
2011-03-18,0,Mar,2,0,Fri,1,5,9,14
2011-03-18,0,Mar,3,0,Fri,1,1,4,5
2011-03-18,0,Mar,5,0,Fri,1,2,8,10
2011-03-18,0,Mar,6,0,Fri,1,1,35,36
2011-03-18,0,Mar,7,0,Fri,1,11,112,123
2011-03-18,0,Mar,8,0,Fri,1,24,256,280
2011-03-18,0,Mar,9,0,Fri,1,18,192,210
2011-03-18,0,Mar,10,0,Fri,1,43,74,117
2011-03-18,0,Mar,11,0,Fri,1,55,104,159
2011-03-18,0,Mar,12,0,Fri,1,72,123,195
2011-03-18,0,Mar,13,0,Fri,1,57,118,175
2011-03-18,0,Mar,14,0,Fri,1,71,103,174
2011-03-18,0,Mar,15,0,Fri,1,62,111,173
2011-03-18,0,Mar,16,0,Fri,1,67,137,204
2011-03-18,0,Mar,17,0,Fri,1,95,237,332
2011-03-18,0,Mar,18,0,Fri,1,84,247,331
2011-03-18,0,Mar,19,0,Fri,1,58,132,190
2011-03-18,0,Mar,20,0,Fri,1,46,103,149
2011-03-18,0,Mar,21,0,Fri,1,22,91,113
2011-03-18,0,Mar,22,0,Fri,1,55,63,118
2011-03-18,0,Mar,23,0,Fri,1,26,60,86
2011-03-19,0,Mar,0,0,Sat,0,26,50,76
2011-03-19,0,Mar,1,0,Sat,0,16,35,51
2011-03-19,0,Mar,2,0,Sat,0,5,20,25
2011-03-19,0,Mar,3,0,Sat,0,1,7,8
2011-03-19,0,Mar,4,0,Sat,0,1,2,3
2011-03-19,0,Mar,5,0,Sat,0,0,2,2
2011-03-19,0,Mar,6,0,Sat,0,0,10,10
2011-03-19,0,Mar,7,0,Sat,0,4,9,13
2011-03-19,0,Mar,8,0,Sat,0,11,37,48
2011-03-19,0,Mar,9,0,Sat,0,35,41,76
2011-03-19,0,Mar,10,0,Sat,0,55,85,140
2011-03-19,0,Mar,11,0,Sat,0,90,106,196
2011-03-19,0,Mar,12,0,Sat,0,126,141,267
2011-03-19,0,Mar,13,0,Sat,0,174,127,301
2011-03-19,0,Mar,14,0,Sat,0,168,144,312
2011-03-19,0,Mar,15,0,Sat,0,170,143,313
2011-03-19,0,Mar,16,0,Sat,0,175,129,304
2011-03-19,0,Mar,17,0,Sat,0,138,140,278
2011-03-19,0,Mar,18,0,Sat,0,92,125,217
2011-03-19,0,Mar,19,0,Sat,0,38,116,154
2011-03-19,0,Mar,20,0,Sat,0,39,69,108
2011-03-19,0,Mar,21,0,Sat,0,20,73,93
2011-03-19,0,Mar,22,0,Sat,0,27,45,72
2011-03-19,0,Mar,23,0,Sat,0,13,37,50
2011-03-20,0,Mar,0,0,Sun,0,7,33,40
2011-03-20,0,Mar,1,0,Sun,0,2,22,24
2011-03-20,0,Mar,2,0,Sun,0,6,24,30
2011-03-20,0,Mar,3,0,Sun,0,1,11,12
2011-03-20,0,Mar,4,0,Sun,0,2,1,3
2011-03-20,0,Mar,5,0,Sun,0,3,6,9
2011-03-20,0,Mar,6,0,Sun,0,1,3,4
2011-03-20,0,Mar,7,0,Sun,0,5,9,14
2011-03-20,0,Mar,8,0,Sun,0,7,30,37
2011-03-20,0,Mar,9,0,Sun,0,35,43,78
2011-03-20,0,Mar,10,0,Sun,0,55,81,136
2011-03-20,0,Mar,11,0,Sun,0,92,111,203
2011-03-20,0,Mar,12,0,Sun,0,120,108,228
2011-03-20,0,Mar,13,0,Sun,0,88,115,203
2011-03-20,0,Mar,14,0,Sun,0,145,134,279
2011-03-20,0,Mar,15,0,Sun,0,172,136,308
2011-03-20,0,Mar,16,0,Sun,0,92,132,224
2011-03-20,0,Mar,17,0,Sun,0,83,143,226
2011-03-20,0,Mar,18,0,Sun,0,58,98,156
2011-03-20,0,Mar,19,0,Sun,0,21,58,79
2011-03-20,0,Mar,20,0,Sun,0,21,46,67
2011-03-20,0,Mar,21,0,Sun,0,10,39,49
2011-03-20,0,Mar,22,0,Sun,0,8,30,38
2011-03-20,0,Mar,23,0,Sun,0,13,11,24
2011-03-21,0,Mar,0,0,Mon,1,2,11,13
2011-03-21,0,Mar,1,0,Mon,1,1,6,7
2011-03-21,0,Mar,2,0,Mon,1,1,5,6
2011-03-21,0,Mar,3,0,Mon,1,0,1,1
2011-03-21,0,Mar,5,0,Mon,1,1,1,2
2011-03-21,0,Mar,6,0,Mon,1,2,30,32
2011-03-21,0,Mar,7,0,Mon,1,3,15,18
2011-03-21,0,Mar,8,0,Mon,1,3,95,98
2011-03-21,0,Mar,9,0,Mon,1,12,115,127
2011-03-21,0,Mar,10,0,Mon,1,17,45,62
2011-03-21,0,Mar,11,0,Mon,1,32,47,79
2011-03-21,0,Mar,12,0,Mon,1,25,56,81
2011-03-21,0,Mar,13,0,Mon,1,35,77,112
2011-03-21,0,Mar,14,0,Mon,1,36,65,101
2011-03-21,0,Mar,15,0,Mon,1,41,66,107
2011-03-21,0,Mar,16,0,Mon,1,29,112,141
2011-03-21,0,Mar,17,0,Mon,1,41,231,272
2011-03-21,0,Mar,18,0,Mon,1,44,232,276
2011-03-21,0,Mar,19,0,Mon,1,22,199,221
2011-03-21,0,Mar,20,0,Mon,1,16,106,122
2011-03-21,0,Mar,21,0,Mon,1,12,79,91
2011-03-21,0,Mar,22,0,Mon,1,18,60,78
2011-03-21,0,Mar,23,0,Mon,1,8,22,30
2011-03-22,0,Mar,0,0,Tue,1,4,7,11
2011-03-22,0,Mar,1,0,Tue,1,6,13,19
2011-03-22,0,Mar,2,0,Tue,1,0,1,1
2011-03-22,0,Mar,3,0,Tue,1,3,2,5
2011-03-22,0,Mar,4,0,Tue,1,0,1,1
2011-03-22,0,Mar,5,0,Tue,1,1,11,12
2011-03-22,0,Mar,6,0,Tue,1,2,58,60
2011-03-22,0,Mar,7,0,Tue,1,4,132,136
2011-03-22,0,Mar,8,0,Tue,1,24,312,336
2011-03-22,0,Mar,9,0,Tue,1,19,159,178
2011-03-22,0,Mar,10,0,Tue,1,29,95,124
2011-03-22,0,Mar,11,0,Tue,1,22,64,86
2011-03-22,0,Mar,12,0,Tue,1,35,86,121
2011-03-22,0,Mar,13,0,Tue,1,21,85,106
2011-03-22,0,Mar,14,0,Tue,1,30,71,101
2011-03-22,0,Mar,15,0,Tue,1,55,79,134
2011-03-22,0,Mar,16,0,Tue,1,40,125,165
2011-03-22,0,Mar,17,0,Tue,1,42,265,307
2011-03-22,0,Mar,18,0,Tue,1,41,271,312
2011-03-22,0,Mar,19,0,Tue,1,22,142,164
2011-03-22,0,Mar,20,0,Tue,1,19,116,135
2011-03-22,0,Mar,21,0,Tue,1,24,63,87
2011-03-22,0,Mar,22,0,Tue,1,13,57,70
2011-03-22,0,Mar,23,0,Tue,1,4,28,32
2011-03-23,0,Mar,0,0,Wed,1,3,8,11
2011-03-23,0,Mar,1,0,Wed,1,0,7,7
2011-03-23,0,Mar,2,0,Wed,1,1,1,2
2011-03-23,0,Mar,3,0,Wed,1,0,3,3
2011-03-23,0,Mar,5,0,Wed,1,0,10,10
2011-03-23,0,Mar,6,0,Wed,1,1,43,44
2011-03-23,0,Mar,7,0,Wed,1,7,111,118
2011-03-23,0,Mar,8,0,Wed,1,14,247,261
2011-03-23,0,Mar,9,0,Wed,1,8,174,182
2011-03-23,0,Mar,10,0,Wed,1,15,60,75
2011-03-23,0,Mar,11,0,Wed,1,18,53,71
2011-03-23,0,Mar,12,0,Wed,1,14,73,87
2011-03-23,0,Mar,13,0,Wed,1,14,94,108
2011-03-23,0,Mar,14,0,Wed,1,13,71,84
2011-03-23,0,Mar,15,0,Wed,1,11,74,85
2011-03-23,0,Mar,16,0,Wed,1,13,123,136
2011-03-23,0,Mar,17,0,Wed,1,28,245,273
2011-03-23,0,Mar,18,0,Wed,1,20,218,238
2011-03-23,0,Mar,19,0,Wed,1,12,147,159
2011-03-23,0,Mar,20,0,Wed,1,3,72,75
2011-03-23,0,Mar,21,0,Wed,1,0,22,22
2011-03-23,0,Mar,22,0,Wed,1,6,38,44
2011-03-23,0,Mar,23,0,Wed,1,2,24,26
2011-03-24,0,Mar,0,0,Thur,1,0,11,11
2011-03-24,0,Mar,1,0,Thur,1,0,3,3
2011-03-24,0,Mar,2,0,Thur,1,0,6,6
2011-03-24,0,Mar,3,0,Thur,1,1,0,1
2011-03-24,0,Mar,4,0,Thur,1,0,1,1
2011-03-24,0,Mar,5,0,Thur,1,1,8,9
2011-03-24,0,Mar,6,0,Thur,1,0,41,41
2011-03-24,0,Mar,7,0,Thur,1,2,106,108
2011-03-24,0,Mar,8,0,Thur,1,4,120,124
2011-03-24,0,Mar,9,0,Thur,1,3,94,97
2011-03-24,0,Mar,10,0,Thur,1,10,55,65
2011-03-24,0,Mar,11,0,Thur,1,10,61,71
2011-03-24,0,Mar,12,0,Thur,1,12,82,94
2011-03-24,0,Mar,13,0,Thur,1,11,90,101
2011-03-24,0,Mar,14,0,Thur,1,17,66,83
2011-03-24,0,Mar,15,0,Thur,1,13,77,90
2011-03-24,0,Mar,16,0,Thur,1,6,78,84
2011-03-24,0,Mar,17,0,Thur,1,12,221,233
2011-03-24,0,Mar,18,0,Thur,1,17,197,214
2011-03-24,0,Mar,19,0,Thur,1,16,122,138
2011-03-24,0,Mar,20,0,Thur,1,8,110,118
2011-03-24,0,Mar,21,0,Thur,1,11,67,78
2011-03-24,0,Mar,22,0,Thur,1,3,59,62
2011-03-24,0,Mar,23,0,Thur,1,9,24,33
2011-03-25,0,Mar,0,0,Fri,1,1,17,18
2011-03-25,0,Mar,1,0,Fri,1,0,5,5
2011-03-25,0,Mar,2,0,Fri,1,0,5,5
2011-03-25,0,Mar,3,0,Fri,1,0,2,2
2011-03-25,0,Mar,4,0,Fri,1,3,2,5
2011-03-25,0,Mar,5,0,Fri,1,0,9,9
2011-03-25,0,Mar,6,0,Fri,1,0,32,32
2011-03-25,0,Mar,7,0,Fri,1,4,100,104
2011-03-25,0,Mar,8,0,Fri,1,9,228,237
2011-03-25,0,Mar,9,0,Fri,1,16,150,166
2011-03-25,0,Mar,10,0,Fri,1,15,53,68
2011-03-25,0,Mar,11,0,Fri,1,17,58,75
2011-03-25,0,Mar,12,0,Fri,1,37,108,145
2011-03-25,0,Mar,13,0,Fri,1,34,104,138
2011-03-25,0,Mar,14,0,Fri,1,30,103,133
2011-03-25,0,Mar,15,0,Fri,1,43,79,122
2011-03-25,0,Mar,16,0,Fri,1,23,127,150
2011-03-25,0,Mar,17,0,Fri,1,23,202,225
2011-03-25,0,Mar,18,0,Fri,1,8,190,198
2011-03-25,0,Mar,19,0,Fri,1,9,126,135
2011-03-25,0,Mar,20,0,Fri,1,6,75,81
2011-03-25,0,Mar,21,0,Fri,1,11,64,75
2011-03-25,0,Mar,22,0,Fri,1,3,40,43
2011-03-25,0,Mar,23,0,Fri,1,8,31,39
2011-03-26,0,Mar,0,0,Sat,0,3,25,28
2011-03-26,0,Mar,1,0,Sat,0,3,24,27
2011-03-26,0,Mar,2,0,Sat,0,4,21,25
2011-03-26,0,Mar,3,0,Sat,0,2,7,9
2011-03-26,0,Mar,4,0,Sat,0,2,4,6
2011-03-26,0,Mar,5,0,Sat,0,0,8,8
2011-03-26,0,Mar,6,0,Sat,0,2,8,10
2011-03-26,0,Mar,7,0,Sat,0,18,23,41
2011-03-26,0,Mar,8,0,Sat,0,24,42,66
2011-03-26,0,Mar,9,0,Sat,0,32,68,100
2011-03-26,0,Mar,10,0,Sat,0,32,93,125
2011-03-26,0,Mar,11,0,Sat,0,75,93,168
2011-03-26,0,Mar,12,0,Sat,0,98,129,227
2011-03-26,0,Mar,13,0,Sat,0,94,145,239
2011-03-26,0,Mar,14,0,Sat,0,93,123,216
2011-03-26,0,Mar,15,0,Sat,0,110,109,219
2011-03-26,0,Mar,16,0,Sat,0,118,130,248
2011-03-26,0,Mar,17,0,Sat,0,102,101,203
2011-03-26,0,Mar,18,0,Sat,0,64,89,153
2011-03-26,0,Mar,19,0,Sat,0,45,93,138
2011-03-26,0,Mar,20,0,Sat,0,18,67,85
2011-03-26,0,Mar,21,0,Sat,0,15,36,51
2011-03-26,0,Mar,22,0,Sat,0,17,46,63
2011-03-26,0,Mar,23,0,Sat,0,10,31,41
2011-03-27,0,Mar,0,0,Sun,0,5,26,31
2011-03-27,0,Mar,1,0,Sun,0,3,17,20
2011-03-27,0,Mar,2,0,Sun,0,6,15,21
2011-03-27,0,Mar,3,0,Sun,0,0,14,14
2011-03-27,0,Mar,4,0,Sun,0,1,5,6
2011-03-27,0,Mar,6,0,Sun,0,0,2,2
2011-03-27,0,Mar,7,0,Sun,0,0,7,7
2011-03-27,0,Mar,8,0,Sun,0,6,8,14
2011-03-27,0,Mar,9,0,Sun,0,17,37,54
2011-03-27,0,Mar,10,0,Sun,0,27,59,86
2011-03-27,0,Mar,11,0,Sun,0,23,85,108
2011-03-27,0,Mar,12,0,Sun,0,43,120,163
2011-03-27,0,Mar,13,0,Sun,0,47,100,147
2011-03-27,0,Mar,14,0,Sun,0,61,103,164
2011-03-27,0,Mar,15,0,Sun,0,61,111,172
2011-03-27,0,Mar,16,0,Sun,0,45,98,143
2011-03-27,0,Mar,17,0,Sun,0,50,109,159
2011-03-27,0,Mar,18,0,Sun,0,32,105,137
2011-03-27,0,Mar,19,0,Sun,0,23,80,103
2011-03-27,0,Mar,20,0,Sun,0,7,50,57
2011-03-27,0,Mar,21,0,Sun,0,7,29,36
2011-03-27,0,Mar,22,0,Sun,0,5,25,30
2011-03-27,0,Mar,23,0,Sun,0,3,16,19
2011-03-28,0,Mar,0,0,Mon,1,1,11,12
2011-03-28,0,Mar,1,0,Mon,1,2,4,6
2011-03-28,0,Mar,2,0,Mon,1,0,5,5
2011-03-28,0,Mar,3,0,Mon,1,0,2,2
2011-03-28,0,Mar,5,0,Mon,1,0,8,8
2011-03-28,0,Mar,6,0,Mon,1,0,40,40
2011-03-28,0,Mar,7,0,Mon,1,6,104,110
2011-03-28,0,Mar,8,0,Mon,1,15,239,254
2011-03-28,0,Mar,9,0,Mon,1,12,109,121
2011-03-28,0,Mar,10,0,Mon,1,22,47,69
2011-03-28,0,Mar,11,0,Mon,1,18,39,57
2011-03-28,0,Mar,12,0,Mon,1,8,71,79
2011-03-28,0,Mar,13,0,Mon,1,14,69,83
2011-03-28,0,Mar,14,0,Mon,1,15,65,80
2011-03-28,0,Mar,15,0,Mon,1,19,53,72
2011-03-28,0,Mar,16,0,Mon,1,15,117,132
2011-03-28,0,Mar,17,0,Mon,1,25,227,252
2011-03-28,0,Mar,18,0,Mon,1,21,220,241
2011-03-28,0,Mar,19,0,Mon,1,17,156,173
2011-03-28,0,Mar,20,0,Mon,1,5,107,112
2011-03-28,0,Mar,21,0,Mon,1,6,55,61
2011-03-28,0,Mar,22,0,Mon,1,0,40,40
2011-03-28,0,Mar,23,0,Mon,1,1,18,19
2011-03-29,0,Mar,0,0,Tue,1,1,15,16
2011-03-29,0,Mar,1,0,Tue,1,0,4,4
2011-03-29,0,Mar,2,0,Tue,1,0,3,3
2011-03-29,0,Mar,3,0,Tue,1,2,1,3
2011-03-29,0,Mar,4,0,Tue,1,1,1,2
2011-03-29,0,Mar,5,0,Tue,1,0,8,8
2011-03-29,0,Mar,6,0,Tue,1,4,46,50
2011-03-29,0,Mar,7,0,Tue,1,5,128,133
2011-03-29,0,Mar,8,0,Tue,1,19,268,287
2011-03-29,0,Mar,9,0,Tue,1,16,156,172
2011-03-29,0,Mar,10,0,Tue,1,13,46,59
2011-03-29,0,Mar,11,0,Tue,1,18,63,81
2011-03-29,0,Mar,12,0,Tue,1,29,77,106
2011-03-29,0,Mar,13,0,Tue,1,24,80,104
2011-03-29,0,Mar,14,0,Tue,1,20,66,86
2011-03-29,0,Mar,15,0,Tue,1,22,65,87
2011-03-29,0,Mar,16,0,Tue,1,12,124,136
2011-03-29,0,Mar,17,0,Tue,1,34,265,299
2011-03-29,0,Mar,18,0,Tue,1,42,252,294
2011-03-29,0,Mar,19,0,Tue,1,20,170,190
2011-03-29,0,Mar,20,0,Tue,1,13,119,132
2011-03-29,0,Mar,21,0,Tue,1,8,75,83
2011-03-29,0,Mar,22,0,Tue,1,6,49,55
2011-03-29,0,Mar,23,0,Tue,1,8,27,35
2011-03-30,0,Mar,0,0,Wed,1,3,8,11
2011-03-30,0,Mar,1,0,Wed,1,1,9,10
2011-03-30,0,Mar,2,0,Wed,1,0,4,4
2011-03-30,0,Mar,3,0,Wed,1,0,4,4
2011-03-30,0,Mar,4,0,Wed,1,1,0,1
2011-03-30,0,Mar,5,0,Wed,1,0,7,7
2011-03-30,0,Mar,6,0,Wed,1,4,44,48
2011-03-30,0,Mar,7,0,Wed,1,8,128,136
2011-03-30,0,Mar,8,0,Wed,1,16,247,263
2011-03-30,0,Mar,9,0,Wed,1,7,147,154
2011-03-30,0,Mar,10,0,Wed,1,13,51,64
2011-03-30,0,Mar,11,0,Wed,1,26,64,90
2011-03-30,0,Mar,12,0,Wed,1,15,65,80
2011-03-30,0,Mar,13,0,Wed,1,14,84,98
2011-03-30,0,Mar,14,0,Wed,1,16,64,80
2011-03-30,0,Mar,15,0,Wed,1,14,56,70
2011-03-30,0,Mar,16,0,Wed,1,0,36,36
2011-03-30,0,Mar,17,0,Wed,1,11,105,116
2011-03-30,0,Mar,18,0,Wed,1,6,79,85
2011-03-30,0,Mar,19,0,Wed,1,5,67,72
2011-03-30,0,Mar,20,0,Wed,1,4,40,44
2011-03-30,0,Mar,21,0,Wed,1,0,27,27
2011-03-30,0,Mar,22,0,Wed,1,3,21,24
2011-03-30,0,Mar,23,0,Wed,1,1,11,12
2011-03-31,0,Mar,0,0,Thur,1,0,3,3
2011-03-31,0,Mar,1,0,Thur,1,1,4,5
2011-03-31,0,Mar,2,0,Thur,1,0,5,5
2011-03-31,0,Mar,3,0,Thur,1,0,1,1
2011-03-31,0,Mar,4,0,Thur,1,0,2,2
2011-03-31,0,Mar,5,0,Thur,1,0,8,8
2011-03-31,0,Mar,6,0,Thur,1,2,34,36
2011-03-31,0,Mar,7,0,Thur,1,5,87,92
2011-03-31,0,Mar,8,0,Thur,1,7,185,192
2011-03-31,0,Mar,9,0,Thur,1,6,126,132
2011-03-31,0,Mar,10,0,Thur,1,15,54,69
2011-03-31,0,Mar,11,0,Thur,1,6,52,58
2011-03-31,0,Mar,12,0,Thur,1,17,73,90
2011-03-31,0,Mar,13,0,Thur,1,13,55,68
2011-03-31,0,Mar,14,0,Thur,1,27,49,76
2011-03-31,0,Mar,15,0,Thur,1,4,61,65
2011-03-31,0,Mar,16,0,Thur,1,13,72,85
2011-03-31,0,Mar,17,0,Thur,1,15,153,168
2011-03-31,0,Mar,18,0,Thur,1,12,165,177
2011-03-31,0,Mar,19,0,Thur,1,12,118,130
2011-03-31,0,Mar,20,0,Thur,1,6,79,85
2011-03-31,0,Mar,21,0,Thur,1,7,53,60
2011-03-31,0,Mar,22,0,Thur,1,7,44,51
2011-03-31,0,Mar,23,0,Thur,1,4,23,27
2011-04-01,0,Apr,0,0,Fri,1,0,6,6
2011-04-01,0,Apr,1,0,Fri,1,0,4,4
2011-04-01,0,Apr,2,0,Fri,1,0,7,7
2011-04-01,0,Apr,3,0,Fri,1,0,4,4
2011-04-01,0,Apr,4,0,Fri,1,0,3,3
2011-04-01,0,Apr,5,0,Fri,1,1,11,12
2011-04-01,0,Apr,6,0,Fri,1,2,26,28
2011-04-01,0,Apr,7,0,Fri,1,4,91,95
2011-04-01,0,Apr,8,0,Fri,1,8,198,206
2011-04-01,0,Apr,9,0,Fri,1,11,162,173
2011-04-01,0,Apr,10,0,Fri,1,12,63,75
2011-04-01,0,Apr,11,0,Fri,1,17,72,89
2011-04-01,0,Apr,12,0,Fri,1,15,80,95
2011-04-01,0,Apr,13,0,Fri,1,18,92,110
2011-04-01,0,Apr,14,0,Fri,1,26,61,87
2011-04-01,0,Apr,15,0,Fri,1,30,81,111
2011-04-01,0,Apr,16,0,Fri,1,42,125,167
2011-04-01,0,Apr,17,0,Fri,1,36,245,281
2011-04-01,0,Apr,18,0,Fri,1,36,205,241
2011-04-01,0,Apr,19,0,Fri,1,16,120,136
2011-04-01,0,Apr,20,0,Fri,1,2,75,77
2011-04-01,0,Apr,21,0,Fri,1,9,84,93
2011-04-01,0,Apr,22,0,Fri,1,10,64,74
2011-04-01,0,Apr,23,0,Fri,1,12,41,53
2011-04-02,0,Apr,0,0,Sat,0,3,29,32
2011-04-02,0,Apr,1,0,Sat,0,4,28,32
2011-04-02,0,Apr,2,0,Sat,0,1,20,21
2011-04-02,0,Apr,3,0,Sat,0,1,8,9
2011-04-02,0,Apr,4,0,Sat,0,0,5,5
2011-04-02,0,Apr,5,0,Sat,0,1,4,5
2011-04-02,0,Apr,6,0,Sat,0,5,7,12
2011-04-02,0,Apr,7,0,Sat,0,2,16,18
2011-04-02,0,Apr,8,0,Sat,0,10,45,55
2011-04-02,0,Apr,9,0,Sat,0,22,65,87
2011-04-02,0,Apr,10,0,Sat,0,41,113,154
2011-04-02,0,Apr,11,0,Sat,0,72,126,198
2011-04-02,0,Apr,12,0,Sat,0,84,100,184
2011-04-02,0,Apr,13,0,Sat,0,56,81,137
2011-04-02,0,Apr,14,0,Sat,0,97,93,190
2011-04-02,0,Apr,15,0,Sat,0,72,64,136
2011-04-02,0,Apr,16,0,Sat,0,111,85,196
2011-04-02,0,Apr,17,0,Sat,0,89,95,184
2011-04-02,0,Apr,18,0,Sat,0,69,110,179
2011-04-02,0,Apr,19,0,Sat,0,71,77,148
2011-04-02,0,Apr,20,0,Sat,0,29,56,85
2011-04-02,0,Apr,21,0,Sat,0,24,53,77
2011-04-02,0,Apr,22,0,Sat,0,14,41,55
2011-04-02,0,Apr,23,0,Sat,0,20,33,53
2011-04-03,0,Apr,0,0,Sun,0,8,31,39
2011-04-03,0,Apr,1,0,Sun,0,8,26,34
2011-04-03,0,Apr,2,0,Sun,0,5,19,24
2011-04-03,0,Apr,3,0,Sun,0,3,8,11
2011-04-03,0,Apr,4,0,Sun,0,3,0,3
2011-04-03,0,Apr,5,0,Sun,0,1,4,5
2011-04-03,0,Apr,6,0,Sun,0,10,23,33
2011-04-03,0,Apr,7,0,Sun,0,13,20,33
2011-04-03,0,Apr,8,0,Sun,0,18,44,62
2011-04-03,0,Apr,9,0,Sun,0,68,74,142
2011-04-03,0,Apr,10,0,Sun,0,111,104,215
2011-04-03,0,Apr,11,0,Sun,0,139,104,243
2011-04-03,0,Apr,12,0,Sun,0,166,147,313
2011-04-03,0,Apr,13,0,Sun,0,219,148,367
2011-04-03,0,Apr,14,0,Sun,0,240,109,349
2011-04-03,0,Apr,15,0,Sun,0,174,118,292
2011-04-03,0,Apr,16,0,Sun,0,147,156,303
2011-04-03,0,Apr,17,0,Sun,0,148,126,274
2011-04-03,0,Apr,18,0,Sun,0,71,101,172
2011-04-03,0,Apr,19,0,Sun,0,51,93,144
2011-04-03,0,Apr,20,0,Sun,0,24,55,79
2011-04-03,0,Apr,21,0,Sun,0,8,37,45
2011-04-03,0,Apr,22,0,Sun,0,7,29,36
2011-04-03,0,Apr,23,0,Sun,0,9,22,31
2011-04-04,0,Apr,0,0,Mon,1,1,5,6
2011-04-04,0,Apr,1,0,Mon,1,7,4,11
2011-04-04,0,Apr,2,0,Mon,1,1,1,2
2011-04-04,0,Apr,3,0,Mon,1,1,0,1
2011-04-04,0,Apr,4,0,Mon,1,1,1,2
2011-04-04,0,Apr,5,0,Mon,1,0,7,7
2011-04-04,0,Apr,6,0,Mon,1,3,43,46
2011-04-04,0,Apr,7,0,Mon,1,7,150,157
2011-04-04,0,Apr,8,0,Mon,1,31,308,339
2011-04-04,0,Apr,9,0,Mon,1,24,134,158
2011-04-04,0,Apr,10,0,Mon,1,35,55,90
2011-04-04,0,Apr,11,0,Mon,1,58,66,124
2011-04-04,0,Apr,12,0,Mon,1,59,98,157
2011-04-04,0,Apr,13,0,Mon,1,47,92,139
2011-04-04,0,Apr,14,0,Mon,1,47,76,123
2011-04-04,0,Apr,15,0,Mon,1,47,96,143
2011-04-04,0,Apr,16,0,Mon,1,59,130,189
2011-04-04,0,Apr,17,0,Mon,1,83,283,366
2011-04-04,0,Apr,18,0,Mon,1,78,308,386
2011-04-04,0,Apr,19,0,Mon,1,51,227,278
2011-04-04,0,Apr,20,0,Mon,1,40,133,173
2011-04-04,0,Apr,21,0,Mon,1,19,76,95
2011-04-04,0,Apr,22,0,Mon,1,17,58,75
2011-04-04,0,Apr,23,0,Mon,1,18,30,48
2011-04-05,0,Apr,0,0,Tue,1,10,12,22
2011-04-05,0,Apr,1,0,Tue,1,10,5,15
2011-04-05,0,Apr,2,0,Tue,1,0,5,5
2011-04-05,0,Apr,3,0,Tue,1,1,3,4
2011-04-05,0,Apr,4,0,Tue,1,0,2,2
2011-04-05,0,Apr,5,0,Tue,1,0,5,5
2011-04-05,0,Apr,6,0,Tue,1,2,36,38
2011-04-05,0,Apr,7,0,Tue,1,10,124,134
2011-04-05,0,Apr,8,0,Tue,1,9,148,157
2011-04-05,0,Apr,9,0,Tue,1,2,44,46
2011-04-05,0,Apr,10,0,Tue,1,3,25,28
2011-04-05,0,Apr,11,0,Tue,1,1,18,19
2011-04-05,0,Apr,12,0,Tue,1,6,32,38
2011-04-05,0,Apr,13,0,Tue,1,5,51,56
2011-04-05,0,Apr,14,0,Tue,1,9,67,76
2011-04-05,0,Apr,15,0,Tue,1,6,62,68
2011-04-05,0,Apr,16,0,Tue,1,17,113,130
2011-04-05,0,Apr,17,0,Tue,1,27,246,273
2011-04-05,0,Apr,18,0,Tue,1,19,248,267
2011-04-05,0,Apr,19,0,Tue,1,12,148,160
2011-04-05,0,Apr,20,0,Tue,1,4,87,91
2011-04-05,0,Apr,21,0,Tue,1,8,81,89
2011-04-05,0,Apr,22,0,Tue,1,3,43,46
2011-04-05,0,Apr,23,0,Tue,1,3,23,26
2011-04-06,0,Apr,0,0,Wed,1,0,15,15
2011-04-06,0,Apr,1,0,Wed,1,0,2,2
2011-04-06,0,Apr,2,0,Wed,1,0,5,5
2011-04-06,0,Apr,3,0,Wed,1,0,4,4
2011-04-06,0,Apr,4,0,Wed,1,0,1,1
2011-04-06,0,Apr,5,0,Wed,1,1,12,13
2011-04-06,0,Apr,6,0,Wed,1,4,52,56
2011-04-06,0,Apr,7,0,Wed,1,3,130,133
2011-04-06,0,Apr,8,0,Wed,1,17,308,325
2011-04-06,0,Apr,9,0,Wed,1,8,157,165
2011-04-06,0,Apr,10,0,Wed,1,21,48,69
2011-04-06,0,Apr,11,0,Wed,1,23,70,93
2011-04-06,0,Apr,12,0,Wed,1,22,112,134
2011-04-06,0,Apr,13,0,Wed,1,29,83,112
2011-04-06,0,Apr,14,0,Wed,1,35,80,115
2011-04-06,0,Apr,15,0,Wed,1,34,83,117
2011-04-06,0,Apr,16,0,Wed,1,27,142,169
2011-04-06,0,Apr,17,0,Wed,1,53,303,356
2011-04-06,0,Apr,18,0,Wed,1,43,282,325
2011-04-06,0,Apr,19,0,Wed,1,36,196,232
2011-04-06,0,Apr,20,0,Wed,1,15,126,141
2011-04-06,0,Apr,21,0,Wed,1,18,84,102
2011-04-06,0,Apr,22,0,Wed,1,13,71,84
2011-04-06,0,Apr,23,0,Wed,1,11,29,40
2011-04-07,0,Apr,0,0,Thur,1,5,15,20
2011-04-07,0,Apr,1,0,Thur,1,2,11,13
2011-04-07,0,Apr,2,0,Thur,1,0,7,7
2011-04-07,0,Apr,3,0,Thur,1,0,3,3
2011-04-07,0,Apr,4,0,Thur,1,0,1,1
2011-04-07,0,Apr,5,0,Thur,1,0,6,6
2011-04-07,0,Apr,6,0,Thur,1,5,59,64
2011-04-07,0,Apr,7,0,Thur,1,8,152,160
2011-04-07,0,Apr,8,0,Thur,1,23,291,314
2011-04-07,0,Apr,9,0,Thur,1,15,155,170
2011-04-07,0,Apr,10,0,Thur,1,29,66,95
2011-04-07,0,Apr,11,0,Thur,1,36,86,122
2011-04-07,0,Apr,12,0,Thur,1,39,114,153
2011-04-07,0,Apr,13,0,Thur,1,36,99,135
2011-04-07,0,Apr,14,0,Thur,1,46,111,157
2011-04-07,0,Apr,15,0,Thur,1,27,133,160
2011-04-07,0,Apr,16,0,Thur,1,52,161,213
2011-04-07,0,Apr,17,0,Thur,1,63,280,343
2011-04-07,0,Apr,18,0,Thur,1,68,265,333
2011-04-07,0,Apr,19,0,Thur,1,34,192,226
2011-04-07,0,Apr,20,0,Thur,1,37,166,203
2011-04-07,0,Apr,21,0,Thur,1,19,89,108
2011-04-07,0,Apr,22,0,Thur,1,18,63,81
2011-04-07,0,Apr,23,0,Thur,1,9,45,54
2011-04-08,0,Apr,0,0,Fri,1,4,21,25
2011-04-08,0,Apr,1,0,Fri,1,3,6,9
2011-04-08,0,Apr,2,0,Fri,1,3,10,13
2011-04-08,0,Apr,3,0,Fri,1,0,1,1
2011-04-08,0,Apr,4,0,Fri,1,0,1,1
2011-04-08,0,Apr,5,0,Fri,1,1,8,9
2011-04-08,0,Apr,6,0,Fri,1,2,33,35
2011-04-08,0,Apr,7,0,Fri,1,4,109,113
2011-04-08,0,Apr,8,0,Fri,1,13,208,221
2011-04-08,0,Apr,9,0,Fri,1,17,168,185
2011-04-08,0,Apr,10,0,Fri,1,10,63,73
2011-04-08,0,Apr,11,0,Fri,1,19,79,98
2011-04-08,0,Apr,12,0,Fri,1,29,51,80
2011-04-08,0,Apr,13,0,Fri,1,7,35,42
2011-04-08,0,Apr,14,0,Fri,1,2,13,15
2011-04-08,0,Apr,15,0,Fri,1,1,24,25
2011-04-08,0,Apr,16,0,Fri,1,2,58,60
2011-04-08,0,Apr,17,0,Fri,1,10,138,148
2011-04-08,0,Apr,18,0,Fri,1,8,54,62
2011-04-08,0,Apr,19,0,Fri,1,1,52,53
2011-04-08,0,Apr,20,0,Fri,1,12,51,63
2011-04-08,0,Apr,21,0,Fri,1,11,43,54
2011-04-08,0,Apr,22,0,Fri,1,9,42,51
2011-04-08,0,Apr,23,0,Fri,1,4,31,35
2011-04-09,0,Apr,0,0,Sat,0,5,26,31
2011-04-09,0,Apr,1,0,Sat,0,3,17,20
2011-04-09,0,Apr,2,0,Sat,0,2,15,17
2011-04-09,0,Apr,3,0,Sat,0,3,11,14
2011-04-09,0,Apr,4,0,Sat,0,0,3,3
2011-04-09,0,Apr,5,0,Sat,0,0,5,5
2011-04-09,0,Apr,6,0,Sat,0,0,13,13
2011-04-09,0,Apr,7,0,Sat,0,8,13,21
2011-04-09,0,Apr,8,0,Sat,0,7,47,54
2011-04-09,0,Apr,9,0,Sat,0,27,71,98
2011-04-09,0,Apr,10,0,Sat,0,43,90,133
2011-04-09,0,Apr,11,0,Sat,0,51,91,142
2011-04-09,0,Apr,12,0,Sat,0,79,123,202
2011-04-09,0,Apr,13,0,Sat,0,114,108,222
2011-04-09,0,Apr,14,0,Sat,0,94,118,212
2011-04-09,0,Apr,15,0,Sat,0,85,116,201
2011-04-09,0,Apr,16,0,Sat,0,73,118,191
2011-04-09,0,Apr,17,0,Sat,0,128,129,257
2011-04-09,0,Apr,18,0,Sat,0,48,129,177
2011-04-09,0,Apr,19,0,Sat,0,47,83,130
2011-04-09,0,Apr,20,0,Sat,0,19,74,93
2011-04-09,0,Apr,21,0,Sat,0,10,65,75
2011-04-09,0,Apr,22,0,Sat,0,21,66,87
2011-04-09,0,Apr,23,0,Sat,0,12,45,57
2011-04-10,0,Apr,0,0,Sun,0,5,48,53
2011-04-10,0,Apr,1,0,Sun,0,6,31,37
2011-04-10,0,Apr,2,0,Sun,0,12,24,36
2011-04-10,0,Apr,3,0,Sun,0,5,11,16
2011-04-10,0,Apr,4,0,Sun,0,3,2,5
2011-04-10,0,Apr,5,0,Sun,0,0,4,4
2011-04-10,0,Apr,6,0,Sun,0,0,4,4
2011-04-10,0,Apr,7,0,Sun,0,3,7,10
2011-04-10,0,Apr,8,0,Sun,0,17,38,55
2011-04-10,0,Apr,9,0,Sun,0,31,50,81
2011-04-10,0,Apr,10,0,Sun,0,69,81,150
2011-04-10,0,Apr,11,0,Sun,0,93,109,202
2011-04-10,0,Apr,12,0,Sun,0,94,136,230
2011-04-10,0,Apr,13,0,Sun,0,121,142,263
2011-04-10,0,Apr,14,0,Sun,0,148,133,281
2011-04-10,0,Apr,15,0,Sun,0,156,141,297
2011-04-10,0,Apr,16,0,Sun,0,135,153,288
2011-04-10,0,Apr,17,0,Sun,0,84,152,236
2011-04-10,0,Apr,18,0,Sun,0,103,137,240
2011-04-10,0,Apr,19,0,Sun,0,47,84,131
2011-04-10,0,Apr,20,0,Sun,0,21,71,92
2011-04-10,0,Apr,21,0,Sun,0,18,77,95
2011-04-10,0,Apr,22,0,Sun,0,12,45,57
2011-04-10,0,Apr,23,0,Sun,0,5,27,32
2011-04-11,0,Apr,0,0,Mon,1,7,16,23
2011-04-11,0,Apr,1,0,Mon,1,1,3,4
2011-04-11,0,Apr,2,0,Mon,1,7,2,9
2011-04-11,0,Apr,4,0,Mon,1,0,1,1
2011-04-11,0,Apr,5,0,Mon,1,1,12,13
2011-04-11,0,Apr,6,0,Mon,1,2,59,61
2011-04-11,0,Apr,7,0,Mon,1,12,164,176
2011-04-11,0,Apr,8,0,Mon,1,28,286,314
2011-04-11,0,Apr,9,0,Mon,1,33,132,165
2011-04-11,0,Apr,10,0,Mon,1,41,55,96
2011-04-11,0,Apr,11,0,Mon,1,45,59,104
2011-04-11,0,Apr,12,0,Mon,1,37,97,134
2011-04-11,0,Apr,13,0,Mon,1,62,77,139
2011-04-11,0,Apr,14,0,Mon,1,60,85,145
2011-04-11,0,Apr,15,0,Mon,1,56,85,141
2011-04-11,0,Apr,16,0,Mon,1,73,162,235
2011-04-11,0,Apr,17,0,Mon,1,100,352,452
2011-04-11,0,Apr,18,0,Mon,1,93,290,383
2011-04-11,0,Apr,19,0,Mon,1,73,211,284
2011-04-11,0,Apr,20,0,Mon,1,44,122,166
2011-04-11,0,Apr,21,0,Mon,1,39,119,158
2011-04-11,0,Apr,22,0,Mon,1,25,66,91
2011-04-11,0,Apr,23,0,Mon,1,16,38,54
2011-04-12,0,Apr,0,0,Tue,1,11,13,24
2011-04-12,0,Apr,1,0,Tue,1,6,7,13
2011-04-12,0,Apr,2,0,Tue,1,7,7,14
2011-04-12,0,Apr,3,0,Tue,1,0,1,1
2011-04-12,0,Apr,4,0,Tue,1,4,2,6
2011-04-12,0,Apr,5,0,Tue,1,1,15,16
2011-04-12,0,Apr,6,0,Tue,1,3,55,58
2011-04-12,0,Apr,7,0,Tue,1,12,177,189
2011-04-12,0,Apr,8,0,Tue,1,15,211,226
2011-04-12,0,Apr,9,0,Tue,1,4,50,54
2011-04-12,0,Apr,10,0,Tue,1,6,34,40
2011-04-12,0,Apr,11,0,Tue,1,11,38,49
2011-04-12,0,Apr,12,0,Tue,1,9,83,92
2011-04-12,0,Apr,13,0,Tue,1,22,84,106
2011-04-12,0,Apr,14,0,Tue,1,16,28,44
2011-04-12,0,Apr,15,0,Tue,1,24,54,78
2011-04-12,0,Apr,16,0,Tue,1,19,80,99
2011-04-12,0,Apr,17,0,Tue,1,29,262,291
2011-04-12,0,Apr,18,0,Tue,1,21,203,224
2011-04-12,0,Apr,19,0,Tue,1,3,127,130
2011-04-12,0,Apr,20,0,Tue,1,9,94,103
2011-04-12,0,Apr,21,0,Tue,1,10,74,84
2011-04-12,0,Apr,22,0,Tue,1,7,47,54
2011-04-12,0,Apr,23,0,Tue,1,8,31,39
2011-04-13,0,Apr,0,0,Wed,1,3,12,15
2011-04-13,0,Apr,1,0,Wed,1,0,1,1
2011-04-13,0,Apr,2,0,Wed,1,0,2,2
2011-04-13,0,Apr,3,0,Wed,1,0,2,2
2011-04-13,0,Apr,4,0,Wed,1,1,2,3
2011-04-13,0,Apr,5,0,Wed,1,1,4,5
2011-04-13,0,Apr,6,0,Wed,1,1,33,34
2011-04-13,0,Apr,7,0,Wed,1,3,67,70
2011-04-13,0,Apr,8,0,Wed,1,6,158,164
2011-04-13,0,Apr,9,0,Wed,1,2,63,65
2011-04-13,0,Apr,10,0,Wed,1,4,42,46
2011-04-13,0,Apr,11,0,Wed,1,4,57,61
2011-04-13,0,Apr,12,0,Wed,1,12,83,95
2011-04-13,0,Apr,13,0,Wed,1,6,55,61
2011-04-13,0,Apr,14,0,Wed,1,24,82,106
2011-04-13,0,Apr,15,0,Wed,1,12,69,81
2011-04-13,0,Apr,16,0,Wed,1,23,119,142
2011-04-13,0,Apr,17,0,Wed,1,25,284,309
2011-04-13,0,Apr,18,0,Wed,1,28,293,321
2011-04-13,0,Apr,19,0,Wed,1,15,160,175
2011-04-13,0,Apr,20,0,Wed,1,7,119,126
2011-04-13,0,Apr,21,0,Wed,1,17,100,117
2011-04-13,0,Apr,22,0,Wed,1,10,89,99
2011-04-13,0,Apr,23,0,Wed,1,5,57,62
2011-04-14,0,Apr,0,0,Thur,1,3,18,21
2011-04-14,0,Apr,1,0,Thur,1,1,9,10
2011-04-14,0,Apr,2,0,Thur,1,0,3,3
2011-04-14,0,Apr,3,0,Thur,1,0,2,2
2011-04-14,0,Apr,4,0,Thur,1,1,8,9
2011-04-14,0,Apr,5,0,Thur,1,2,12,14
2011-04-14,0,Apr,6,0,Thur,1,4,66,70
2011-04-14,0,Apr,7,0,Thur,1,11,182,193
2011-04-14,0,Apr,8,0,Thur,1,21,316,337
2011-04-14,0,Apr,9,0,Thur,1,18,152,170
2011-04-14,0,Apr,10,0,Thur,1,21,68,89
2011-04-14,0,Apr,11,0,Thur,1,28,87,115
2011-04-14,0,Apr,12,0,Thur,1,35,110,145
2011-04-14,0,Apr,13,0,Thur,1,38,121,159
2011-04-14,0,Apr,14,0,Thur,1,36,101,137
2011-04-14,0,Apr,15,0,Thur,1,57,85,142
2011-04-14,0,Apr,16,0,Thur,1,49,153,202
2011-04-14,0,Apr,17,0,Thur,1,50,338,388
2011-04-14,0,Apr,18,0,Thur,1,47,290,337
2011-04-14,0,Apr,19,0,Thur,1,37,222,259
2011-04-14,0,Apr,20,0,Thur,1,22,147,169
2011-04-14,0,Apr,21,0,Thur,1,19,126,145
2011-04-14,0,Apr,22,0,Thur,1,22,82,104
2011-04-14,0,Apr,23,0,Thur,1,7,40,47
2011-04-15,0,Apr,0,1,Fri,0,6,21,27
2011-04-15,0,Apr,1,1,Fri,0,6,9,15
2011-04-15,0,Apr,2,1,Fri,0,8,10,18
2011-04-15,0,Apr,3,1,Fri,0,0,3,3
2011-04-15,0,Apr,4,1,Fri,0,0,3,3
2011-04-15,0,Apr,5,1,Fri,0,2,11,13
2011-04-15,0,Apr,6,1,Fri,0,5,42,47
2011-04-15,0,Apr,7,1,Fri,0,10,139,149
2011-04-15,0,Apr,8,1,Fri,0,21,279,300
2011-04-15,0,Apr,9,1,Fri,0,16,162,178
2011-04-15,0,Apr,10,1,Fri,0,31,91,122
2011-04-15,0,Apr,11,1,Fri,0,41,95,136
2011-04-15,0,Apr,12,1,Fri,0,45,155,200
2011-04-15,0,Apr,13,1,Fri,0,47,133,180
2011-04-15,0,Apr,14,1,Fri,0,57,106,163
2011-04-15,0,Apr,15,1,Fri,0,50,112,162
2011-04-15,0,Apr,16,1,Fri,0,70,173,243
2011-04-15,0,Apr,17,1,Fri,0,64,267,331
2011-04-15,0,Apr,18,1,Fri,0,47,216,263
2011-04-15,0,Apr,19,1,Fri,0,41,168,209
2011-04-15,0,Apr,20,1,Fri,0,26,92,118
2011-04-15,0,Apr,21,1,Fri,0,25,77,102
2011-04-15,0,Apr,22,1,Fri,0,16,64,80
2011-04-15,0,Apr,23,1,Fri,0,8,56,64
2011-04-16,0,Apr,0,0,Sat,0,7,36,43
2011-04-16,0,Apr,1,0,Sat,0,5,28,33
2011-04-16,0,Apr,2,0,Sat,0,5,19,24
2011-04-16,0,Apr,3,0,Sat,0,5,9,14
2011-04-16,0,Apr,4,0,Sat,0,1,4,5
2011-04-16,0,Apr,5,0,Sat,0,1,3,4
2011-04-16,0,Apr,6,0,Sat,0,1,9,10
2011-04-16,0,Apr,7,0,Sat,0,3,18,21
2011-04-16,0,Apr,8,0,Sat,0,7,38,45
2011-04-16,0,Apr,9,0,Sat,0,2,27,29
2011-04-16,0,Apr,10,0,Sat,0,1,21,22
2011-04-16,0,Apr,11,0,Sat,0,4,27,31
2011-04-16,0,Apr,12,0,Sat,0,6,26,32
2011-04-16,0,Apr,13,0,Sat,0,9,49,58
2011-04-16,0,Apr,14,0,Sat,0,14,49,63
2011-04-16,0,Apr,15,0,Sat,0,16,62,78
2011-04-16,0,Apr,16,0,Sat,0,6,27,33
2011-04-16,0,Apr,17,0,Sat,0,1,14,15
2011-04-16,0,Apr,18,0,Sat,0,6,32,38
2011-04-16,0,Apr,19,0,Sat,0,9,62,71
2011-04-16,0,Apr,20,0,Sat,0,4,49,53
2011-04-16,0,Apr,21,0,Sat,0,1,13,14
2011-04-16,0,Apr,22,0,Sat,0,2,22,24
2011-04-16,0,Apr,23,0,Sat,0,5,30,35
2011-04-17,0,Apr,0,0,Sun,0,4,29,33
2011-04-17,0,Apr,1,0,Sun,0,6,25,31
2011-04-17,0,Apr,2,0,Sun,0,4,25,29
2011-04-17,0,Apr,3,0,Sun,0,12,13,25
2011-04-17,0,Apr,4,0,Sun,0,2,5,7
2011-04-17,0,Apr,5,0,Sun,0,2,1,3
2011-04-17,0,Apr,6,0,Sun,0,3,5,8
2011-04-17,0,Apr,7,0,Sun,0,2,14,16
2011-04-17,0,Apr,8,0,Sun,0,7,36,43
2011-04-17,0,Apr,9,0,Sun,0,31,71,102
2011-04-17,0,Apr,10,0,Sun,0,91,120,211
2011-04-17,0,Apr,11,0,Sun,0,119,185,304
2011-04-17,0,Apr,12,0,Sun,0,167,187,354
2011-04-17,0,Apr,13,0,Sun,0,181,162,343
2011-04-17,0,Apr,14,0,Sun,0,170,191,361
2011-04-17,0,Apr,15,0,Sun,0,179,209,388
2011-04-17,0,Apr,16,0,Sun,0,161,182,343
2011-04-17,0,Apr,17,0,Sun,0,143,163,306
2011-04-17,0,Apr,18,0,Sun,0,102,175,277
2011-04-17,0,Apr,19,0,Sun,0,75,135,210
2011-04-17,0,Apr,20,0,Sun,0,44,97,141
2011-04-17,0,Apr,21,0,Sun,0,13,70,83
2011-04-17,0,Apr,22,0,Sun,0,21,49,70
2011-04-17,0,Apr,23,0,Sun,0,19,37,56
2011-04-18,0,Apr,0,0,Mon,1,15,24,39
2011-04-18,0,Apr,1,0,Mon,1,11,8,19
2011-04-18,0,Apr,2,0,Mon,1,14,2,16
2011-04-18,0,Apr,3,0,Mon,1,6,1,7
2011-04-18,0,Apr,4,0,Mon,1,2,4,6
2011-04-18,0,Apr,5,0,Mon,1,0,16,16
2011-04-18,0,Apr,6,0,Mon,1,3,51,54
2011-04-18,0,Apr,7,0,Mon,1,12,156,168
2011-04-18,0,Apr,8,0,Mon,1,20,277,297
2011-04-18,0,Apr,9,0,Mon,1,37,132,169
2011-04-18,0,Apr,10,0,Mon,1,41,68,109
2011-04-18,0,Apr,11,0,Mon,1,36,87,123
2011-04-18,0,Apr,12,0,Mon,1,60,124,184
2011-04-18,0,Apr,13,0,Mon,1,41,128,169
2011-04-18,0,Apr,14,0,Mon,1,49,95,144
2011-04-18,0,Apr,15,0,Mon,1,64,112,176
2011-04-18,0,Apr,16,0,Mon,1,40,165,205
2011-04-18,0,Apr,17,0,Mon,1,66,362,428
2011-04-18,0,Apr,18,0,Mon,1,41,321,362
2011-04-18,0,Apr,19,0,Mon,1,42,244,286
2011-04-18,0,Apr,20,0,Mon,1,29,136,165
2011-04-18,0,Apr,21,0,Mon,1,20,131,151
2011-04-18,0,Apr,22,0,Mon,1,9,81,90
2011-04-18,0,Apr,23,0,Mon,1,11,35,46
2011-04-19,0,Apr,0,0,Tue,1,2,23,25
2011-04-19,0,Apr,1,0,Tue,1,5,2,7
2011-04-19,0,Apr,2,0,Tue,1,8,5,13
2011-04-19,0,Apr,3,0,Tue,1,0,3,3
2011-04-19,0,Apr,4,0,Tue,1,1,4,5
2011-04-19,0,Apr,5,0,Tue,1,1,17,18
2011-04-19,0,Apr,6,0,Tue,1,2,63,65
2011-04-19,0,Apr,7,0,Tue,1,22,166,188
2011-04-19,0,Apr,8,0,Tue,1,20,331,351
2011-04-19,0,Apr,9,0,Tue,1,23,139,162
2011-04-19,0,Apr,10,0,Tue,1,15,60,75
2011-04-19,0,Apr,11,0,Tue,1,19,53,72
2011-04-19,0,Apr,12,0,Tue,1,19,84,103
2011-04-19,0,Apr,13,0,Tue,1,26,103,129
2011-04-19,0,Apr,14,0,Tue,1,19,88,107
2011-04-19,0,Apr,15,0,Tue,1,44,83,127
2011-04-19,0,Apr,16,0,Tue,1,30,162,192
2011-04-19,0,Apr,17,0,Tue,1,39,372,411
2011-04-19,0,Apr,18,0,Tue,1,44,377,421
2011-04-19,0,Apr,19,0,Tue,1,28,248,276
2011-04-19,0,Apr,20,0,Tue,1,20,148,168
2011-04-19,0,Apr,21,0,Tue,1,8,114,122
2011-04-19,0,Apr,22,0,Tue,1,3,109,112
2011-04-19,0,Apr,23,0,Tue,1,11,41,52
2011-04-20,0,Apr,0,0,Wed,1,4,29,33
2011-04-20,0,Apr,1,0,Wed,1,2,5,7
2011-04-20,0,Apr,2,0,Wed,1,0,2,2
2011-04-20,0,Apr,3,0,Wed,1,0,2,2
2011-04-20,0,Apr,4,0,Wed,1,5,4,9
2011-04-20,0,Apr,5,0,Wed,1,1,14,15
2011-04-20,0,Apr,6,0,Wed,1,2,62,64
2011-04-20,0,Apr,7,0,Wed,1,26,211,237
2011-04-20,0,Apr,8,0,Wed,1,22,374,396
2011-04-20,0,Apr,9,0,Wed,1,27,170,197
2011-04-20,0,Apr,10,0,Wed,1,45,86,131
2011-04-20,0,Apr,11,0,Wed,1,31,87,118
2011-04-20,0,Apr,12,0,Wed,1,28,117,145
2011-04-20,0,Apr,13,0,Wed,1,42,135,177
2011-04-20,0,Apr,14,0,Wed,1,33,115,148
2011-04-20,0,Apr,15,0,Wed,1,32,113,145
2011-04-20,0,Apr,16,0,Wed,1,54,201,255
2011-04-20,0,Apr,17,0,Wed,1,34,398,432
2011-04-20,0,Apr,18,0,Wed,1,56,385,441
2011-04-20,0,Apr,19,0,Wed,1,74,309,383
2011-04-20,0,Apr,20,0,Wed,1,31,194,225
2011-04-20,0,Apr,21,0,Wed,1,38,134,172
2011-04-20,0,Apr,22,0,Wed,1,12,105,117
2011-04-20,0,Apr,23,0,Wed,1,14,79,93
2011-04-21,0,Apr,0,0,Thur,1,11,33,44
2011-04-21,0,Apr,1,0,Thur,1,6,20,26
2011-04-21,0,Apr,2,0,Thur,1,3,10,13
2011-04-21,0,Apr,3,0,Thur,1,4,3,7
2011-04-21,0,Apr,4,0,Thur,1,2,4,6
2011-04-21,0,Apr,5,0,Thur,1,0,14,14
2011-04-21,0,Apr,6,0,Thur,1,2,73,75
2011-04-21,0,Apr,7,0,Thur,1,15,183,198
2011-04-21,0,Apr,8,0,Thur,1,19,346,365
2011-04-21,0,Apr,9,0,Thur,1,18,178,196
2011-04-21,0,Apr,10,0,Thur,1,25,73,98
2011-04-21,0,Apr,11,0,Thur,1,34,99,133
2011-04-21,0,Apr,12,0,Thur,1,49,150,199
2011-04-21,0,Apr,13,0,Thur,1,55,122,177
2011-04-21,0,Apr,14,0,Thur,1,68,160,228
2011-04-21,0,Apr,15,0,Thur,1,69,166,235
2011-04-21,0,Apr,16,0,Thur,1,66,228,294
2011-04-21,0,Apr,17,0,Thur,1,79,402,481
2011-04-21,0,Apr,18,0,Thur,1,71,381,452
2011-04-21,0,Apr,19,0,Thur,1,52,272,324
2011-04-21,0,Apr,20,0,Thur,1,28,176,204
2011-04-21,0,Apr,21,0,Thur,1,25,159,184
2011-04-21,0,Apr,22,0,Thur,1,31,106,137
2011-04-21,0,Apr,23,0,Thur,1,13,86,99
2011-04-22,0,Apr,0,0,Fri,1,3,30,33
2011-04-22,0,Apr,1,0,Fri,1,2,22,24
2011-04-22,0,Apr,2,0,Fri,1,2,7,9
2011-04-22,0,Apr,3,0,Fri,1,0,2,2
2011-04-22,0,Apr,4,0,Fri,1,1,2,3
2011-04-22,0,Apr,5,0,Fri,1,0,16,16
2011-04-22,0,Apr,6,0,Fri,1,2,47,49
2011-04-22,0,Apr,7,0,Fri,1,5,175,180
2011-04-22,0,Apr,8,0,Fri,1,15,331,346
2011-04-22,0,Apr,9,0,Fri,1,17,178,195
2011-04-22,0,Apr,10,0,Fri,1,32,104,136
2011-04-22,0,Apr,11,0,Fri,1,23,83,106
2011-04-22,0,Apr,12,0,Fri,1,19,61,80
2011-04-22,0,Apr,13,0,Fri,1,3,37,40
2011-04-22,0,Apr,14,0,Fri,1,3,33,36
2011-04-22,0,Apr,15,0,Fri,1,13,62,75
2011-04-22,0,Apr,16,0,Fri,1,4,58,62
2011-04-22,0,Apr,17,0,Fri,1,6,63,69
2011-04-22,0,Apr,18,0,Fri,1,4,47,51
2011-04-22,0,Apr,19,0,Fri,1,7,48,55
2011-04-22,0,Apr,20,0,Fri,1,8,39,47
2011-04-22,0,Apr,21,0,Fri,1,5,23,28
2011-04-22,0,Apr,22,0,Fri,1,3,21,24
2011-04-22,0,Apr,23,0,Fri,1,0,17,17
2011-04-23,0,Apr,0,0,Sat,0,0,18,18
2011-04-23,0,Apr,1,0,Sat,0,5,11,16
2011-04-23,0,Apr,2,0,Sat,0,3,14,17
2011-04-23,0,Apr,3,0,Sat,0,0,4,4
2011-04-23,0,Apr,4,0,Sat,0,2,3,5
2011-04-23,0,Apr,5,0,Sat,0,1,6,7
2011-04-23,0,Apr,6,0,Sat,0,0,11,11
2011-04-23,0,Apr,7,0,Sat,0,2,17,19
2011-04-23,0,Apr,8,0,Sat,0,15,32,47
2011-04-23,0,Apr,9,0,Sat,0,13,55,68
2011-04-23,0,Apr,10,0,Sat,0,36,93,129
2011-04-23,0,Apr,11,0,Sat,0,68,164,232
2011-04-23,0,Apr,12,0,Sat,0,94,197,291
2011-04-23,0,Apr,13,0,Sat,0,126,186,312
2011-04-23,0,Apr,14,0,Sat,0,182,209,391
2011-04-23,0,Apr,15,0,Sat,0,171,226,397
2011-04-23,0,Apr,16,0,Sat,0,180,246,426
2011-04-23,0,Apr,17,0,Sat,0,168,215,383
2011-04-23,0,Apr,18,0,Sat,0,149,227,376
2011-04-23,0,Apr,19,0,Sat,0,84,199,283
2011-04-23,0,Apr,20,0,Sat,0,45,138,183
2011-04-23,0,Apr,21,0,Sat,0,32,103,135
2011-04-23,0,Apr,22,0,Sat,0,55,114,169
2011-04-23,0,Apr,23,0,Sat,0,31,86,117
2011-04-24,0,Apr,0,0,Sun,0,30,66,96
2011-04-24,0,Apr,1,0,Sun,0,14,40,54
2011-04-24,0,Apr,2,0,Sun,0,27,45,72
2011-04-24,0,Apr,3,0,Sun,0,4,20,24
2011-04-24,0,Apr,4,0,Sun,0,0,5,5
2011-04-24,0,Apr,5,0,Sun,0,5,7,12
2011-04-24,0,Apr,6,0,Sun,0,10,3,13
2011-04-24,0,Apr,7,0,Sun,0,16,11,27
2011-04-24,0,Apr,8,0,Sun,0,38,42,80
2011-04-24,0,Apr,9,0,Sun,0,73,104,177
2011-04-24,0,Apr,10,0,Sun,0,118,171,289
2011-04-24,0,Apr,11,0,Sun,0,124,193,317
2011-04-24,0,Apr,12,0,Sun,0,168,220,388
2011-04-24,0,Apr,13,0,Sun,0,205,236,441
2011-04-24,0,Apr,14,0,Sun,0,197,223,420
2011-04-24,0,Apr,15,0,Sun,0,167,202,369
2011-04-24,0,Apr,16,0,Sun,0,162,197,359
2011-04-24,0,Apr,17,0,Sun,0,142,189,331
2011-04-24,0,Apr,18,0,Sun,0,96,174,270
2011-04-24,0,Apr,19,0,Sun,0,62,132,194
2011-04-24,0,Apr,20,0,Sun,0,34,71,105
2011-04-24,0,Apr,21,0,Sun,0,8,53,61
2011-04-24,0,Apr,22,0,Sun,0,5,40,45
2011-04-24,0,Apr,23,0,Sun,0,5,37,42
2011-04-25,0,Apr,0,0,Mon,1,2,10,12
2011-04-25,0,Apr,1,0,Mon,1,2,8,10
2011-04-25,0,Apr,2,0,Mon,1,1,9,10
2011-04-25,0,Apr,3,0,Mon,1,2,8,10
2011-04-25,0,Apr,4,0,Mon,1,1,4,5
2011-04-25,0,Apr,5,0,Mon,1,3,14,17
2011-04-25,0,Apr,6,0,Mon,1,7,59,66
2011-04-25,0,Apr,7,0,Mon,1,13,183,196
2011-04-25,0,Apr,8,0,Mon,1,27,326,353
2011-04-25,0,Apr,9,0,Mon,1,27,147,174
2011-04-25,0,Apr,10,0,Mon,1,61,64,125
2011-04-25,0,Apr,11,0,Mon,1,53,94,147
2011-04-25,0,Apr,12,0,Mon,1,48,140,188
2011-04-25,0,Apr,13,0,Mon,1,57,146,203
2011-04-25,0,Apr,14,0,Mon,1,47,99,146
2011-04-25,0,Apr,15,0,Mon,1,50,125,175
2011-04-25,0,Apr,16,0,Mon,1,41,198,239
2011-04-25,0,Apr,17,0,Mon,1,80,441,521
2011-04-25,0,Apr,18,0,Mon,1,74,425,499
2011-04-25,0,Apr,19,0,Mon,1,62,320,382
2011-04-25,0,Apr,20,0,Mon,1,42,195,237
2011-04-25,0,Apr,21,0,Mon,1,41,149,190
2011-04-25,0,Apr,22,0,Mon,1,23,83,106
2011-04-25,0,Apr,23,0,Mon,1,9,53,62
2011-04-26,0,Apr,0,0,Tue,1,10,17,27
2011-04-26,0,Apr,1,0,Tue,1,16,5,21
2011-04-26,0,Apr,2,0,Tue,1,17,9,26
2011-04-26,0,Apr,3,0,Tue,1,17,4,21
2011-04-26,0,Apr,4,0,Tue,1,2,4,6
2011-04-26,0,Apr,5,0,Tue,1,0,16,16
2011-04-26,0,Apr,6,0,Tue,1,0,80,80
2011-04-26,0,Apr,7,0,Tue,1,16,254,270
2011-04-26,0,Apr,8,0,Tue,1,32,417,449
2011-04-26,0,Apr,9,0,Tue,1,35,164,199
2011-04-26,0,Apr,10,0,Tue,1,22,98,120
2011-04-26,0,Apr,11,0,Tue,1,40,132,172
2011-04-26,0,Apr,12,0,Tue,1,40,146,186
2011-04-26,0,Apr,13,0,Tue,1,37,139,176
2011-04-26,0,Apr,14,0,Tue,1,40,115,155
2011-04-26,0,Apr,15,0,Tue,1,34,119,153
2011-04-26,0,Apr,16,0,Tue,1,40,251,291
2011-04-26,0,Apr,17,0,Tue,1,66,455,521
2011-04-26,0,Apr,18,0,Tue,1,65,463,528
2011-04-26,0,Apr,19,0,Tue,1,42,286,328
2011-04-26,0,Apr,20,0,Tue,1,35,199,234
2011-04-26,0,Apr,21,0,Tue,1,33,162,195
2011-04-26,0,Apr,22,0,Tue,1,32,116,148
2011-04-26,0,Apr,23,0,Tue,1,7,71,78
2011-04-27,0,Apr,0,0,Wed,1,3,24,27
2011-04-27,0,Apr,1,0,Wed,1,2,15,17
2011-04-27,0,Apr,2,0,Wed,1,0,5,5
2011-04-27,0,Apr,3,0,Wed,1,3,4,7
2011-04-27,0,Apr,4,0,Wed,1,0,6,6
2011-04-27,0,Apr,5,0,Wed,1,1,16,17
2011-04-27,0,Apr,6,0,Wed,1,5,79,84
2011-04-27,0,Apr,7,0,Wed,1,17,229,246
2011-04-27,0,Apr,8,0,Wed,1,31,413,444
2011-04-27,0,Apr,9,0,Wed,1,20,161,181
2011-04-27,0,Apr,10,0,Wed,1,26,66,92
2011-04-27,0,Apr,11,0,Wed,1,53,103,156
2011-04-27,0,Apr,12,0,Wed,1,38,135,173
2011-04-27,0,Apr,13,0,Wed,1,31,119,150
2011-04-27,0,Apr,14,0,Wed,1,29,119,148
2011-04-27,0,Apr,15,0,Wed,1,18,120,138
2011-04-27,0,Apr,16,0,Wed,1,29,189,218
2011-04-27,0,Apr,17,0,Wed,1,63,458,521
2011-04-27,0,Apr,18,0,Wed,1,46,366,412
2011-04-27,0,Apr,19,0,Wed,1,40,220,260
2011-04-27,0,Apr,20,0,Wed,1,30,188,218
2011-04-27,0,Apr,21,0,Wed,1,19,126,145
2011-04-27,0,Apr,22,0,Wed,1,18,111,129
2011-04-27,0,Apr,23,0,Wed,1,25,53,78
2011-04-28,0,Apr,0,0,Thur,1,13,41,54
2011-04-28,0,Apr,1,0,Thur,1,8,12,20
2011-04-28,0,Apr,2,0,Thur,1,14,7,21
2011-04-28,0,Apr,3,0,Thur,1,2,1,3
2011-04-28,0,Apr,4,0,Thur,1,4,5,9
2011-04-28,0,Apr,5,0,Thur,1,0,13,13
2011-04-28,0,Apr,6,0,Thur,1,7,79,86
2011-04-28,0,Apr,7,0,Thur,1,14,201,215
2011-04-28,0,Apr,8,0,Thur,1,31,367,398
2011-04-28,0,Apr,9,0,Thur,1,18,165,183
2011-04-28,0,Apr,10,0,Thur,1,9,45,54
2011-04-28,0,Apr,11,0,Thur,1,10,74,84
2011-04-28,0,Apr,12,0,Thur,1,23,84,107
2011-04-28,0,Apr,13,0,Thur,1,18,103,121
2011-04-28,0,Apr,14,0,Thur,1,21,121,142
2011-04-28,0,Apr,15,0,Thur,1,46,117,163
2011-04-28,0,Apr,16,0,Thur,1,42,228,270
2011-04-28,0,Apr,17,0,Thur,1,49,406,455
2011-04-28,0,Apr,18,0,Thur,1,44,486,530
2011-04-28,0,Apr,19,0,Thur,1,57,347,404
2011-04-28,0,Apr,20,0,Thur,1,49,220,269
2011-04-28,0,Apr,21,0,Thur,1,27,167,194
2011-04-28,0,Apr,22,0,Thur,1,34,119,153
2011-04-28,0,Apr,23,0,Thur,1,29,81,110
2011-04-29,0,Apr,0,0,Fri,1,11,37,48
2011-04-29,0,Apr,1,0,Fri,1,10,21,31
2011-04-29,0,Apr,2,0,Fri,1,2,8,10
2011-04-29,0,Apr,3,0,Fri,1,1,4,5
2011-04-29,0,Apr,4,0,Fri,1,0,6,6
2011-04-29,0,Apr,5,0,Fri,1,0,25,25
2011-04-29,0,Apr,6,0,Fri,1,4,67,71
2011-04-29,0,Apr,7,0,Fri,1,18,222,240
2011-04-29,0,Apr,8,0,Fri,1,35,386,421
2011-04-29,0,Apr,9,0,Fri,1,45,185,230
2011-04-29,0,Apr,10,0,Fri,1,57,99,156
2011-04-29,0,Apr,11,0,Fri,1,49,108,157
2011-04-29,0,Apr,12,0,Fri,1,63,160,223
2011-04-29,0,Apr,13,0,Fri,1,74,234,308
2011-04-29,0,Apr,14,0,Fri,1,58,190,248
2011-04-29,0,Apr,15,0,Fri,1,77,175,252
2011-04-29,0,Apr,16,0,Fri,1,59,240,299
2011-04-29,0,Apr,17,0,Fri,1,75,433,508
2011-04-29,0,Apr,18,0,Fri,1,55,384,439
2011-04-29,0,Apr,19,0,Fri,1,40,230,270
2011-04-29,0,Apr,20,0,Fri,1,34,160,194
2011-04-29,0,Apr,21,0,Fri,1,50,145,195
2011-04-29,0,Apr,22,0,Fri,1,36,110,146
2011-04-29,0,Apr,23,0,Fri,1,25,88,113
2011-04-30,0,Apr,0,0,Sat,0,33,73,106
2011-04-30,0,Apr,1,0,Sat,0,15,59,74
2011-04-30,0,Apr,2,0,Sat,0,12,53,65
2011-04-30,0,Apr,3,0,Sat,0,4,13,17
2011-04-30,0,Apr,4,0,Sat,0,2,5,7
2011-04-30,0,Apr,5,0,Sat,0,3,4,7
2011-04-30,0,Apr,6,0,Sat,0,10,11,21
2011-04-30,0,Apr,7,0,Sat,0,21,27,48
2011-04-30,0,Apr,8,0,Sat,0,21,70,91
2011-04-30,0,Apr,9,0,Sat,0,35,121,156
2011-04-30,0,Apr,10,0,Sat,0,94,185,279
2011-04-30,0,Apr,11,0,Sat,0,120,201,321
2011-04-30,0,Apr,12,0,Sat,0,178,238,416
2011-04-30,0,Apr,13,0,Sat,0,185,270,455
2011-04-30,0,Apr,14,0,Sat,0,184,268,452
2011-04-30,0,Apr,15,0,Sat,0,217,282,499
2011-04-30,0,Apr,16,0,Sat,0,191,273,464
2011-04-30,0,Apr,17,0,Sat,0,162,245,407
2011-04-30,0,Apr,18,0,Sat,0,134,237,371
2011-04-30,0,Apr,19,0,Sat,0,150,237,387
2011-04-30,0,Apr,20,0,Sat,0,65,159,224
2011-04-30,0,Apr,21,0,Sat,0,58,119,177
2011-04-30,0,Apr,22,0,Sat,0,37,106,143
2011-04-30,0,Apr,23,0,Sat,0,34,91,125
2011-05-01,0,May,0,0,Sun,0,19,77,96
2011-05-01,0,May,1,0,Sun,0,9,50,59
2011-05-01,0,May,2,0,Sun,0,7,43,50
2011-05-01,0,May,3,0,Sun,0,8,15,23
2011-05-01,0,May,4,0,Sun,0,6,11,17
2011-05-01,0,May,5,0,Sun,0,0,10,10
2011-05-01,0,May,6,0,Sun,0,4,9,13
2011-05-01,0,May,7,0,Sun,0,7,26,33
2011-05-01,0,May,8,0,Sun,0,16,43,59
2011-05-01,0,May,9,0,Sun,0,45,96,141
2011-05-01,0,May,10,0,Sun,0,109,155,264
2011-05-01,0,May,11,0,Sun,0,109,141,250
2011-05-01,0,May,12,0,Sun,0,109,172,281
2011-05-01,0,May,13,0,Sun,0,123,209,332
2011-05-01,0,May,14,0,Sun,0,85,153,238
2011-05-01,0,May,15,0,Sun,0,113,153,266
2011-05-01,0,May,16,0,Sun,0,75,139,214
2011-05-01,0,May,17,0,Sun,0,60,136,196
2011-05-01,0,May,18,0,Sun,0,33,126,159
2011-05-01,0,May,19,0,Sun,0,47,131,178
2011-05-01,0,May,20,0,Sun,0,35,86,121
2011-05-01,0,May,21,0,Sun,0,23,82,105
2011-05-01,0,May,22,0,Sun,0,32,68,100
2011-05-01,0,May,23,0,Sun,0,64,82,146
2011-05-02,0,May,0,0,Mon,1,68,109,177
2011-05-02,0,May,1,0,Mon,1,41,73,114
2011-05-02,0,May,2,0,Mon,1,16,19,35
2011-05-02,0,May,3,0,Mon,1,9,7,16
2011-05-02,0,May,4,0,Mon,1,9,8,17
2011-05-02,0,May,5,0,Mon,1,4,16,20
2011-05-02,0,May,6,0,Mon,1,3,59,62
2011-05-02,0,May,7,0,Mon,1,16,193,209
2011-05-02,0,May,8,0,Mon,1,21,350,371
2011-05-02,0,May,9,0,Mon,1,41,131,172
2011-05-02,0,May,10,0,Mon,1,31,77,108
2011-05-02,0,May,11,0,Mon,1,34,96,130
2011-05-02,0,May,12,0,Mon,1,40,147,187
2011-05-02,0,May,13,0,Mon,1,51,119,170
2011-05-02,0,May,14,0,Mon,1,48,133,181
2011-05-02,0,May,15,0,Mon,1,45,110,155
2011-05-02,0,May,16,0,Mon,1,49,220,269
2011-05-02,0,May,17,0,Mon,1,65,472,537
2011-05-02,0,May,18,0,Mon,1,68,450,518
2011-05-02,0,May,19,0,Mon,1,46,268,314
2011-05-02,0,May,20,0,Mon,1,44,174,218
2011-05-02,0,May,21,0,Mon,1,54,178,232
2011-05-02,0,May,22,0,Mon,1,28,97,125
2011-05-02,0,May,23,0,Mon,1,16,48,64
2011-05-03,0,May,0,0,Tue,1,0,16,16
2011-05-03,0,May,1,0,Tue,1,0,14,14
2011-05-03,0,May,2,0,Tue,1,0,5,5
2011-05-03,0,May,3,0,Tue,1,0,2,2
2011-05-03,0,May,4,0,Tue,1,3,1,4
2011-05-03,0,May,5,0,Tue,1,0,14,14
2011-05-03,0,May,6,0,Tue,1,7,102,109
2011-05-03,0,May,7,0,Tue,1,17,248,265
2011-05-03,0,May,8,0,Tue,1,24,435,459
2011-05-03,0,May,9,0,Tue,1,29,157,186
2011-05-03,0,May,10,0,Tue,1,36,91,127
2011-05-03,0,May,11,0,Tue,1,20,120,140
2011-05-03,0,May,12,0,Tue,1,48,169,217
2011-05-03,0,May,13,0,Tue,1,50,144,194
2011-05-03,0,May,14,0,Tue,1,36,122,158
2011-05-03,0,May,15,0,Tue,1,37,117,154
2011-05-03,0,May,16,0,Tue,1,46,225,271
2011-05-03,0,May,17,0,Tue,1,53,464,517
2011-05-03,0,May,18,0,Tue,1,59,485,544
2011-05-03,0,May,19,0,Tue,1,42,323,365
2011-05-03,0,May,20,0,Tue,1,28,262,290
2011-05-03,0,May,21,0,Tue,1,42,183,225
2011-05-03,0,May,22,0,Tue,1,14,99,113
2011-05-03,0,May,23,0,Tue,1,12,50,62
2011-05-04,0,May,0,0,Wed,1,5,22,27
2011-05-04,0,May,1,0,Wed,1,1,6,7
2011-05-04,0,May,2,0,Wed,1,0,4,4
2011-05-04,0,May,3,0,Wed,1,0,1,1
2011-05-04,0,May,4,0,Wed,1,1,2,3
2011-05-04,0,May,5,0,Wed,1,1,8,9
2011-05-04,0,May,6,0,Wed,1,0,21,21
2011-05-04,0,May,7,0,Wed,1,6,46,52
2011-05-04,0,May,8,0,Wed,1,5,74,79
2011-05-04,0,May,9,0,Wed,1,5,35,40
2011-05-04,0,May,10,0,Wed,1,5,26,31
2011-05-04,0,May,11,0,Wed,1,3,69,72
2011-05-04,0,May,12,0,Wed,1,19,105,124
2011-05-04,0,May,13,0,Wed,1,15,128,143
2011-05-04,0,May,14,0,Wed,1,13,94,107
2011-05-04,0,May,15,0,Wed,1,22,107,129
2011-05-04,0,May,16,0,Wed,1,22,173,195
2011-05-04,0,May,17,0,Wed,1,22,388,410
2011-05-04,0,May,18,0,Wed,1,29,367,396
2011-05-04,0,May,19,0,Wed,1,30,266,296
2011-05-04,0,May,20,0,Wed,1,17,174,191
2011-05-04,0,May,21,0,Wed,1,17,133,150
2011-05-04,0,May,22,0,Wed,1,9,80,89
2011-05-04,0,May,23,0,Wed,1,8,49,57
2011-05-05,0,May,0,0,Thur,1,4,23,27
2011-05-05,0,May,1,0,Thur,1,4,6,10
2011-05-05,0,May,2,0,Thur,1,1,4,5
2011-05-05,0,May,3,0,Thur,1,0,4,4
2011-05-05,0,May,4,0,Thur,1,4,3,7
2011-05-05,0,May,5,0,Thur,1,1,29,30
2011-05-05,0,May,6,0,Thur,1,3,86,89
2011-05-05,0,May,7,0,Thur,1,16,255,271
2011-05-05,0,May,8,0,Thur,1,25,415,440
2011-05-05,0,May,9,0,Thur,1,20,164,184
2011-05-05,0,May,10,0,Thur,1,30,98,128
2011-05-05,0,May,11,0,Thur,1,43,105,148
2011-05-05,0,May,12,0,Thur,1,27,169,196
2011-05-05,0,May,13,0,Thur,1,50,142,192
2011-05-05,0,May,14,0,Thur,1,19,135,154
2011-05-05,0,May,15,0,Thur,1,27,120,147
2011-05-05,0,May,16,0,Thur,1,36,233,269
2011-05-05,0,May,17,0,Thur,1,66,467,533
2011-05-05,0,May,18,0,Thur,1,64,456,520
2011-05-05,0,May,19,0,Thur,1,56,305,361
2011-05-05,0,May,20,0,Thur,1,33,225,258
2011-05-05,0,May,21,0,Thur,1,39,141,180
2011-05-05,0,May,22,0,Thur,1,30,135,165
2011-05-05,0,May,23,0,Thur,1,16,99,115
2011-05-06,0,May,0,0,Fri,1,13,43,56
2011-05-06,0,May,1,0,Fri,1,8,24,32
2011-05-06,0,May,2,0,Fri,1,1,15,16
2011-05-06,0,May,3,0,Fri,1,3,6,9
2011-05-06,0,May,4,0,Fri,1,0,1,1
2011-05-06,0,May,5,0,Fri,1,0,16,16
2011-05-06,0,May,6,0,Fri,1,8,74,82
2011-05-06,0,May,7,0,Fri,1,20,202,222
2011-05-06,0,May,8,0,Fri,1,35,415,450
2011-05-06,0,May,9,0,Fri,1,27,161,188
2011-05-06,0,May,10,0,Fri,1,30,97,127
2011-05-06,0,May,11,0,Fri,1,42,123,165
2011-05-06,0,May,12,0,Fri,1,48,198,246
2011-05-06,0,May,13,0,Fri,1,71,182,253
2011-05-06,0,May,14,0,Fri,1,86,127,213
2011-05-06,0,May,15,0,Fri,1,89,171,260
2011-05-06,0,May,16,0,Fri,1,82,262,344
2011-05-06,0,May,17,0,Fri,1,83,470,553
2011-05-06,0,May,18,0,Fri,1,85,385,470
2011-05-06,0,May,19,0,Fri,1,39,253,292
2011-05-06,0,May,20,0,Fri,1,29,161,190
2011-05-06,0,May,21,0,Fri,1,22,130,152
2011-05-06,0,May,22,0,Fri,1,46,105,151
2011-05-06,0,May,23,0,Fri,1,27,93,120
2011-05-07,0,May,0,0,Sat,0,10,76,86
2011-05-07,0,May,1,0,Sat,0,8,50,58
2011-05-07,0,May,2,0,Sat,0,5,47,52
2011-05-07,0,May,3,0,Sat,0,9,9,18
2011-05-07,0,May,4,0,Sat,0,1,4,5
2011-05-07,0,May,5,0,Sat,0,4,3,7
2011-05-07,0,May,6,0,Sat,0,1,12,13
2011-05-07,0,May,7,0,Sat,0,8,32,40
2011-05-07,0,May,8,0,Sat,0,19,96,115
2011-05-07,0,May,9,0,Sat,0,54,164,218
2011-05-07,0,May,10,0,Sat,0,90,208,298
2011-05-07,0,May,11,0,Sat,0,132,215,347
2011-05-07,0,May,12,0,Sat,0,129,244,373
2011-05-07,0,May,13,0,Sat,0,196,240,436
2011-05-07,0,May,14,0,Sat,0,143,235,378
2011-05-07,0,May,15,0,Sat,0,148,230,378
2011-05-07,0,May,16,0,Sat,0,119,223,342
2011-05-07,0,May,17,0,Sat,0,138,216,354
2011-05-07,0,May,18,0,Sat,0,114,175,289
2011-05-07,0,May,19,0,Sat,0,88,179,267
2011-05-07,0,May,20,0,Sat,0,82,137,219
2011-05-07,0,May,21,0,Sat,0,58,124,182
2011-05-07,0,May,22,0,Sat,0,26,94,120
2011-05-07,0,May,23,0,Sat,0,30,89,119
2011-05-08,0,May,0,0,Sun,0,22,78,100
2011-05-08,0,May,1,0,Sun,0,8,56,64
2011-05-08,0,May,2,0,Sun,0,17,42,59
2011-05-08,0,May,3,0,Sun,0,10,21,31
2011-05-08,0,May,4,0,Sun,0,2,8,10
2011-05-08,0,May,5,0,Sun,0,0,5,5
2011-05-08,0,May,6,0,Sun,0,2,4,6
2011-05-08,0,May,7,0,Sun,0,8,15,23
2011-05-08,0,May,8,0,Sun,0,28,58,86
2011-05-08,0,May,9,0,Sun,0,48,112,160
2011-05-08,0,May,10,0,Sun,0,91,153,244
2011-05-08,0,May,11,0,Sun,0,142,198,340
2011-05-08,0,May,12,0,Sun,0,139,243,382
2011-05-08,0,May,13,0,Sun,0,166,224,390
2011-05-08,0,May,14,0,Sun,0,126,240,366
2011-05-08,0,May,15,0,Sun,0,128,230,358
2011-05-08,0,May,16,0,Sun,0,122,263,385
2011-05-08,0,May,17,0,Sun,0,106,245,351
2011-05-08,0,May,18,0,Sun,0,63,205,268
2011-05-08,0,May,19,0,Sun,0,61,178,239
2011-05-08,0,May,20,0,Sun,0,42,132,174
2011-05-08,0,May,21,0,Sun,0,32,95,127
2011-05-08,0,May,22,0,Sun,0,29,86,115
2011-05-08,0,May,23,0,Sun,0,9,41,50
2011-05-09,0,May,0,0,Mon,1,31,22,53
2011-05-09,0,May,1,0,Mon,1,25,8,33
2011-05-09,0,May,2,0,Mon,1,6,2,8
2011-05-09,0,May,3,0,Mon,1,0,7,7
2011-05-09,0,May,4,0,Mon,1,0,4,4
2011-05-09,0,May,5,0,Mon,1,0,23,23
2011-05-09,0,May,6,0,Mon,1,2,87,89
2011-05-09,0,May,7,0,Mon,1,16,221,237
2011-05-09,0,May,8,0,Mon,1,23,351,374
2011-05-09,0,May,9,0,Mon,1,36,142,178
2011-05-09,0,May,10,0,Mon,1,24,95,119
2011-05-09,0,May,11,0,Mon,1,26,99,125
2011-05-09,0,May,12,0,Mon,1,35,160,195
2011-05-09,0,May,13,0,Mon,1,36,138,174
2011-05-09,0,May,14,0,Mon,1,44,118,162
2011-05-09,0,May,15,0,Mon,1,51,148,199
2011-05-09,0,May,16,0,Mon,1,49,255,304
2011-05-09,0,May,17,0,Mon,1,59,539,598
2011-05-09,0,May,18,0,Mon,1,66,458,524
2011-05-09,0,May,19,0,Mon,1,45,339,384
2011-05-09,0,May,20,0,Mon,1,25,214,239
2011-05-09,0,May,21,0,Mon,1,28,128,156
2011-05-09,0,May,22,0,Mon,1,21,95,116
2011-05-09,0,May,23,0,Mon,1,16,45,61
2011-05-10,0,May,0,0,Tue,1,6,12,18
2011-05-10,0,May,1,0,Tue,1,3,12,15
2011-05-10,0,May,2,0,Tue,1,1,4,5
2011-05-10,0,May,3,0,Tue,1,1,3,4
2011-05-10,0,May,4,0,Tue,1,0,2,2
2011-05-10,0,May,5,0,Tue,1,1,28,29
2011-05-10,0,May,6,0,Tue,1,9,103,112
2011-05-10,0,May,7,0,Tue,1,13,301,314
2011-05-10,0,May,8,0,Tue,1,28,397,425
2011-05-10,0,May,9,0,Tue,1,29,176,205
2011-05-10,0,May,10,0,Tue,1,27,100,127
2011-05-10,0,May,11,0,Tue,1,17,108,125
2011-05-10,0,May,12,0,Tue,1,47,170,217
2011-05-10,0,May,13,0,Tue,1,50,152,202
2011-05-10,0,May,14,0,Tue,1,42,134,176
2011-05-10,0,May,15,0,Tue,1,28,152,180
2011-05-10,0,May,16,0,Tue,1,56,271,327
2011-05-10,0,May,17,0,Tue,1,79,532,611
2011-05-10,0,May,18,0,Tue,1,70,480,550
2011-05-10,0,May,19,0,Tue,1,69,365,434
2011-05-10,0,May,20,0,Tue,1,50,241,291
2011-05-10,0,May,21,0,Tue,1,30,173,203
2011-05-10,0,May,22,0,Tue,1,29,121,150
2011-05-10,0,May,23,0,Tue,1,9,72,81
2011-05-11,0,May,0,0,Wed,1,8,30,38
2011-05-11,0,May,1,0,Wed,1,4,16,20
2011-05-11,0,May,2,0,Wed,1,6,4,10
2011-05-11,0,May,3,0,Wed,1,0,3,3
2011-05-11,0,May,4,0,Wed,1,0,2,2
2011-05-11,0,May,5,0,Wed,1,0,20,20
2011-05-11,0,May,6,0,Wed,1,6,93,99
2011-05-11,0,May,7,0,Wed,1,25,293,318
2011-05-11,0,May,8,0,Wed,1,21,421,442
2011-05-11,0,May,9,0,Wed,1,21,182,203
2011-05-11,0,May,10,0,Wed,1,30,124,154
2011-05-11,0,May,11,0,Wed,1,18,123,141
2011-05-11,0,May,12,0,Wed,1,41,185,226
2011-05-11,0,May,13,0,Wed,1,36,157,193
2011-05-11,0,May,14,0,Wed,1,36,141,177
2011-05-11,0,May,15,0,Wed,1,48,131,179
2011-05-11,0,May,16,0,Wed,1,49,240,289
2011-05-11,0,May,17,0,Wed,1,17,242,259
2011-05-11,0,May,18,0,Wed,1,40,234,274
2011-05-11,0,May,19,0,Wed,1,60,341,401
2011-05-11,0,May,20,0,Wed,1,28,245,273
2011-05-11,0,May,21,0,Wed,1,32,202,234
2011-05-11,0,May,22,0,Wed,1,12,134,146
2011-05-11,0,May,23,0,Wed,1,12,69,81
2011-05-12,0,May,0,0,Thur,1,5,39,44
2011-05-12,0,May,1,0,Thur,1,1,16,17
2011-05-12,0,May,2,0,Thur,1,1,14,15
2011-05-12,0,May,3,0,Thur,1,0,5,5
2011-05-12,0,May,4,0,Thur,1,1,5,6
2011-05-12,0,May,5,0,Thur,1,2,27,29
2011-05-12,0,May,6,0,Thur,1,9,103,112
2011-05-12,0,May,7,0,Thur,1,14,283,297
2011-05-12,0,May,8,0,Thur,1,27,394,421
2011-05-12,0,May,9,0,Thur,1,21,191,212
2011-05-12,0,May,10,0,Thur,1,28,119,147
2011-05-12,0,May,11,0,Thur,1,43,136,179
2011-05-12,0,May,12,0,Thur,1,43,164,207
2011-05-12,0,May,13,0,Thur,1,48,170,218
2011-05-12,0,May,14,0,Thur,1,43,148,191
2011-05-12,0,May,15,0,Thur,1,54,163,217
2011-05-12,0,May,16,0,Thur,1,50,238,288
2011-05-12,0,May,17,0,Thur,1,54,540,594
2011-05-12,0,May,18,0,Thur,1,64,463,527
2011-05-12,0,May,19,0,Thur,1,59,305,364
2011-05-12,0,May,20,0,Thur,1,56,220,276
2011-05-12,0,May,21,0,Thur,1,31,192,223
2011-05-12,0,May,22,0,Thur,1,25,147,172
2011-05-12,0,May,23,0,Thur,1,16,87,103
2011-05-13,0,May,0,0,Fri,1,6,46,52
2011-05-13,0,May,1,0,Fri,1,5,15,20
2011-05-13,0,May,2,0,Fri,1,3,8,11
2011-05-13,0,May,3,0,Fri,1,2,2,4
2011-05-13,0,May,4,0,Fri,1,2,3,5
2011-05-13,0,May,5,0,Fri,1,1,24,25
2011-05-13,0,May,6,0,Fri,1,6,76,82
2011-05-13,0,May,7,0,Fri,1,16,141,157
2011-05-13,0,May,8,0,Fri,1,26,361,387
2011-05-13,0,May,9,0,Fri,1,18,215,233
2011-05-13,0,May,10,0,Fri,1,31,99,130
2011-05-13,0,May,11,0,Fri,1,56,90,146
2011-05-13,0,May,12,0,Fri,1,53,170,223
2011-05-13,0,May,13,0,Fri,1,69,157,226
2011-05-13,0,May,14,0,Fri,1,70,120,190
2011-05-13,0,May,15,0,Fri,1,56,142,198
2011-05-13,0,May,16,0,Fri,1,44,256,300
2011-05-13,0,May,17,0,Fri,1,62,429,491
2011-05-13,0,May,18,0,Fri,1,39,359,398
2011-05-13,0,May,19,0,Fri,1,25,245,270
2011-05-13,0,May,20,0,Fri,1,22,130,152
2011-05-13,0,May,21,0,Fri,1,24,130,154
2011-05-13,0,May,22,0,Fri,1,25,107,132
2011-05-13,0,May,23,0,Fri,1,31,88,119
2011-05-14,0,May,0,0,Sat,0,24,78,102
2011-05-14,0,May,1,0,Sat,0,18,64,82
2011-05-14,0,May,2,0,Sat,0,15,37,52
2011-05-14,0,May,3,0,Sat,0,5,30,35
2011-05-14,0,May,4,0,Sat,0,1,4,5
2011-05-14,0,May,5,0,Sat,0,7,7,14
2011-05-14,0,May,6,0,Sat,0,2,9,11
2011-05-14,0,May,7,0,Sat,0,4,28,32
2011-05-14,0,May,8,0,Sat,0,16,72,88
2011-05-14,0,May,9,0,Sat,0,14,86,100
2011-05-14,0,May,10,0,Sat,0,34,133,167
2011-05-14,0,May,11,0,Sat,0,72,207,279
2011-05-14,0,May,12,0,Sat,0,75,204,279
2011-05-14,0,May,13,0,Sat,0,68,180,248
2011-05-14,0,May,14,0,Sat,0,57,159,216
2011-05-14,0,May,15,0,Sat,0,73,221,294
2011-05-14,0,May,16,0,Sat,0,107,188,295
2011-05-14,0,May,17,0,Sat,0,78,194,272
2011-05-14,0,May,18,0,Sat,0,88,216,304
2011-05-14,0,May,19,0,Sat,0,69,179,248
2011-05-14,0,May,20,0,Sat,0,42,115,157
2011-05-14,0,May,21,0,Sat,0,15,44,59
2011-05-14,0,May,22,0,Sat,0,7,19,26
2011-05-14,0,May,23,0,Sat,0,11,33,44
2011-05-15,0,May,0,0,Sun,0,5,34,39
2011-05-15,0,May,1,0,Sun,0,4,43,47
2011-05-15,0,May,2,0,Sun,0,13,37,50
2011-05-15,0,May,3,0,Sun,0,11,21,32
2011-05-15,0,May,4,0,Sun,0,5,8,13
2011-05-15,0,May,5,0,Sun,0,3,11,14
2011-05-15,0,May,6,0,Sun,0,3,14,17
2011-05-15,0,May,7,0,Sun,0,4,38,42
2011-05-15,0,May,8,0,Sun,0,24,46,70
2011-05-15,0,May,9,0,Sun,0,36,98,134
2011-05-15,0,May,10,0,Sun,0,73,153,226
2011-05-15,0,May,11,0,Sun,0,120,202,322
2011-05-15,0,May,12,0,Sun,0,120,247,367
2011-05-15,0,May,13,0,Sun,0,195,261,456
2011-05-15,0,May,14,0,Sun,0,183,254,437
2011-05-15,0,May,15,0,Sun,0,206,253,459
2011-05-15,0,May,16,0,Sun,0,158,282,440
2011-05-15,0,May,17,0,Sun,0,137,255,392
2011-05-15,0,May,18,0,Sun,0,60,177,237
2011-05-15,0,May,19,0,Sun,0,78,153,231
2011-05-15,0,May,20,0,Sun,0,53,138,191
2011-05-15,0,May,21,0,Sun,0,44,107,151
2011-05-15,0,May,22,0,Sun,0,29,88,117
2011-05-15,0,May,23,0,Sun,0,18,51,69
2011-05-16,0,May,0,0,Mon,1,17,21,38
2011-05-16,0,May,1,0,Mon,1,6,8,14
2011-05-16,0,May,2,0,Mon,1,4,9,13
2011-05-16,0,May,3,0,Mon,1,1,3,4
2011-05-16,0,May,4,0,Mon,1,1,5,6
2011-05-16,0,May,5,0,Mon,1,1,20,21
2011-05-16,0,May,6,0,Mon,1,11,93,104
2011-05-16,0,May,7,0,Mon,1,27,245,272
2011-05-16,0,May,8,0,Mon,1,28,366,394
2011-05-16,0,May,9,0,Mon,1,38,156,194
2011-05-16,0,May,10,0,Mon,1,37,75,112
2011-05-16,0,May,11,0,Mon,1,56,129,185
2011-05-16,0,May,12,0,Mon,1,72,137,209
2011-05-16,0,May,13,0,Mon,1,61,153,214
2011-05-16,0,May,14,0,Mon,1,76,117,193
2011-05-16,0,May,15,0,Mon,1,55,110,165
2011-05-16,0,May,16,0,Mon,1,45,181,226
2011-05-16,0,May,17,0,Mon,1,47,227,274
2011-05-16,0,May,18,0,Mon,1,55,398,453
2011-05-16,0,May,19,0,Mon,1,36,272,308
2011-05-16,0,May,20,0,Mon,1,31,167,198
2011-05-16,0,May,21,0,Mon,1,28,149,177
2011-05-16,0,May,22,0,Mon,1,22,105,127
2011-05-16,0,May,23,0,Mon,1,18,39,57
2011-05-17,0,May,0,0,Tue,1,13,18,31
2011-05-17,0,May,1,0,Tue,1,7,6,13
2011-05-17,0,May,2,0,Tue,1,4,4,8
2011-05-17,0,May,3,0,Tue,1,1,3,4
2011-05-17,0,May,4,0,Tue,1,2,2,4
2011-05-17,0,May,5,0,Tue,1,0,22,22
2011-05-17,0,May,6,0,Tue,1,0,49,49
2011-05-17,0,May,7,0,Tue,1,13,138,151
2011-05-17,0,May,8,0,Tue,1,22,325,347
2011-05-17,0,May,9,0,Tue,1,17,190,207
2011-05-17,0,May,10,0,Tue,1,31,73,104
2011-05-17,0,May,11,0,Tue,1,26,104,130
2011-05-17,0,May,12,0,Tue,1,38,115,153
2011-05-17,0,May,13,0,Tue,1,31,141,172
2011-05-17,0,May,14,0,Tue,1,61,123,184
2011-05-17,0,May,15,0,Tue,1,79,131,210
2011-05-17,0,May,16,0,Tue,1,73,217,290
2011-05-17,0,May,17,0,Tue,1,83,521,604
2011-05-17,0,May,18,0,Tue,1,54,426,480
2011-05-17,0,May,19,0,Tue,1,51,298,349
2011-05-17,0,May,20,0,Tue,1,30,253,283
2011-05-17,0,May,21,0,Tue,1,23,151,174
2011-05-17,0,May,22,0,Tue,1,12,86,98
2011-05-17,0,May,23,0,Tue,1,7,49,56
2011-05-18,0,May,0,0,Wed,1,8,15,23
2011-05-18,0,May,1,0,Wed,1,3,9,12
2011-05-18,0,May,2,0,Wed,1,1,5,6
2011-05-18,0,May,3,0,Wed,1,6,3,9
2011-05-18,0,May,4,0,Wed,1,1,2,3
2011-05-18,0,May,5,0,Wed,1,0,9,9
2011-05-18,0,May,6,0,Wed,1,2,99,101
2011-05-18,0,May,7,0,Wed,1,14,260,274
2011-05-18,0,May,8,0,Wed,1,25,428,453
2011-05-18,0,May,9,0,Wed,1,26,176,202
2011-05-18,0,May,10,0,Wed,1,33,73,106
2011-05-18,0,May,11,0,Wed,1,6,17,23
2011-05-18,0,May,12,0,Wed,1,12,42,54
2011-05-18,0,May,13,0,Wed,1,30,92,122
2011-05-18,0,May,14,0,Wed,1,44,94,138
2011-05-18,0,May,15,0,Wed,1,34,133,167
2011-05-18,0,May,16,0,Wed,1,53,241,294
2011-05-18,0,May,17,0,Wed,1,78,487,565
2011-05-18,0,May,18,0,Wed,1,58,431,489
2011-05-18,0,May,19,0,Wed,1,43,288,331
2011-05-18,0,May,20,0,Wed,1,24,189,213
2011-05-18,0,May,21,0,Wed,1,11,74,85
2011-05-18,0,May,22,0,Wed,1,14,103,117
2011-05-18,0,May,23,0,Wed,1,10,49,59
2011-05-19,0,May,0,0,Thur,1,6,23,29
2011-05-19,0,May,1,0,Thur,1,2,4,6
2011-05-19,0,May,2,0,Thur,1,3,12,15
2011-05-19,0,May,3,0,Thur,1,1,3,4
2011-05-19,0,May,4,0,Thur,1,2,3,5
2011-05-19,0,May,5,0,Thur,1,2,24,26
2011-05-19,0,May,6,0,Thur,1,17,86,103
2011-05-19,0,May,7,0,Thur,1,18,239,257
2011-05-19,0,May,8,0,Thur,1,34,453,487
2011-05-19,0,May,9,0,Thur,1,40,176,216
2011-05-19,0,May,10,0,Thur,1,35,95,130
2011-05-19,0,May,11,0,Thur,1,53,111,164
2011-05-19,0,May,12,0,Thur,1,38,130,168
2011-05-19,0,May,13,0,Thur,1,44,139,183
2011-05-19,0,May,14,0,Thur,1,43,137,180
2011-05-19,0,May,15,0,Thur,1,63,125,188
2011-05-19,0,May,16,0,Thur,1,55,247,302
2011-05-19,0,May,17,0,Thur,1,60,487,547
2011-05-19,0,May,18,0,Thur,1,59,454,513
2011-05-19,0,May,19,0,Thur,1,65,345,410
2011-05-19,0,May,20,0,Thur,1,46,236,282
2011-05-19,0,May,21,0,Thur,1,29,180,209
2011-05-19,0,May,22,0,Thur,1,11,68,79
2011-05-19,0,May,23,0,Thur,1,9,63,72
2011-05-20,0,May,0,0,Fri,1,15,33,48
2011-05-20,0,May,1,0,Fri,1,8,17,25
2011-05-20,0,May,2,0,Fri,1,4,4,8
2011-05-20,0,May,3,0,Fri,1,1,4,5
2011-05-20,0,May,4,0,Fri,1,1,4,5
2011-05-20,0,May,5,0,Fri,1,0,28,28
2011-05-20,0,May,6,0,Fri,1,15,102,117
2011-05-20,0,May,7,0,Fri,1,30,289,319
2011-05-20,0,May,8,0,Fri,1,41,476,517
2011-05-20,0,May,9,0,Fri,1,35,199,234
2011-05-20,0,May,10,0,Fri,1,44,104,148
2011-05-20,0,May,11,0,Fri,1,63,133,196
2011-05-20,0,May,12,0,Fri,1,69,186,255
2011-05-20,0,May,13,0,Fri,1,60,172,232
2011-05-20,0,May,14,0,Fri,1,66,131,197
2011-05-20,0,May,15,0,Fri,1,74,168,242
2011-05-20,0,May,16,0,Fri,1,61,269,330
2011-05-20,0,May,17,0,Fri,1,71,483,554
2011-05-20,0,May,18,0,Fri,1,79,394,473
2011-05-20,0,May,19,0,Fri,1,49,253,302
2011-05-20,0,May,20,0,Fri,1,40,180,220
2011-05-20,0,May,21,0,Fri,1,40,155,195
2011-05-20,0,May,22,0,Fri,1,28,124,152
2011-05-20,0,May,23,0,Fri,1,15,100,115
2011-05-21,0,May,0,0,Sat,0,20,78,98
2011-05-21,0,May,1,0,Sat,0,8,64,72
2011-05-21,0,May,2,0,Sat,0,5,35,40
2011-05-21,0,May,3,0,Sat,0,7,12,19
2011-05-21,0,May,4,0,Sat,0,1,6,7
2011-05-21,0,May,5,0,Sat,0,1,4,5
2011-05-21,0,May,6,0,Sat,0,6,22,28
2011-05-21,0,May,7,0,Sat,0,10,33,43
2011-05-21,0,May,8,0,Sat,0,29,97,126
2011-05-21,0,May,9,0,Sat,0,60,165,225
2011-05-21,0,May,10,0,Sat,0,122,201,323
2011-05-21,0,May,11,0,Sat,0,173,245,418
2011-05-21,0,May,12,0,Sat,0,222,271,493
2011-05-21,0,May,13,0,Sat,0,191,271,462
2011-05-21,0,May,14,0,Sat,0,187,269,456
2011-05-21,0,May,15,0,Sat,0,232,274,506
2011-05-21,0,May,16,0,Sat,0,204,267,471
2011-05-21,0,May,17,0,Sat,0,191,253,444
2011-05-21,0,May,18,0,Sat,0,191,253,444
2011-05-21,0,May,19,0,Sat,0,117,184,301
2011-05-21,0,May,20,0,Sat,0,84,164,248
2011-05-21,0,May,21,0,Sat,0,77,150,227
2011-05-21,0,May,22,0,Sat,0,78,126,204
2011-05-21,0,May,23,0,Sat,0,42,103,145
2011-05-22,0,May,0,0,Sun,0,31,100,131
2011-05-22,0,May,1,0,Sun,0,17,81,98
2011-05-22,0,May,2,0,Sun,0,18,50,68
2011-05-22,0,May,3,0,Sun,0,10,23,33
2011-05-22,0,May,4,0,Sun,0,3,9,12
2011-05-22,0,May,5,0,Sun,0,1,5,6
2011-05-22,0,May,6,0,Sun,0,5,13,18
2011-05-22,0,May,7,0,Sun,0,13,27,40
2011-05-22,0,May,8,0,Sun,0,29,65,94
2011-05-22,0,May,9,0,Sun,0,59,130,189
2011-05-22,0,May,10,0,Sun,0,135,170,305
2011-05-22,0,May,11,0,Sun,0,164,209,373
2011-05-22,0,May,12,0,Sun,0,146,255,401
2011-05-22,0,May,13,0,Sun,0,180,275,455
2011-05-22,0,May,14,0,Sun,0,125,191,316
2011-05-22,0,May,15,0,Sun,0,110,221,331
2011-05-22,0,May,16,0,Sun,0,72,201,273
2011-05-22,0,May,17,0,Sun,0,93,213,306
2011-05-22,0,May,18,0,Sun,0,120,238,358
2011-05-22,0,May,19,0,Sun,0,107,193,300
2011-05-22,0,May,20,0,Sun,0,57,174,231
2011-05-22,0,May,21,0,Sun,0,27,109,136
2011-05-22,0,May,22,0,Sun,0,35,86,121
2011-05-22,0,May,23,0,Sun,0,19,46,65
2011-05-23,0,May,0,0,Mon,1,23,18,41
2011-05-23,0,May,1,0,Mon,1,4,5,9
2011-05-23,0,May,2,0,Mon,1,2,3,5
2011-05-23,0,May,3,0,Mon,1,0,4,4
2011-05-23,0,May,4,0,Mon,1,2,2,4
2011-05-23,0,May,5,0,Mon,1,0,11,11
2011-05-23,0,May,6,0,Mon,1,4,92,96
2011-05-23,0,May,7,0,Mon,1,13,223,236
2011-05-23,0,May,8,0,Mon,1,50,359,409
2011-05-23,0,May,9,0,Mon,1,36,131,167
2011-05-23,0,May,10,0,Mon,1,49,72,121
2011-05-23,0,May,11,0,Mon,1,73,107,180
2011-05-23,0,May,12,0,Mon,1,65,139,204
2011-05-23,0,May,13,0,Mon,1,49,155,204
2011-05-23,0,May,14,0,Mon,1,57,130,187
2011-05-23,0,May,15,0,Mon,1,57,119,176
2011-05-23,0,May,16,0,Mon,1,56,223,279
2011-05-23,0,May,17,0,Mon,1,56,373,429
2011-05-23,0,May,18,0,Mon,1,68,385,453
2011-05-23,0,May,19,0,Mon,1,56,302,358
2011-05-23,0,May,20,0,Mon,1,39,271,310
2011-05-23,0,May,21,0,Mon,1,33,155,188
2011-05-23,0,May,22,0,Mon,1,25,106,131
2011-05-23,0,May,23,0,Mon,1,19,53,72
2011-05-24,0,May,0,0,Tue,1,12,23,35
2011-05-24,0,May,1,0,Tue,1,6,9,15
2011-05-24,0,May,2,0,Tue,1,2,8,10
2011-05-24,0,May,3,0,Tue,1,0,2,2
2011-05-24,0,May,4,0,Tue,1,1,3,4
2011-05-24,0,May,5,0,Tue,1,2,22,24
2011-05-24,0,May,6,0,Tue,1,10,102,112
2011-05-24,0,May,7,0,Tue,1,26,288,314
2011-05-24,0,May,8,0,Tue,1,31,403,434
2011-05-24,0,May,9,0,Tue,1,27,111,138
2011-05-24,0,May,10,0,Tue,1,18,90,108
2011-05-24,0,May,11,0,Tue,1,33,142,175
2011-05-24,0,May,12,0,Tue,1,41,129,170
2011-05-24,0,May,13,0,Tue,1,38,152,190
2011-05-24,0,May,14,0,Tue,1,27,126,153
2011-05-24,0,May,15,0,Tue,1,59,129,188
2011-05-24,0,May,16,0,Tue,1,52,225,277
2011-05-24,0,May,17,0,Tue,1,56,492,548
2011-05-24,0,May,18,0,Tue,1,74,490,564
2011-05-24,0,May,19,0,Tue,1,45,310,355
2011-05-24,0,May,20,0,Tue,1,39,241,280
2011-05-24,0,May,21,0,Tue,1,21,168,189
2011-05-24,0,May,22,0,Tue,1,26,115,141
2011-05-24,0,May,23,0,Tue,1,13,53,66
2011-05-25,0,May,0,0,Wed,1,3,32,35
2011-05-25,0,May,1,0,Wed,1,6,2,8
2011-05-25,0,May,2,0,Wed,1,0,8,8
2011-05-25,0,May,3,0,Wed,1,0,9,9
2011-05-25,0,May,4,0,Wed,1,0,3,3
2011-05-25,0,May,5,0,Wed,1,2,23,25
2011-05-25,0,May,6,0,Wed,1,4,113,117
2011-05-25,0,May,7,0,Wed,1,29,284,313
2011-05-25,0,May,8,0,Wed,1,36,495,531
2011-05-25,0,May,9,0,Wed,1,27,207,234
2011-05-25,0,May,10,0,Wed,1,30,105,135
2011-05-25,0,May,11,0,Wed,1,36,104,140
2011-05-25,0,May,12,0,Wed,1,32,178,210
2011-05-25,0,May,13,0,Wed,1,39,163,202
2011-05-25,0,May,14,0,Wed,1,47,121,168
2011-05-25,0,May,15,0,Wed,1,37,145,182
2011-05-25,0,May,16,0,Wed,1,61,238,299
2011-05-25,0,May,17,0,Wed,1,77,524,601
2011-05-25,0,May,18,0,Wed,1,66,451,517
2011-05-25,0,May,19,0,Wed,1,73,332,405
2011-05-25,0,May,20,0,Wed,1,56,284,340
2011-05-25,0,May,21,0,Wed,1,33,203,236
2011-05-25,0,May,22,0,Wed,1,34,140,174
2011-05-25,0,May,23,0,Wed,1,12,74,86
2011-05-26,0,May,0,0,Thur,1,11,34,45
2011-05-26,0,May,1,0,Thur,1,3,13,16
2011-05-26,0,May,2,0,Thur,1,7,7,14
2011-05-26,0,May,3,0,Thur,1,0,4,4
2011-05-26,0,May,4,0,Thur,1,0,2,2
2011-05-26,0,May,5,0,Thur,1,2,25,27
2011-05-26,0,May,6,0,Thur,1,4,94,98
2011-05-26,0,May,7,0,Thur,1,16,270,286
2011-05-26,0,May,8,0,Thur,1,31,458,489
2011-05-26,0,May,9,0,Thur,1,22,194,216
2011-05-26,0,May,10,0,Thur,1,49,94,143
2011-05-26,0,May,11,0,Thur,1,36,124,160
2011-05-26,0,May,12,0,Thur,1,53,141,194
2011-05-26,0,May,13,0,Thur,1,52,145,197
2011-05-26,0,May,14,0,Thur,1,44,145,189
2011-05-26,0,May,15,0,Thur,1,40,101,141
2011-05-26,0,May,16,0,Thur,1,58,233,291
2011-05-26,0,May,17,0,Thur,1,49,445,494
2011-05-26,0,May,18,0,Thur,1,74,404,478
2011-05-26,0,May,19,0,Thur,1,67,311,378
2011-05-26,0,May,20,0,Thur,1,55,267,322
2011-05-26,0,May,21,0,Thur,1,45,178,223
2011-05-26,0,May,22,0,Thur,1,23,157,180
2011-05-26,0,May,23,0,Thur,1,17,73,90
2011-05-27,0,May,0,0,Fri,1,14,55,69
2011-05-27,0,May,1,0,Fri,1,14,36,50
2011-05-27,0,May,2,0,Fri,1,6,12,18
2011-05-27,0,May,3,0,Fri,1,1,11,12
2011-05-27,0,May,4,0,Fri,1,2,5,7
2011-05-27,0,May,5,0,Fri,1,2,29,31
2011-05-27,0,May,6,0,Fri,1,8,73,81
2011-05-27,0,May,7,0,Fri,1,20,229,249
2011-05-27,0,May,8,0,Fri,1,25,393,418
2011-05-27,0,May,9,0,Fri,1,37,190,227
2011-05-27,0,May,10,0,Fri,1,42,111,153
2011-05-27,0,May,11,0,Fri,1,40,126,166
2011-05-27,0,May,12,0,Fri,1,53,190,243
2011-05-27,0,May,13,0,Fri,1,51,158,209
2011-05-27,0,May,14,0,Fri,1,51,188,239
2011-05-27,0,May,15,0,Fri,1,98,258,356
2011-05-27,0,May,16,0,Fri,1,63,356,419
2011-05-27,0,May,17,0,Fri,1,77,414,491
2011-05-27,0,May,18,0,Fri,1,89,310,399
2011-05-27,0,May,19,0,Fri,1,69,210,279
2011-05-27,0,May,20,0,Fri,1,24,120,144
2011-05-27,0,May,21,0,Fri,1,37,114,151
2011-05-27,0,May,22,0,Fri,1,25,116,141
2011-05-27,0,May,23,0,Fri,1,23,104,127
2011-05-28,0,May,0,0,Sat,0,15,79,94
2011-05-28,0,May,1,0,Sat,0,8,47,55
2011-05-28,0,May,2,0,Sat,0,13,35,48
2011-05-28,0,May,3,0,Sat,0,2,13,15
2011-05-28,0,May,4,0,Sat,0,0,4,4
2011-05-28,0,May,5,0,Sat,0,4,3,7
2011-05-28,0,May,6,0,Sat,0,3,16,19
2011-05-28,0,May,7,0,Sat,0,17,33,50
2011-05-28,0,May,8,0,Sat,0,27,75,102
2011-05-28,0,May,9,0,Sat,0,61,116,177
2011-05-28,0,May,10,0,Sat,0,110,166,276
2011-05-28,0,May,11,0,Sat,0,171,178,349
2011-05-28,0,May,12,0,Sat,0,145,213,358
2011-05-28,0,May,13,0,Sat,0,168,217,385
2011-05-28,0,May,14,0,Sat,0,172,210,382
2011-05-28,0,May,15,0,Sat,0,187,187,374
2011-05-28,0,May,16,0,Sat,0,201,201,402
2011-05-28,0,May,17,0,Sat,0,180,161,341
2011-05-28,0,May,18,0,Sat,0,173,212,385
2011-05-28,0,May,19,0,Sat,0,99,153,252
2011-05-28,0,May,20,0,Sat,0,68,128,196
2011-05-28,0,May,21,0,Sat,0,87,114,201
2011-05-28,0,May,22,0,Sat,0,46,115,161
2011-05-28,0,May,23,0,Sat,0,44,81,125
2011-05-29,0,May,0,0,Sun,0,32,51,83
2011-05-29,0,May,1,0,Sun,0,17,49,66
2011-05-29,0,May,2,0,Sun,0,12,49,61
2011-05-29,0,May,3,0,Sun,0,2,24,26
2011-05-29,0,May,4,0,Sun,0,13,10,23
2011-05-29,0,May,5,0,Sun,0,3,3,6
2011-05-29,0,May,6,0,Sun,0,5,10,15
2011-05-29,0,May,7,0,Sun,0,13,17,30
2011-05-29,0,May,8,0,Sun,0,34,62,96
2011-05-29,0,May,9,0,Sun,0,74,78,152
2011-05-29,0,May,10,0,Sun,0,130,121,251
2011-05-29,0,May,11,0,Sun,0,139,180,319
2011-05-29,0,May,12,0,Sun,0,216,186,402
2011-05-29,0,May,13,0,Sun,0,237,181,418
2011-05-29,0,May,14,0,Sun,0,183,168,351
2011-05-29,0,May,15,0,Sun,0,221,155,376
2011-05-29,0,May,16,0,Sun,0,194,167,361
2011-05-29,0,May,17,0,Sun,0,214,169,383
2011-05-29,0,May,18,0,Sun,0,151,177,328
2011-05-29,0,May,19,0,Sun,0,141,146,287
2011-05-29,0,May,20,0,Sun,0,91,128,219
2011-05-29,0,May,21,0,Sun,0,107,122,229
2011-05-29,0,May,22,0,Sun,0,78,93,171
2011-05-29,0,May,23,0,Sun,0,48,87,135
2011-05-30,0,May,0,1,Mon,0,38,65,103
2011-05-30,0,May,1,1,Mon,0,26,53,79
2011-05-30,0,May,2,1,Mon,0,17,28,45
2011-05-30,0,May,3,1,Mon,0,10,8,18
2011-05-30,0,May,4,1,Mon,0,2,4,6
2011-05-30,0,May,5,1,Mon,0,1,6,7
2011-05-30,0,May,6,1,Mon,0,6,10,16
2011-05-30,0,May,7,1,Mon,0,12,19,31
2011-05-30,0,May,8,1,Mon,0,36,58,94
2011-05-30,0,May,9,1,Mon,0,47,81,128
2011-05-30,0,May,10,1,Mon,0,116,153,269
2011-05-30,0,May,11,1,Mon,0,153,168,321
2011-05-30,0,May,12,1,Mon,0,179,187,366
2011-05-30,0,May,13,1,Mon,0,133,217,350
2011-05-30,0,May,14,1,Mon,0,142,185,327
2011-05-30,0,May,15,1,Mon,0,132,179,311
2011-05-30,0,May,16,1,Mon,0,101,208,309
2011-05-30,0,May,17,1,Mon,0,102,202,304
2011-05-30,0,May,18,1,Mon,0,77,172,249
2011-05-30,0,May,19,1,Mon,0,68,157,225
2011-05-30,0,May,20,1,Mon,0,69,168,237
2011-05-30,0,May,21,1,Mon,0,42,107,149
2011-05-30,0,May,22,1,Mon,0,26,80,106
2011-05-30,0,May,23,1,Mon,0,14,34,48
2011-05-31,0,May,0,0,Tue,1,9,20,29
2011-05-31,0,May,1,0,Tue,1,8,9,17
2011-05-31,0,May,2,0,Tue,1,5,7,12
2011-05-31,0,May,3,0,Tue,1,1,3,4
2011-05-31,0,May,4,0,Tue,1,0,3,3
2011-05-31,0,May,5,0,Tue,1,0,26,26
2011-05-31,0,May,6,0,Tue,1,11,98,109
2011-05-31,0,May,7,0,Tue,1,16,219,235
2011-05-31,0,May,8,0,Tue,1,34,372,406
2011-05-31,0,May,9,0,Tue,1,22,153,175
2011-05-31,0,May,10,0,Tue,1,37,72,109
2011-05-31,0,May,11,0,Tue,1,28,78,106
2011-05-31,0,May,12,0,Tue,1,37,125,162
2011-05-31,0,May,13,0,Tue,1,37,110,147
2011-05-31,0,May,14,0,Tue,1,41,99,140
2011-05-31,0,May,15,0,Tue,1,42,133,175
2011-05-31,0,May,16,0,Tue,1,44,205,249
2011-05-31,0,May,17,0,Tue,1,67,428,495
2011-05-31,0,May,18,0,Tue,1,55,362,417
2011-05-31,0,May,19,0,Tue,1,39,246,285
2011-05-31,0,May,20,0,Tue,1,38,213,251
2011-05-31,0,May,21,0,Tue,1,45,165,210
2011-05-31,0,May,22,0,Tue,1,42,117,159
2011-05-31,0,May,23,0,Tue,1,15,46,61
2011-06-01,0,Jun,0,0,Wed,1,9,25,34
2011-06-01,0,Jun,1,0,Wed,1,8,9,17
2011-06-01,0,Jun,2,0,Wed,1,0,3,3
2011-06-01,0,Jun,3,0,Wed,1,0,6,6
2011-06-01,0,Jun,4,0,Wed,1,0,4,4
2011-06-01,0,Jun,5,0,Wed,1,2,19,21
2011-06-01,0,Jun,6,0,Wed,1,7,121,128
2011-06-01,0,Jun,7,0,Wed,1,19,265,284
2011-06-01,0,Jun,8,0,Wed,1,37,417,454
2011-06-01,0,Jun,9,0,Wed,1,34,173,207
2011-06-01,0,Jun,10,0,Wed,1,31,84,115
2011-06-01,0,Jun,11,0,Wed,1,26,86,112
2011-06-01,0,Jun,12,0,Wed,1,32,137,169
2011-06-01,0,Jun,13,0,Wed,1,29,125,154
2011-06-01,0,Jun,14,0,Wed,1,40,105,145
2011-06-01,0,Jun,15,0,Wed,1,25,127,152
2011-06-01,0,Jun,16,0,Wed,1,39,227,266
2011-06-01,0,Jun,17,0,Wed,1,52,434,486
2011-06-01,0,Jun,18,0,Wed,1,31,278,309
2011-06-01,0,Jun,19,0,Wed,1,16,248,264
2011-06-01,0,Jun,20,0,Wed,1,23,233,256
2011-06-01,0,Jun,21,0,Wed,1,29,161,190
2011-06-01,0,Jun,22,0,Wed,1,14,115,129
2011-06-01,0,Jun,23,0,Wed,1,10,59,69
2011-06-02,0,Jun,0,0,Thur,1,11,31,42
2011-06-02,0,Jun,1,0,Thur,1,3,12,15
2011-06-02,0,Jun,2,0,Thur,1,0,6,6
2011-06-02,0,Jun,3,0,Thur,1,0,4,4
2011-06-02,0,Jun,4,0,Thur,1,0,3,3
2011-06-02,0,Jun,5,0,Thur,1,3,28,31
2011-06-02,0,Jun,6,0,Thur,1,7,106,113
2011-06-02,0,Jun,7,0,Thur,1,19,285,304
2011-06-02,0,Jun,8,0,Thur,1,25,442,467
2011-06-02,0,Jun,9,0,Thur,1,28,197,225
2011-06-02,0,Jun,10,0,Thur,1,33,106,139
2011-06-02,0,Jun,11,0,Thur,1,42,123,165
2011-06-02,0,Jun,12,0,Thur,1,39,193,232
2011-06-02,0,Jun,13,0,Thur,1,35,168,203
2011-06-02,0,Jun,14,0,Thur,1,43,142,185
2011-06-02,0,Jun,15,0,Thur,1,44,144,188
2011-06-02,0,Jun,16,0,Thur,1,63,255,318
2011-06-02,0,Jun,17,0,Thur,1,88,484,572
2011-06-02,0,Jun,18,0,Thur,1,74,451,525
2011-06-02,0,Jun,19,0,Thur,1,58,321,379
2011-06-02,0,Jun,20,0,Thur,1,51,286,337
2011-06-02,0,Jun,21,0,Thur,1,33,215,248
2011-06-02,0,Jun,22,0,Thur,1,14,141,155
2011-06-02,0,Jun,23,0,Thur,1,23,89,112
2011-06-03,0,Jun,0,0,Fri,1,15,53,68
2011-06-03,0,Jun,1,0,Fri,1,7,15,22
2011-06-03,0,Jun,2,0,Fri,1,0,12,12
2011-06-03,0,Jun,3,0,Fri,1,0,5,5
2011-06-03,0,Jun,4,0,Fri,1,1,5,6
2011-06-03,0,Jun,5,0,Fri,1,4,24,28
2011-06-03,0,Jun,6,0,Fri,1,8,98,106
2011-06-03,0,Jun,7,0,Fri,1,25,252,277
2011-06-03,0,Jun,8,0,Fri,1,31,471,502
2011-06-03,0,Jun,9,0,Fri,1,36,194,230
2011-06-03,0,Jun,10,0,Fri,1,54,107,161
2011-06-03,0,Jun,11,0,Fri,1,57,135,192
2011-06-03,0,Jun,12,0,Fri,1,51,208,259
2011-06-03,0,Jun,13,0,Fri,1,58,190,248
2011-06-03,0,Jun,14,0,Fri,1,66,174,240
2011-06-03,0,Jun,15,0,Fri,1,56,156,212
2011-06-03,0,Jun,16,0,Fri,1,63,286,349
2011-06-03,0,Jun,17,0,Fri,1,73,485,558
2011-06-03,0,Jun,18,0,Fri,1,76,488,564
2011-06-03,0,Jun,19,0,Fri,1,53,338,391
2011-06-03,0,Jun,20,0,Fri,1,57,236,293
2011-06-03,0,Jun,21,0,Fri,1,51,196,247
2011-06-03,0,Jun,22,0,Fri,1,26,145,171
2011-06-03,0,Jun,23,0,Fri,1,30,141,171
2011-06-04,0,Jun,0,0,Sat,0,24,69,93
2011-06-04,0,Jun,1,0,Sat,0,14,80,94
2011-06-04,0,Jun,2,0,Sat,0,18,41,59
2011-06-04,0,Jun,3,0,Sat,0,8,10,18
2011-06-04,0,Jun,4,0,Sat,0,4,11,15
2011-06-04,0,Jun,5,0,Sat,0,3,5,8
2011-06-04,0,Jun,6,0,Sat,0,11,17,28
2011-06-04,0,Jun,7,0,Sat,0,27,60,87
2011-06-04,0,Jun,8,0,Sat,0,29,96,125
2011-06-04,0,Jun,9,0,Sat,0,55,169,224
2011-06-04,0,Jun,10,0,Sat,0,115,202,317
2011-06-04,0,Jun,11,0,Sat,0,120,249,369
2011-06-04,0,Jun,12,0,Sat,0,150,270,420
2011-06-04,0,Jun,13,0,Sat,0,188,268,456
2011-06-04,0,Jun,14,0,Sat,0,193,258,451
2011-06-04,0,Jun,15,0,Sat,0,180,224,404
2011-06-04,0,Jun,16,0,Sat,0,168,272,440
2011-06-04,0,Jun,17,0,Sat,0,142,202,344
2011-06-04,0,Jun,18,0,Sat,0,127,214,341
2011-06-04,0,Jun,19,0,Sat,0,79,206,285
2011-06-04,0,Jun,20,0,Sat,0,90,149,239
2011-06-04,0,Jun,21,0,Sat,0,46,139,185
2011-06-04,0,Jun,22,0,Sat,0,49,141,190
2011-06-04,0,Jun,23,0,Sat,0,29,121,150
2011-06-05,0,Jun,0,0,Sun,0,23,90,113
2011-06-05,0,Jun,1,0,Sun,0,26,70,96
2011-06-05,0,Jun,2,0,Sun,0,16,48,64
2011-06-05,0,Jun,3,0,Sun,0,22,25,47
2011-06-05,0,Jun,4,0,Sun,0,4,8,12
2011-06-05,0,Jun,5,0,Sun,0,1,5,6
2011-06-05,0,Jun,6,0,Sun,0,10,11,21
2011-06-05,0,Jun,7,0,Sun,0,8,19,27
2011-06-05,0,Jun,8,0,Sun,0,24,74,98
2011-06-05,0,Jun,9,0,Sun,0,53,111,164
2011-06-05,0,Jun,10,0,Sun,0,83,168,251
2011-06-05,0,Jun,11,0,Sun,0,121,214,335
2011-06-05,0,Jun,12,0,Sun,0,123,212,335
2011-06-05,0,Jun,13,0,Sun,0,154,213,367
2011-06-05,0,Jun,14,0,Sun,0,161,224,385
2011-06-05,0,Jun,15,0,Sun,0,161,256,417
2011-06-05,0,Jun,16,0,Sun,0,138,260,398
2011-06-05,0,Jun,17,0,Sun,0,126,264,390
2011-06-05,0,Jun,18,0,Sun,0,124,239,363
2011-06-05,0,Jun,19,0,Sun,0,108,249,357
2011-06-05,0,Jun,20,0,Sun,0,84,195,279
2011-06-05,0,Jun,21,0,Sun,0,54,111,165
2011-06-05,0,Jun,22,0,Sun,0,36,94,130
2011-06-05,0,Jun,23,0,Sun,0,25,61,86
2011-06-06,0,Jun,0,0,Mon,1,11,18,29
2011-06-06,0,Jun,1,0,Mon,1,9,5,14
2011-06-06,0,Jun,2,0,Mon,1,4,4,8
2011-06-06,0,Jun,3,0,Mon,1,2,3,5
2011-06-06,0,Jun,4,0,Mon,1,4,4,8
2011-06-06,0,Jun,5,0,Mon,1,7,24,31
2011-06-06,0,Jun,6,0,Mon,1,11,101,112
2011-06-06,0,Jun,7,0,Mon,1,18,281,299
2011-06-06,0,Jun,8,0,Mon,1,28,410,438
2011-06-06,0,Jun,9,0,Mon,1,26,162,188
2011-06-06,0,Jun,10,0,Mon,1,31,64,95
2011-06-06,0,Jun,11,0,Mon,1,39,72,111
2011-06-06,0,Jun,12,0,Mon,1,25,128,153
2011-06-06,0,Jun,13,0,Mon,1,28,152,180
2011-06-06,0,Jun,14,0,Mon,1,46,99,145
2011-06-06,0,Jun,15,0,Mon,1,38,127,165
2011-06-06,0,Jun,16,0,Mon,1,34,233,267
2011-06-06,0,Jun,17,0,Mon,1,63,516,579
2011-06-06,0,Jun,18,0,Mon,1,56,500,556
2011-06-06,0,Jun,19,0,Mon,1,64,343,407
2011-06-06,0,Jun,20,0,Mon,1,59,277,336
2011-06-06,0,Jun,21,0,Mon,1,29,160,189
2011-06-06,0,Jun,22,0,Mon,1,36,137,173
2011-06-06,0,Jun,23,0,Mon,1,5,55,60
2011-06-07,0,Jun,0,0,Tue,1,5,15,20
2011-06-07,0,Jun,1,0,Tue,1,2,2,4
2011-06-07,0,Jun,2,0,Tue,1,3,2,5
2011-06-07,0,Jun,3,0,Tue,1,1,1,2
2011-06-07,0,Jun,4,0,Tue,1,2,3,5
2011-06-07,0,Jun,5,0,Tue,1,2,30,32
2011-06-07,0,Jun,6,0,Tue,1,10,116,126
2011-06-07,0,Jun,7,0,Tue,1,23,311,334
2011-06-07,0,Jun,8,0,Tue,1,45,432,477
2011-06-07,0,Jun,9,0,Tue,1,27,190,217
2011-06-07,0,Jun,10,0,Tue,1,37,86,123
2011-06-07,0,Jun,11,0,Tue,1,38,113,151
2011-06-07,0,Jun,12,0,Tue,1,42,141,183
2011-06-07,0,Jun,13,0,Tue,1,55,141,196
2011-06-07,0,Jun,14,0,Tue,1,34,112,146
2011-06-07,0,Jun,15,0,Tue,1,56,127,183
2011-06-07,0,Jun,16,0,Tue,1,55,253,308
2011-06-07,0,Jun,17,0,Tue,1,64,475,539
2011-06-07,0,Jun,18,0,Tue,1,72,479,551
2011-06-07,0,Jun,19,0,Tue,1,69,355,424
2011-06-07,0,Jun,20,0,Tue,1,45,301,346
2011-06-07,0,Jun,21,0,Tue,1,31,187,218
2011-06-07,0,Jun,22,0,Tue,1,27,126,153
2011-06-07,0,Jun,23,0,Tue,1,18,72,90
2011-06-08,0,Jun,0,0,Wed,1,12,29,41
2011-06-08,0,Jun,1,0,Wed,1,3,20,23
2011-06-08,0,Jun,2,0,Wed,1,0,7,7
2011-06-08,0,Jun,3,0,Wed,1,2,1,3
2011-06-08,0,Jun,4,0,Wed,1,0,6,6
2011-06-08,0,Jun,5,0,Wed,1,0,21,21
2011-06-08,0,Jun,6,0,Wed,1,13,103,116
2011-06-08,0,Jun,7,0,Wed,1,24,329,353
2011-06-08,0,Jun,8,0,Wed,1,46,435,481
2011-06-08,0,Jun,9,0,Wed,1,34,168,202
2011-06-08,0,Jun,10,0,Wed,1,27,63,90
2011-06-08,0,Jun,11,0,Wed,1,28,106,134
2011-06-08,0,Jun,12,0,Wed,1,15,134,149
2011-06-08,0,Jun,13,0,Wed,1,20,116,136
2011-06-08,0,Jun,14,0,Wed,1,44,111,155
2011-06-08,0,Jun,15,0,Wed,1,28,100,128
2011-06-08,0,Jun,16,0,Wed,1,34,199,233
2011-06-08,0,Jun,17,0,Wed,1,80,426,506
2011-06-08,0,Jun,18,0,Wed,1,61,398,459
2011-06-08,0,Jun,19,0,Wed,1,61,323,384
2011-06-08,0,Jun,20,0,Wed,1,55,225,280
2011-06-08,0,Jun,21,0,Wed,1,34,168,202
2011-06-08,0,Jun,22,0,Wed,1,37,139,176
2011-06-08,0,Jun,23,0,Wed,1,18,98,116
2011-06-09,0,Jun,0,0,Thur,1,7,40,47
2011-06-09,0,Jun,1,0,Thur,1,3,13,16
2011-06-09,0,Jun,2,0,Thur,1,0,6,6
2011-06-09,0,Jun,3,0,Thur,1,0,2,2
2011-06-09,0,Jun,4,0,Thur,1,2,4,6
2011-06-09,0,Jun,5,0,Thur,1,1,19,20
2011-06-09,0,Jun,6,0,Thur,1,13,105,118
2011-06-09,0,Jun,7,0,Thur,1,31,283,314
2011-06-09,0,Jun,8,0,Thur,1,32,400,432
2011-06-09,0,Jun,9,0,Thur,1,20,148,168
2011-06-09,0,Jun,10,0,Thur,1,20,74,94
2011-06-09,0,Jun,11,0,Thur,1,36,82,118
2011-06-09,0,Jun,12,0,Thur,1,40,100,140
2011-06-09,0,Jun,13,0,Thur,1,18,118,136
2011-06-09,0,Jun,14,0,Thur,1,25,93,118
2011-06-09,0,Jun,15,0,Thur,1,18,86,104
2011-06-09,0,Jun,16,0,Thur,1,30,170,200
2011-06-09,0,Jun,17,0,Thur,1,54,355,409
2011-06-09,0,Jun,18,0,Thur,1,52,414,466
2011-06-09,0,Jun,19,0,Thur,1,55,271,326
2011-06-09,0,Jun,20,0,Thur,1,40,214,254
2011-06-09,0,Jun,21,0,Thur,1,29,142,171
2011-06-09,0,Jun,22,0,Thur,1,22,131,153
2011-06-09,0,Jun,23,0,Thur,1,15,82,97
2011-06-10,0,Jun,0,0,Fri,1,8,61,69
2011-06-10,0,Jun,1,0,Fri,1,5,18,23
2011-06-10,0,Jun,2,0,Fri,1,6,7,13
2011-06-10,0,Jun,3,0,Fri,1,3,3,6
2011-06-10,0,Jun,4,0,Fri,1,0,4,4
2011-06-10,0,Jun,5,0,Fri,1,0,28,28
2011-06-10,0,Jun,6,0,Fri,1,10,94,104
2011-06-10,0,Jun,7,0,Fri,1,25,242,267
2011-06-10,0,Jun,8,0,Fri,1,29,423,452
2011-06-10,0,Jun,9,0,Fri,1,37,176,213
2011-06-10,0,Jun,10,0,Fri,1,23,88,111
2011-06-10,0,Jun,11,0,Fri,1,46,107,153
2011-06-10,0,Jun,12,0,Fri,1,40,167,207
2011-06-10,0,Jun,13,0,Fri,1,40,149,189
2011-06-10,0,Jun,14,0,Fri,1,44,121,165
2011-06-10,0,Jun,15,0,Fri,1,49,163,212
2011-06-10,0,Jun,16,0,Fri,1,46,239,285
2011-06-10,0,Jun,17,0,Fri,1,63,454,517
2011-06-10,0,Jun,18,0,Fri,1,96,367,463
2011-06-10,0,Jun,19,0,Fri,1,61,245,306
2011-06-10,0,Jun,20,0,Fri,1,53,197,250
2011-06-10,0,Jun,21,0,Fri,1,55,163,218
2011-06-10,0,Jun,22,0,Fri,1,40,145,185
2011-06-10,0,Jun,23,0,Fri,1,36,110,146
2011-06-11,0,Jun,0,0,Sat,0,28,89,117
2011-06-11,0,Jun,1,0,Sat,0,10,67,77
2011-06-11,0,Jun,2,0,Sat,0,10,50,60
2011-06-11,0,Jun,3,0,Sat,0,10,18,28
2011-06-11,0,Jun,4,0,Sat,0,4,9,13
2011-06-11,0,Jun,5,0,Sat,0,4,12,16
2011-06-11,0,Jun,6,0,Sat,0,9,31,40
2011-06-11,0,Jun,7,0,Sat,0,18,50,68
2011-06-11,0,Jun,8,0,Sat,0,32,111,143
2011-06-11,0,Jun,9,0,Sat,0,59,171,230
2011-06-11,0,Jun,10,0,Sat,0,91,173,264
2011-06-11,0,Jun,11,0,Sat,0,110,215,325
2011-06-11,0,Jun,12,0,Sat,0,112,235,347
2011-06-11,0,Jun,13,0,Sat,0,150,237,387
2011-06-11,0,Jun,14,0,Sat,0,148,232,380
2011-06-11,0,Jun,15,0,Sat,0,142,232,374
2011-06-11,0,Jun,16,0,Sat,0,169,225,394
2011-06-11,0,Jun,17,0,Sat,0,147,190,337
2011-06-11,0,Jun,18,0,Sat,0,131,155,286
2011-06-11,0,Jun,19,0,Sat,0,97,167,264
2011-06-11,0,Jun,20,0,Sat,0,95,180,275
2011-06-11,0,Jun,21,0,Sat,0,76,144,220
2011-06-11,0,Jun,22,0,Sat,0,53,137,190
2011-06-11,0,Jun,23,0,Sat,0,24,107,131
2011-06-12,0,Jun,0,0,Sun,0,19,100,119
2011-06-12,0,Jun,1,0,Sun,0,19,74,93
2011-06-12,0,Jun,2,0,Sun,0,9,57,66
2011-06-12,0,Jun,3,0,Sun,0,8,20,28
2011-06-12,0,Jun,4,0,Sun,0,8,6,14
2011-06-12,0,Jun,5,0,Sun,0,5,5,10
2011-06-12,0,Jun,6,0,Sun,0,5,9,14
2011-06-12,0,Jun,7,0,Sun,0,7,27,34
2011-06-12,0,Jun,8,0,Sun,0,28,64,92
2011-06-12,0,Jun,9,0,Sun,0,75,107,182
2011-06-12,0,Jun,10,0,Sun,0,120,191,311
2011-06-12,0,Jun,11,0,Sun,0,131,236,367
2011-06-12,0,Jun,12,0,Sun,0,176,244,420
2011-06-12,0,Jun,13,0,Sun,0,109,264,373
2011-06-12,0,Jun,14,0,Sun,0,96,219,315
2011-06-12,0,Jun,15,0,Sun,0,142,218,360
2011-06-12,0,Jun,16,0,Sun,0,115,235,350
2011-06-12,0,Jun,17,0,Sun,0,94,158,252
2011-06-12,0,Jun,18,0,Sun,0,69,187,256
2011-06-12,0,Jun,19,0,Sun,0,67,156,223
2011-06-12,0,Jun,20,0,Sun,0,62,144,206
2011-06-12,0,Jun,21,0,Sun,0,39,101,140
2011-06-12,0,Jun,22,0,Sun,0,31,97,128
2011-06-12,0,Jun,23,0,Sun,0,33,74,107
2011-06-13,0,Jun,0,0,Mon,1,8,20,28
2011-06-13,0,Jun,1,0,Mon,1,6,10,16
2011-06-13,0,Jun,2,0,Mon,1,2,8,10
2011-06-13,0,Jun,3,0,Mon,1,1,6,7
2011-06-13,0,Jun,4,0,Mon,1,1,3,4
2011-06-13,0,Jun,5,0,Mon,1,2,27,29
2011-06-13,0,Jun,6,0,Mon,1,7,98,105
2011-06-13,0,Jun,7,0,Mon,1,26,302,328
2011-06-13,0,Jun,8,0,Mon,1,44,432,476
2011-06-13,0,Jun,9,0,Mon,1,35,189,224
2011-06-13,0,Jun,10,0,Mon,1,38,80,118
2011-06-13,0,Jun,11,0,Mon,1,53,106,159
2011-06-13,0,Jun,12,0,Mon,1,35,161,196
2011-06-13,0,Jun,13,0,Mon,1,53,174,227
2011-06-13,0,Jun,14,0,Mon,1,55,145,200
2011-06-13,0,Jun,15,0,Mon,1,58,127,185
2011-06-13,0,Jun,16,0,Mon,1,64,262,326
2011-06-13,0,Jun,17,0,Mon,1,72,529,601
2011-06-13,0,Jun,18,0,Mon,1,76,510,586
2011-06-13,0,Jun,19,0,Mon,1,75,348,423
2011-06-13,0,Jun,20,0,Mon,1,78,253,331
2011-06-13,0,Jun,21,0,Mon,1,40,178,218
2011-06-13,0,Jun,22,0,Mon,1,20,114,134
2011-06-13,0,Jun,23,0,Mon,1,14,75,89
2011-06-14,0,Jun,0,0,Tue,1,13,18,31
2011-06-14,0,Jun,1,0,Tue,1,3,10,13
2011-06-14,0,Jun,2,0,Tue,1,2,8,10
2011-06-14,0,Jun,3,0,Tue,1,1,1,2
2011-06-14,0,Jun,4,0,Tue,1,0,3,3
2011-06-14,0,Jun,5,0,Tue,1,3,23,26
2011-06-14,0,Jun,6,0,Tue,1,6,107,113
2011-06-14,0,Jun,7,0,Tue,1,19,346,365
2011-06-14,0,Jun,8,0,Tue,1,45,441,486
2011-06-14,0,Jun,9,0,Tue,1,19,174,193
2011-06-14,0,Jun,10,0,Tue,1,33,97,130
2011-06-14,0,Jun,11,0,Tue,1,40,103,143
2011-06-14,0,Jun,12,0,Tue,1,30,139,169
2011-06-14,0,Jun,13,0,Tue,1,33,176,209
2011-06-14,0,Jun,14,0,Tue,1,41,118,159
2011-06-14,0,Jun,15,0,Tue,1,42,136,178
2011-06-14,0,Jun,16,0,Tue,1,51,279,330
2011-06-14,0,Jun,17,0,Tue,1,85,484,569
2011-06-14,0,Jun,18,0,Tue,1,65,473,538
2011-06-14,0,Jun,19,0,Tue,1,51,335,386
2011-06-14,0,Jun,20,0,Tue,1,60,237,297
2011-06-14,0,Jun,21,0,Tue,1,37,206,243
2011-06-14,0,Jun,22,0,Tue,1,29,159,188
2011-06-14,0,Jun,23,0,Tue,1,19,91,110
2011-06-15,0,Jun,0,0,Wed,1,8,44,52
2011-06-15,0,Jun,1,0,Wed,1,0,14,14
2011-06-15,0,Jun,2,0,Wed,1,0,9,9
2011-06-15,0,Jun,3,0,Wed,1,0,1,1
2011-06-15,0,Jun,4,0,Wed,1,0,4,4
2011-06-15,0,Jun,5,0,Wed,1,1,20,21
2011-06-15,0,Jun,6,0,Wed,1,11,110,121
2011-06-15,0,Jun,7,0,Wed,1,22,348,370
2011-06-15,0,Jun,8,0,Wed,1,53,445,498
2011-06-15,0,Jun,9,0,Wed,1,22,185,207
2011-06-15,0,Jun,10,0,Wed,1,27,108,135
2011-06-15,0,Jun,11,0,Wed,1,49,115,164
2011-06-15,0,Jun,12,0,Wed,1,33,178,211
2011-06-15,0,Jun,13,0,Wed,1,43,146,189
2011-06-15,0,Jun,14,0,Wed,1,50,128,178
2011-06-15,0,Jun,15,0,Wed,1,33,131,164
2011-06-15,0,Jun,16,0,Wed,1,47,265,312
2011-06-15,0,Jun,17,0,Wed,1,83,555,638
2011-06-15,0,Jun,18,0,Wed,1,80,527,607
2011-06-15,0,Jun,19,0,Wed,1,54,362,416
2011-06-15,0,Jun,20,0,Wed,1,57,273,330
2011-06-15,0,Jun,21,0,Wed,1,48,209,257
2011-06-15,0,Jun,22,0,Wed,1,31,144,175
2011-06-15,0,Jun,23,0,Wed,1,17,90,107
2011-06-16,0,Jun,0,0,Thur,1,9,38,47
2011-06-16,0,Jun,1,0,Thur,1,4,13,17
2011-06-16,0,Jun,2,0,Thur,1,1,4,5
2011-06-16,0,Jun,3,0,Thur,1,0,4,4
2011-06-16,0,Jun,4,0,Thur,1,0,6,6
2011-06-16,0,Jun,5,0,Thur,1,7,18,25
2011-06-16,0,Jun,6,0,Thur,1,8,104,112
2011-06-16,0,Jun,7,0,Thur,1,16,172,188
2011-06-16,0,Jun,8,0,Thur,1,24,364,388
2011-06-16,0,Jun,9,0,Thur,1,29,232,261
2011-06-16,0,Jun,10,0,Thur,1,18,103,121
2011-06-16,0,Jun,11,0,Thur,1,33,117,150
2011-06-16,0,Jun,12,0,Thur,1,41,165,206
2011-06-16,0,Jun,13,0,Thur,1,37,114,151
2011-06-16,0,Jun,14,0,Thur,1,39,114,153
2011-06-16,0,Jun,15,0,Thur,1,32,127,159
2011-06-16,0,Jun,16,0,Thur,1,36,258,294
2011-06-16,0,Jun,17,0,Thur,1,42,230,272
2011-06-16,0,Jun,18,0,Thur,1,26,299,325
2011-06-16,0,Jun,19,0,Thur,1,58,269,327
2011-06-16,0,Jun,20,0,Thur,1,25,176,201
2011-06-16,0,Jun,21,0,Thur,1,34,154,188
2011-06-16,0,Jun,22,0,Thur,1,24,127,151
2011-06-16,0,Jun,23,0,Thur,1,2,14,16
2011-06-17,0,Jun,0,0,Fri,1,3,21,24
2011-06-17,0,Jun,1,0,Fri,1,4,19,23
2011-06-17,0,Jun,2,0,Fri,1,2,11,13
2011-06-17,0,Jun,3,0,Fri,1,1,5,6
2011-06-17,0,Jun,4,0,Fri,1,1,5,6
2011-06-17,0,Jun,5,0,Fri,1,1,12,13
2011-06-17,0,Jun,6,0,Fri,1,8,89,97
2011-06-17,0,Jun,7,0,Fri,1,25,225,250
2011-06-17,0,Jun,8,0,Fri,1,28,426,454
2011-06-17,0,Jun,9,0,Fri,1,28,196,224
2011-06-17,0,Jun,10,0,Fri,1,44,126,170
2011-06-17,0,Jun,11,0,Fri,1,43,138,181
2011-06-17,0,Jun,12,0,Fri,1,49,194,243
2011-06-17,0,Jun,13,0,Fri,1,48,156,204
2011-06-17,0,Jun,14,0,Fri,1,73,142,215
2011-06-17,0,Jun,15,0,Fri,1,62,181,243
2011-06-17,0,Jun,16,0,Fri,1,69,286,355
2011-06-17,0,Jun,17,0,Fri,1,85,467,552
2011-06-17,0,Jun,18,0,Fri,1,62,388,450
2011-06-17,0,Jun,19,0,Fri,1,53,275,328
2011-06-17,0,Jun,20,0,Fri,1,40,192,232
2011-06-17,0,Jun,21,0,Fri,1,49,159,208
2011-06-17,0,Jun,22,0,Fri,1,48,127,175
2011-06-17,0,Jun,23,0,Fri,1,37,141,178
2011-06-18,0,Jun,0,0,Sat,0,21,83,104
2011-06-18,0,Jun,1,0,Sat,0,15,80,95
2011-06-18,0,Jun,2,0,Sat,0,16,37,53
2011-06-18,0,Jun,3,0,Sat,0,4,16,20
2011-06-18,0,Jun,4,0,Sat,0,1,4,5
2011-06-18,0,Jun,5,0,Sat,0,1,6,7
2011-06-18,0,Jun,6,0,Sat,0,9,18,27
2011-06-18,0,Jun,7,0,Sat,0,12,45,57
2011-06-18,0,Jun,8,0,Sat,0,28,103,131
2011-06-18,0,Jun,9,0,Sat,0,62,156,218
2011-06-18,0,Jun,10,0,Sat,0,68,176,244
2011-06-18,0,Jun,11,0,Sat,0,134,270,404
2011-06-18,0,Jun,12,0,Sat,0,162,258,420
2011-06-18,0,Jun,13,0,Sat,0,135,192,327
2011-06-18,0,Jun,14,0,Sat,0,138,196,334
2011-06-18,0,Jun,15,0,Sat,0,153,214,367
2011-06-18,0,Jun,16,0,Sat,0,193,275,468
2011-06-18,0,Jun,17,0,Sat,0,210,239,449
2011-06-18,0,Jun,18,0,Sat,0,118,263,381
2011-06-18,0,Jun,19,0,Sat,0,99,227,326
2011-06-18,0,Jun,20,0,Sat,0,61,127,188
2011-06-18,0,Jun,21,0,Sat,0,58,125,183
2011-06-18,0,Jun,22,0,Sat,0,56,105,161
2011-06-18,0,Jun,23,0,Sat,0,53,97,150
2011-06-19,0,Jun,0,0,Sun,0,18,71,89
2011-06-19,0,Jun,1,0,Sun,0,17,59,76
2011-06-19,0,Jun,2,0,Sun,0,13,59,72
2011-06-19,0,Jun,3,0,Sun,0,14,16,30
2011-06-19,0,Jun,4,0,Sun,0,7,10,17
2011-06-19,0,Jun,5,0,Sun,0,7,12,19
2011-06-19,0,Jun,6,0,Sun,0,11,22,33
2011-06-19,0,Jun,7,0,Sun,0,35,36,71
2011-06-19,0,Jun,8,0,Sun,0,25,59,84
2011-06-19,0,Jun,9,0,Sun,0,58,111,169
2011-06-19,0,Jun,10,0,Sun,0,86,158,244
2011-06-19,0,Jun,11,0,Sun,0,141,236,377
2011-06-19,0,Jun,12,0,Sun,0,141,255,396
2011-06-19,0,Jun,13,0,Sun,0,149,214,363
2011-06-19,0,Jun,14,0,Sun,0,124,193,317
2011-06-19,0,Jun,15,0,Sun,0,146,216,362
2011-06-19,0,Jun,16,0,Sun,0,121,257,378
2011-06-19,0,Jun,17,0,Sun,0,159,238,397
2011-06-19,0,Jun,18,0,Sun,0,78,218,296
2011-06-19,0,Jun,19,0,Sun,0,94,217,311
2011-06-19,0,Jun,20,0,Sun,0,86,146,232
2011-06-19,0,Jun,21,0,Sun,0,57,110,167
2011-06-19,0,Jun,22,0,Sun,0,38,114,152
2011-06-19,0,Jun,23,0,Sun,0,14,78,92
2011-06-20,0,Jun,0,0,Mon,1,7,19,26
2011-06-20,0,Jun,1,0,Mon,1,9,3,12
2011-06-20,0,Jun,2,0,Mon,1,2,0,2
2011-06-20,0,Jun,3,0,Mon,1,1,0,1
2011-06-20,0,Jun,4,0,Mon,1,1,2,3
2011-06-20,0,Jun,5,0,Mon,1,0,3,3
2011-06-20,0,Jun,6,0,Mon,1,1,25,26
2011-06-20,0,Jun,7,0,Mon,1,0,46,46
2011-06-20,0,Jun,8,0,Mon,1,12,209,221
2011-06-20,0,Jun,9,0,Mon,1,19,200,219
2011-06-20,0,Jun,10,0,Mon,1,33,58,91
2011-06-20,0,Jun,11,0,Mon,1,27,67,94
2011-06-20,0,Jun,12,0,Mon,1,33,129,162
2011-06-20,0,Jun,13,0,Mon,1,50,129,179
2011-06-20,0,Jun,14,0,Mon,1,45,130,175
2011-06-20,0,Jun,15,0,Mon,1,66,139,205
2011-06-20,0,Jun,16,0,Mon,1,61,238,299
2011-06-20,0,Jun,17,0,Mon,1,81,484,565
2011-06-20,0,Jun,18,0,Mon,1,64,474,538
2011-06-20,0,Jun,19,0,Mon,1,62,369,431
2011-06-20,0,Jun,20,0,Mon,1,52,264,316
2011-06-20,0,Jun,21,0,Mon,1,39,167,206
2011-06-20,0,Jun,22,0,Mon,1,24,106,130
2011-06-20,0,Jun,23,0,Mon,1,10,50,60
2011-06-21,0,Jun,0,0,Tue,1,10,23,33
2011-06-21,0,Jun,1,0,Tue,1,2,12,14
2011-06-21,0,Jun,2,0,Tue,1,1,5,6
2011-06-21,0,Jun,3,0,Tue,1,0,2,2
2011-06-21,0,Jun,4,0,Tue,1,2,7,9
2011-06-21,0,Jun,5,0,Tue,1,3,22,25
2011-06-21,0,Jun,6,0,Tue,1,8,107,115
2011-06-21,0,Jun,7,0,Tue,1,21,288,309
2011-06-21,0,Jun,8,0,Tue,1,33,368,401
2011-06-21,0,Jun,9,0,Tue,1,32,243,275
2011-06-21,0,Jun,10,0,Tue,1,41,120,161
2011-06-21,0,Jun,11,0,Tue,1,52,119,171
2011-06-21,0,Jun,12,0,Tue,1,40,149,189
2011-06-21,0,Jun,13,0,Tue,1,49,158,207
2011-06-21,0,Jun,14,0,Tue,1,44,108,152
2011-06-21,0,Jun,15,0,Tue,1,42,128,170
2011-06-21,0,Jun,16,0,Tue,1,62,273,335
2011-06-21,0,Jun,17,0,Tue,1,65,507,572
2011-06-21,0,Jun,18,0,Tue,1,67,469,536
2011-06-21,0,Jun,19,0,Tue,1,67,358,425
2011-06-21,0,Jun,20,0,Tue,1,72,254,326
2011-06-21,0,Jun,21,0,Tue,1,38,191,229
2011-06-21,0,Jun,22,0,Tue,1,12,97,109
2011-06-21,0,Jun,23,0,Tue,1,11,53,64
2011-06-22,0,Jun,0,0,Wed,1,15,18,33
2011-06-22,0,Jun,1,0,Wed,1,2,19,21
2011-06-22,0,Jun,2,0,Wed,1,2,5,7
2011-06-22,0,Jun,3,0,Wed,1,0,7,7
2011-06-22,0,Jun,4,0,Wed,1,3,8,11
2011-06-22,0,Jun,5,0,Wed,1,2,21,23
2011-06-22,0,Jun,6,0,Wed,1,12,110,122
2011-06-22,0,Jun,7,0,Wed,1,23,288,311
2011-06-22,0,Jun,8,0,Wed,1,27,396,423
2011-06-22,0,Jun,9,0,Wed,1,14,205,219
2011-06-22,0,Jun,10,0,Wed,1,31,104,135
2011-06-22,0,Jun,11,0,Wed,1,37,108,145
2011-06-22,0,Jun,12,0,Wed,1,44,144,188
2011-06-22,0,Jun,13,0,Wed,1,34,113,147
2011-06-22,0,Jun,14,0,Wed,1,32,113,145
2011-06-22,0,Jun,15,0,Wed,1,32,114,146
2011-06-22,0,Jun,16,0,Wed,1,34,224,258
2011-06-22,0,Jun,17,0,Wed,1,67,462,529
2011-06-22,0,Jun,18,0,Wed,1,66,447,513
2011-06-22,0,Jun,19,0,Wed,1,62,280,342
2011-06-22,0,Jun,20,0,Wed,1,52,230,282
2011-06-22,0,Jun,21,0,Wed,1,31,216,247
2011-06-22,0,Jun,22,0,Wed,1,25,123,148
2011-06-22,0,Jun,23,0,Wed,1,14,91,105
2011-06-23,0,Jun,0,0,Thur,1,5,44,49
2011-06-23,0,Jun,1,0,Thur,1,5,26,31
2011-06-23,0,Jun,2,0,Thur,1,0,4,4
2011-06-23,0,Jun,3,0,Thur,1,1,4,5
2011-06-23,0,Jun,4,0,Thur,1,0,7,7
2011-06-23,0,Jun,5,0,Thur,1,2,22,24
2011-06-23,0,Jun,6,0,Thur,1,8,92,100
2011-06-23,0,Jun,7,0,Thur,1,26,301,327
2011-06-23,0,Jun,8,0,Thur,1,20,412,432
2011-06-23,0,Jun,9,0,Thur,1,33,194,227
2011-06-23,0,Jun,10,0,Thur,1,39,88,127
2011-06-23,0,Jun,11,0,Thur,1,28,108,136
2011-06-23,0,Jun,12,0,Thur,1,30,130,160
2011-06-23,0,Jun,13,0,Thur,1,37,149,186
2011-06-23,0,Jun,14,0,Thur,1,46,103,149
2011-06-23,0,Jun,15,0,Thur,1,62,127,189
2011-06-23,0,Jun,16,0,Thur,1,58,217,275
2011-06-23,0,Jun,17,0,Thur,1,74,495,569
2011-06-23,0,Jun,18,0,Thur,1,57,483,540
2011-06-23,0,Jun,19,0,Thur,1,56,344,400
2011-06-23,0,Jun,20,0,Thur,1,75,277,352
2011-06-23,0,Jun,21,0,Thur,1,46,188,234
2011-06-23,0,Jun,22,0,Thur,1,23,139,162
2011-06-23,0,Jun,23,0,Thur,1,15,90,105
2011-06-24,0,Jun,0,0,Fri,1,10,53,63
2011-06-24,0,Jun,1,0,Fri,1,8,20,28
2011-06-24,0,Jun,2,0,Fri,1,4,10,14
2011-06-24,0,Jun,3,0,Fri,1,1,4,5
2011-06-24,0,Jun,4,0,Fri,1,1,8,9
2011-06-24,0,Jun,5,0,Fri,1,2,18,20
2011-06-24,0,Jun,6,0,Fri,1,4,87,91
2011-06-24,0,Jun,7,0,Fri,1,21,247,268
2011-06-24,0,Jun,8,0,Fri,1,27,439,466
2011-06-24,0,Jun,9,0,Fri,1,28,203,231
2011-06-24,0,Jun,10,0,Fri,1,43,102,145
2011-06-24,0,Jun,11,0,Fri,1,56,147,203
2011-06-24,0,Jun,12,0,Fri,1,51,150,201
2011-06-24,0,Jun,13,0,Fri,1,43,178,221
2011-06-24,0,Jun,14,0,Fri,1,67,162,229
2011-06-24,0,Jun,15,0,Fri,1,69,147,216
2011-06-24,0,Jun,16,0,Fri,1,80,247,327
2011-06-24,0,Jun,17,0,Fri,1,85,472,557
2011-06-24,0,Jun,18,0,Fri,1,87,365,452
2011-06-24,0,Jun,19,0,Fri,1,92,293,385
2011-06-24,0,Jun,20,0,Fri,1,66,222,288
2011-06-24,0,Jun,21,0,Fri,1,50,183,233
2011-06-24,0,Jun,22,0,Fri,1,41,126,167
2011-06-24,0,Jun,23,0,Fri,1,33,139,172
2011-06-25,0,Jun,0,0,Sat,0,19,97,116
2011-06-25,0,Jun,1,0,Sat,0,20,75,95
2011-06-25,0,Jun,2,0,Sat,0,8,51,59
2011-06-25,0,Jun,3,0,Sat,0,18,21,39
2011-06-25,0,Jun,4,0,Sat,0,7,4,11
2011-06-25,0,Jun,5,0,Sat,0,6,8,14
2011-06-25,0,Jun,6,0,Sat,0,12,17,29
2011-06-25,0,Jun,7,0,Sat,0,7,35,42
2011-06-25,0,Jun,8,0,Sat,0,27,85,112
2011-06-25,0,Jun,9,0,Sat,0,47,139,186
2011-06-25,0,Jun,10,0,Sat,0,99,203,302
2011-06-25,0,Jun,11,0,Sat,0,122,209,331
2011-06-25,0,Jun,12,0,Sat,0,140,252,392
2011-06-25,0,Jun,13,0,Sat,0,140,231,371
2011-06-25,0,Jun,14,0,Sat,0,151,232,383
2011-06-25,0,Jun,15,0,Sat,0,157,235,392
2011-06-25,0,Jun,16,0,Sat,0,175,235,410
2011-06-25,0,Jun,17,0,Sat,0,152,247,399
2011-06-25,0,Jun,18,0,Sat,0,108,199,307
2011-06-25,0,Jun,19,0,Sat,0,121,254,375
2011-06-25,0,Jun,20,0,Sat,0,74,195,269
2011-06-25,0,Jun,21,0,Sat,0,62,140,202
2011-06-25,0,Jun,22,0,Sat,0,61,126,187
2011-06-25,0,Jun,23,0,Sat,0,49,130,179
2011-06-26,0,Jun,0,0,Sun,0,30,85,115
2011-06-26,0,Jun,1,0,Sun,0,17,73,90
2011-06-26,0,Jun,2,0,Sun,0,17,70,87
2011-06-26,0,Jun,3,0,Sun,0,12,22,34
2011-06-26,0,Jun,4,0,Sun,0,3,8,11
2011-06-26,0,Jun,5,0,Sun,0,3,9,12
2011-06-26,0,Jun,6,0,Sun,0,7,13,20
2011-06-26,0,Jun,7,0,Sun,0,24,27,51
2011-06-26,0,Jun,8,0,Sun,0,29,78,107
2011-06-26,0,Jun,9,0,Sun,0,75,131,206
2011-06-26,0,Jun,10,0,Sun,0,136,196,332
2011-06-26,0,Jun,11,0,Sun,0,127,219,346
2011-06-26,0,Jun,12,0,Sun,0,175,268,443
2011-06-26,0,Jun,13,0,Sun,0,197,245,442
2011-06-26,0,Jun,14,0,Sun,0,197,246,443
2011-06-26,0,Jun,15,0,Sun,0,174,229,403
2011-06-26,0,Jun,16,0,Sun,0,177,278,455
2011-06-26,0,Jun,17,0,Sun,0,178,243,421
2011-06-26,0,Jun,18,0,Sun,0,117,265,382
2011-06-26,0,Jun,19,0,Sun,0,89,228,317
2011-06-26,0,Jun,20,0,Sun,0,55,158,213
2011-06-26,0,Jun,21,0,Sun,0,48,135,183
2011-06-26,0,Jun,22,0,Sun,0,19,95,114
2011-06-26,0,Jun,23,0,Sun,0,14,64,78
2011-06-27,0,Jun,0,0,Mon,1,7,25,32
2011-06-27,0,Jun,1,0,Mon,1,4,11,15
2011-06-27,0,Jun,2,0,Mon,1,3,3,6
2011-06-27,0,Jun,3,0,Mon,1,0,2,2
2011-06-27,0,Jun,4,0,Mon,1,1,8,9
2011-06-27,0,Jun,5,0,Mon,1,1,21,22
2011-06-27,0,Jun,6,0,Mon,1,4,90,94
2011-06-27,0,Jun,7,0,Mon,1,14,247,261
2011-06-27,0,Jun,8,0,Mon,1,29,418,447
2011-06-27,0,Jun,9,0,Mon,1,37,150,187
2011-06-27,0,Jun,10,0,Mon,1,55,95,150
2011-06-27,0,Jun,11,0,Mon,1,55,95,150
2011-06-27,0,Jun,12,0,Mon,1,40,130,170
2011-06-27,0,Jun,13,0,Mon,1,37,127,164
2011-06-27,0,Jun,14,0,Mon,1,58,100,158
2011-06-27,0,Jun,15,0,Mon,1,76,126,202
2011-06-27,0,Jun,16,0,Mon,1,53,222,275
2011-06-27,0,Jun,17,0,Mon,1,90,514,604
2011-06-27,0,Jun,18,0,Mon,1,79,512,591
2011-06-27,0,Jun,19,0,Mon,1,56,340,396
2011-06-27,0,Jun,20,0,Mon,1,54,251,305
2011-06-27,0,Jun,21,0,Mon,1,52,190,242
2011-06-27,0,Jun,22,0,Mon,1,33,112,145
2011-06-27,0,Jun,23,0,Mon,1,16,65,81
2011-06-28,0,Jun,0,0,Tue,1,5,25,30
2011-06-28,0,Jun,1,0,Tue,1,5,8,13
2011-06-28,0,Jun,2,0,Tue,1,2,9,11
2011-06-28,0,Jun,3,0,Tue,1,0,2,2
2011-06-28,0,Jun,4,0,Tue,1,1,7,8
2011-06-28,0,Jun,5,0,Tue,1,1,20,21
2011-06-28,0,Jun,6,0,Tue,1,7,117,124
2011-06-28,0,Jun,7,0,Tue,1,27,320,347
2011-06-28,0,Jun,8,0,Tue,1,39,417,456
2011-06-28,0,Jun,9,0,Tue,1,38,208,246
2011-06-28,0,Jun,10,0,Tue,1,45,112,157
2011-06-28,0,Jun,11,0,Tue,1,49,118,167
2011-06-28,0,Jun,12,0,Tue,1,41,161,202
2011-06-28,0,Jun,13,0,Tue,1,33,156,189
2011-06-28,0,Jun,14,0,Tue,1,43,117,160
2011-06-28,0,Jun,15,0,Tue,1,39,127,166
2011-06-28,0,Jun,16,0,Tue,1,41,220,261
2011-06-28,0,Jun,17,0,Tue,1,70,509,579
2011-06-28,0,Jun,18,0,Tue,1,68,436,504
2011-06-28,0,Jun,19,0,Tue,1,44,255,299
2011-06-28,0,Jun,20,0,Tue,1,50,246,296
2011-06-28,0,Jun,21,0,Tue,1,31,164,195
2011-06-28,0,Jun,22,0,Tue,1,30,104,134
2011-06-28,0,Jun,23,0,Tue,1,23,58,81
2011-06-29,0,Jun,0,0,Wed,1,11,25,36
2011-06-29,0,Jun,1,0,Wed,1,10,18,28
2011-06-29,0,Jun,2,0,Wed,1,7,9,16
2011-06-29,0,Jun,3,0,Wed,1,2,3,5
2011-06-29,0,Jun,4,0,Wed,1,0,5,5
2011-06-29,0,Jun,5,0,Wed,1,3,19,22
2011-06-29,0,Jun,6,0,Wed,1,12,104,116
2011-06-29,0,Jun,7,0,Wed,1,18,318,336
2011-06-29,0,Jun,8,0,Wed,1,41,499,540
2011-06-29,0,Jun,9,0,Wed,1,32,189,221
2011-06-29,0,Jun,10,0,Wed,1,31,95,126
2011-06-29,0,Jun,11,0,Wed,1,53,117,170
2011-06-29,0,Jun,12,0,Wed,1,55,188,243
2011-06-29,0,Jun,13,0,Wed,1,45,186,231
2011-06-29,0,Jun,14,0,Wed,1,50,138,188
2011-06-29,0,Jun,15,0,Wed,1,43,146,189
2011-06-29,0,Jun,16,0,Wed,1,60,268,328
2011-06-29,0,Jun,17,0,Wed,1,78,492,570
2011-06-29,0,Jun,18,0,Wed,1,78,510,588
2011-06-29,0,Jun,19,0,Wed,1,60,341,401
2011-06-29,0,Jun,20,0,Wed,1,69,264,333
2011-06-29,0,Jun,21,0,Wed,1,26,195,221
2011-06-29,0,Jun,22,0,Wed,1,32,151,183
2011-06-29,0,Jun,23,0,Wed,1,32,97,129
2011-06-30,0,Jun,0,0,Thur,1,15,39,54
2011-06-30,0,Jun,1,0,Thur,1,13,19,32
2011-06-30,0,Jun,2,0,Thur,1,2,6,8
2011-06-30,0,Jun,3,0,Thur,1,2,7,9
2011-06-30,0,Jun,4,0,Thur,1,2,4,6
2011-06-30,0,Jun,5,0,Thur,1,1,24,25
2011-06-30,0,Jun,6,0,Thur,1,4,119,123
2011-06-30,0,Jun,7,0,Thur,1,29,291,320
2011-06-30,0,Jun,8,0,Thur,1,44,511,555
2011-06-30,0,Jun,9,0,Thur,1,33,227,260
2011-06-30,0,Jun,10,0,Thur,1,35,97,132
2011-06-30,0,Jun,11,0,Thur,1,47,122,169
2011-06-30,0,Jun,12,0,Thur,1,50,183,233
2011-06-30,0,Jun,13,0,Thur,1,70,162,232
2011-06-30,0,Jun,14,0,Thur,1,46,117,163
2011-06-30,0,Jun,15,0,Thur,1,64,176,240
2011-06-30,0,Jun,16,0,Thur,1,63,260,323
2011-06-30,0,Jun,17,0,Thur,1,98,496,594
2011-06-30,0,Jun,18,0,Thur,1,114,472,586
2011-06-30,0,Jun,19,0,Thur,1,89,366,455
2011-06-30,0,Jun,20,0,Thur,1,55,285,340
2011-06-30,0,Jun,21,0,Thur,1,81,242,323
2011-06-30,0,Jun,22,0,Thur,1,43,164,207
2011-06-30,0,Jun,23,0,Thur,1,27,99,126
2011-07-01,0,Jul,0,0,Fri,1,20,48,68
2011-07-01,0,Jul,1,0,Fri,1,15,16,31
2011-07-01,0,Jul,2,0,Fri,1,6,7,13
2011-07-01,0,Jul,3,0,Fri,1,5,6,11
2011-07-01,0,Jul,4,0,Fri,1,1,5,6
2011-07-01,0,Jul,5,0,Fri,1,3,27,30
2011-07-01,0,Jul,6,0,Fri,1,11,97,108
2011-07-01,0,Jul,7,0,Fri,1,25,218,243
2011-07-01,0,Jul,8,0,Fri,1,39,453,492
2011-07-01,0,Jul,9,0,Fri,1,58,202,260
2011-07-01,0,Jul,10,0,Fri,1,61,109,170
2011-07-01,0,Jul,11,0,Fri,1,68,146,214
2011-07-01,0,Jul,12,0,Fri,1,83,180,263
2011-07-01,0,Jul,13,0,Fri,1,83,209,292
2011-07-01,0,Jul,14,0,Fri,1,78,225,303
2011-07-01,0,Jul,15,0,Fri,1,82,299,381
2011-07-01,0,Jul,16,0,Fri,1,85,342,427
2011-07-01,0,Jul,17,0,Fri,1,99,362,461
2011-07-01,0,Jul,18,0,Fri,1,98,324,422
2011-07-01,0,Jul,19,0,Fri,1,80,238,318
2011-07-01,0,Jul,20,0,Fri,1,84,185,269
2011-07-01,0,Jul,21,0,Fri,1,69,149,218
2011-07-01,0,Jul,22,0,Fri,1,49,173,222
2011-07-01,0,Jul,23,0,Fri,1,44,96,140
2011-07-02,0,Jul,0,0,Sat,0,31,84,115
2011-07-02,0,Jul,1,0,Sat,0,20,58,78
2011-07-02,0,Jul,2,0,Sat,0,9,43,52
2011-07-02,0,Jul,3,0,Sat,0,5,21,26
2011-07-02,0,Jul,4,0,Sat,0,3,8,11
2011-07-02,0,Jul,5,0,Sat,0,1,13,14
2011-07-02,0,Jul,6,0,Sat,0,11,21,32
2011-07-02,0,Jul,7,0,Sat,0,10,35,45
2011-07-02,0,Jul,8,0,Sat,0,38,94,132
2011-07-02,0,Jul,9,0,Sat,0,55,124,179
2011-07-02,0,Jul,10,0,Sat,0,103,168,271
2011-07-02,0,Jul,11,0,Sat,0,144,213,357
2011-07-02,0,Jul,12,0,Sat,0,142,232,374
2011-07-02,0,Jul,13,0,Sat,0,178,226,404
2011-07-02,0,Jul,14,0,Sat,0,177,215,392
2011-07-02,0,Jul,15,0,Sat,0,168,163,331
2011-07-02,0,Jul,16,0,Sat,0,206,192,398
2011-07-02,0,Jul,17,0,Sat,0,179,170,349
2011-07-02,0,Jul,18,0,Sat,0,193,190,383
2011-07-02,0,Jul,19,0,Sat,0,156,149,305
2011-07-02,0,Jul,20,0,Sat,0,136,148,284
2011-07-02,0,Jul,21,0,Sat,0,95,137,232
2011-07-02,0,Jul,22,0,Sat,0,78,123,201
2011-07-02,0,Jul,23,0,Sat,0,66,88,154
2011-07-03,0,Jul,0,0,Sun,0,47,97,144
2011-07-03,0,Jul,1,0,Sun,0,23,55,78
2011-07-03,0,Jul,2,0,Sun,0,19,50,69
2011-07-03,0,Jul,3,0,Sun,0,8,25,33
2011-07-03,0,Jul,4,0,Sun,0,3,2,5
2011-07-03,0,Jul,5,0,Sun,0,0,1,1
2011-07-03,0,Jul,6,0,Sun,0,0,3,3
2011-07-03,0,Jul,7,0,Sun,0,3,22,25
2011-07-03,0,Jul,8,0,Sun,0,39,53,92
2011-07-03,0,Jul,9,0,Sun,0,82,99,181
2011-07-03,0,Jul,10,0,Sun,0,131,133,264
2011-07-03,0,Jul,11,0,Sun,0,215,175,390
2011-07-03,0,Jul,12,0,Sun,0,198,206,404
2011-07-03,0,Jul,13,0,Sun,0,248,173,421
2011-07-03,0,Jul,14,0,Sun,0,225,150,375
2011-07-03,0,Jul,15,0,Sun,0,194,182,376
2011-07-03,0,Jul,16,0,Sun,0,195,219,414
2011-07-03,0,Jul,17,0,Sun,0,181,177,358
2011-07-03,0,Jul,18,0,Sun,0,74,107,181
2011-07-03,0,Jul,19,0,Sun,0,100,83,183
2011-07-03,0,Jul,20,0,Sun,0,83,93,176
2011-07-03,0,Jul,21,0,Sun,0,75,92,167
2011-07-03,0,Jul,22,0,Sun,0,69,93,162
2011-07-03,0,Jul,23,0,Sun,0,70,77,147
2011-07-04,0,Jul,0,1,Mon,0,63,77,140
2011-07-04,0,Jul,1,1,Mon,0,43,76,119
2011-07-04,0,Jul,2,1,Mon,0,33,30,63
2011-07-04,0,Jul,3,1,Mon,0,13,13,26
2011-07-04,0,Jul,4,1,Mon,0,8,4,12
2011-07-04,0,Jul,5,1,Mon,0,1,3,4
2011-07-04,0,Jul,6,1,Mon,0,5,11,16
2011-07-04,0,Jul,7,1,Mon,0,17,19,36
2011-07-04,0,Jul,8,1,Mon,0,42,44,86
2011-07-04,0,Jul,9,1,Mon,0,142,96,238
2011-07-04,0,Jul,10,1,Mon,0,166,114,280
2011-07-04,0,Jul,11,1,Mon,0,177,172,349
2011-07-04,0,Jul,12,1,Mon,0,237,210,447
2011-07-04,0,Jul,13,1,Mon,0,242,181,423
2011-07-04,0,Jul,14,1,Mon,0,235,173,408
2011-07-04,0,Jul,15,1,Mon,0,224,184,408
2011-07-04,0,Jul,16,1,Mon,0,236,216,452
2011-07-04,0,Jul,17,1,Mon,0,240,196,436
2011-07-04,0,Jul,18,1,Mon,0,222,196,418
2011-07-04,0,Jul,19,1,Mon,0,170,205,375
2011-07-04,0,Jul,20,1,Mon,0,195,191,386
2011-07-04,0,Jul,21,1,Mon,0,195,262,457
2011-07-04,0,Jul,22,1,Mon,0,115,211,326
2011-07-04,0,Jul,23,1,Mon,0,44,94,138
2011-07-05,0,Jul,0,0,Tue,1,19,36,55
2011-07-05,0,Jul,1,0,Tue,1,15,24,39
2011-07-05,0,Jul,2,0,Tue,1,8,5,13
2011-07-05,0,Jul,3,0,Tue,1,1,7,8
2011-07-05,0,Jul,4,0,Tue,1,1,4,5
2011-07-05,0,Jul,5,0,Tue,1,1,19,20
2011-07-05,0,Jul,6,0,Tue,1,3,91,94
2011-07-05,0,Jul,7,0,Tue,1,22,248,270
2011-07-05,0,Jul,8,0,Tue,1,41,391,432
2011-07-05,0,Jul,9,0,Tue,1,50,177,227
2011-07-05,0,Jul,10,0,Tue,1,55,84,139
2011-07-05,0,Jul,11,0,Tue,1,75,97,172
2011-07-05,0,Jul,12,0,Tue,1,71,130,201
2011-07-05,0,Jul,13,0,Tue,1,67,136,203
2011-07-05,0,Jul,14,0,Tue,1,66,112,178
2011-07-05,0,Jul,15,0,Tue,1,51,111,162
2011-07-05,0,Jul,16,0,Tue,1,79,202,281
2011-07-05,0,Jul,17,0,Tue,1,79,466,545
2011-07-05,0,Jul,18,0,Tue,1,70,426,496
2011-07-05,0,Jul,19,0,Tue,1,71,297,368
2011-07-05,0,Jul,20,0,Tue,1,59,225,284
2011-07-05,0,Jul,21,0,Tue,1,77,168,245
2011-07-05,0,Jul,22,0,Tue,1,31,124,155
2011-07-05,0,Jul,23,0,Tue,1,19,54,73
2011-07-06,0,Jul,0,0,Wed,1,11,26,37
2011-07-06,0,Jul,1,0,Wed,1,4,11,15
2011-07-06,0,Jul,2,0,Wed,1,1,4,5
2011-07-06,0,Jul,3,0,Wed,1,0,6,6
2011-07-06,0,Jul,4,0,Wed,1,0,6,6
2011-07-06,0,Jul,5,0,Wed,1,5,30,35
2011-07-06,0,Jul,6,0,Wed,1,9,112,121
2011-07-06,0,Jul,7,0,Wed,1,24,288,312
2011-07-06,0,Jul,8,0,Wed,1,31,397,428
2011-07-06,0,Jul,9,0,Wed,1,31,158,189
2011-07-06,0,Jul,10,0,Wed,1,13,30,43
2011-07-06,0,Jul,11,0,Wed,1,24,103,127
2011-07-06,0,Jul,12,0,Wed,1,38,114,152
2011-07-06,0,Jul,13,0,Wed,1,33,107,140
2011-07-06,0,Jul,14,0,Wed,1,50,113,163
2011-07-06,0,Jul,15,0,Wed,1,55,130,185
2011-07-06,0,Jul,16,0,Wed,1,57,218,275
2011-07-06,0,Jul,17,0,Wed,1,79,517,596
2011-07-06,0,Jul,18,0,Wed,1,77,486,563
2011-07-06,0,Jul,19,0,Wed,1,71,323,394
2011-07-06,0,Jul,20,0,Wed,1,55,257,312
2011-07-06,0,Jul,21,0,Wed,1,66,175,241
2011-07-06,0,Jul,22,0,Wed,1,30,156,186
2011-07-06,0,Jul,23,0,Wed,1,20,78,98
2011-07-07,0,Jul,0,0,Thur,1,6,29,35
2011-07-07,0,Jul,1,0,Thur,1,2,14,16
2011-07-07,0,Jul,2,0,Thur,1,1,7,8
2011-07-07,0,Jul,3,0,Thur,1,2,2,4
2011-07-07,0,Jul,4,0,Thur,1,0,4,4
2011-07-07,0,Jul,5,0,Thur,1,2,30,32
2011-07-07,0,Jul,6,0,Thur,1,11,107,118
2011-07-07,0,Jul,7,0,Thur,1,13,279,292
2011-07-07,0,Jul,8,0,Thur,1,28,415,443
2011-07-07,0,Jul,9,0,Thur,1,25,154,179
2011-07-07,0,Jul,10,0,Thur,1,29,72,101
2011-07-07,0,Jul,11,0,Thur,1,30,112,142
2011-07-07,0,Jul,12,0,Thur,1,32,139,171
2011-07-07,0,Jul,13,0,Thur,1,48,107,155
2011-07-07,0,Jul,14,0,Thur,1,39,121,160
2011-07-07,0,Jul,15,0,Thur,1,47,119,166
2011-07-07,0,Jul,16,0,Thur,1,47,218,265
2011-07-07,0,Jul,17,0,Thur,1,80,489,569
2011-07-07,0,Jul,18,0,Thur,1,70,492,562
2011-07-07,0,Jul,19,0,Thur,1,79,286,365
2011-07-07,0,Jul,20,0,Thur,1,61,224,285
2011-07-07,0,Jul,21,0,Thur,1,39,170,209
2011-07-07,0,Jul,22,0,Thur,1,32,150,182
2011-07-07,0,Jul,23,0,Thur,1,31,98,129
2011-07-08,0,Jul,0,0,Fri,1,6,41,47
2011-07-08,0,Jul,1,0,Fri,1,9,25,34
2011-07-08,0,Jul,2,0,Fri,1,10,12,22
2011-07-08,0,Jul,3,0,Fri,1,2,4,6
2011-07-08,0,Jul,4,0,Fri,1,7,4,11
2011-07-08,0,Jul,5,0,Fri,1,3,24,27
2011-07-08,0,Jul,6,0,Fri,1,11,91,102
2011-07-08,0,Jul,7,0,Fri,1,30,302,332
2011-07-08,0,Jul,8,0,Fri,1,36,421,457
2011-07-08,0,Jul,9,0,Fri,1,30,211,241
2011-07-08,0,Jul,10,0,Fri,1,30,108,138
2011-07-08,0,Jul,11,0,Fri,1,61,104,165
2011-07-08,0,Jul,12,0,Fri,1,49,164,213
2011-07-08,0,Jul,13,0,Fri,1,54,175,229
2011-07-08,0,Jul,14,0,Fri,1,53,163,216
2011-07-08,0,Jul,15,0,Fri,1,39,102,141
2011-07-08,0,Jul,16,0,Fri,1,27,105,132
2011-07-08,0,Jul,17,0,Fri,1,6,161,167
2011-07-08,0,Jul,18,0,Fri,1,35,281,316
2011-07-08,0,Jul,19,0,Fri,1,45,225,270
2011-07-08,0,Jul,20,0,Fri,1,30,220,250
2011-07-08,0,Jul,21,0,Fri,1,46,158,204
2011-07-08,0,Jul,22,0,Fri,1,33,136,169
2011-07-08,0,Jul,23,0,Fri,1,40,111,151
2011-07-09,0,Jul,0,0,Sat,0,31,90,121
2011-07-09,0,Jul,1,0,Sat,0,5,48,53
2011-07-09,0,Jul,2,0,Sat,0,12,43,55
2011-07-09,0,Jul,3,0,Sat,0,7,23,30
2011-07-09,0,Jul,4,0,Sat,0,2,4,6
2011-07-09,0,Jul,5,0,Sat,0,4,11,15
2011-07-09,0,Jul,6,0,Sat,0,11,27,38
2011-07-09,0,Jul,7,0,Sat,0,21,50,71
2011-07-09,0,Jul,8,0,Sat,0,68,114,182
2011-07-09,0,Jul,9,0,Sat,0,77,170,247
2011-07-09,0,Jul,10,0,Sat,0,87,177,264
2011-07-09,0,Jul,11,0,Sat,0,101,189,290
2011-07-09,0,Jul,12,0,Sat,0,145,221,366
2011-07-09,0,Jul,13,0,Sat,0,167,249,416
2011-07-09,0,Jul,14,0,Sat,0,158,215,373
2011-07-09,0,Jul,15,0,Sat,0,182,220,402
2011-07-09,0,Jul,16,0,Sat,0,171,245,416
2011-07-09,0,Jul,17,0,Sat,0,160,241,401
2011-07-09,0,Jul,18,0,Sat,0,132,246,378
2011-07-09,0,Jul,19,0,Sat,0,128,178,306
2011-07-09,0,Jul,20,0,Sat,0,129,185,314
2011-07-09,0,Jul,21,0,Sat,0,83,155,238
2011-07-09,0,Jul,22,0,Sat,0,60,154,214
2011-07-09,0,Jul,23,0,Sat,0,47,93,140
2011-07-10,0,Jul,0,0,Sun,0,42,112,154
2011-07-10,0,Jul,1,0,Sun,0,19,94,113
2011-07-10,0,Jul,2,0,Sun,0,28,68,96
2011-07-10,0,Jul,3,0,Sun,0,6,19,25
2011-07-10,0,Jul,4,0,Sun,0,0,5,5
2011-07-10,0,Jul,5,0,Sun,0,7,10,17
2011-07-10,0,Jul,6,0,Sun,0,8,17,25
2011-07-10,0,Jul,7,0,Sun,0,27,38,65
2011-07-10,0,Jul,8,0,Sun,0,27,65,92
2011-07-10,0,Jul,9,0,Sun,0,62,107,169
2011-07-10,0,Jul,10,0,Sun,0,95,173,268
2011-07-10,0,Jul,11,0,Sun,0,110,177,287
2011-07-10,0,Jul,12,0,Sun,0,133,244,377
2011-07-10,0,Jul,13,0,Sun,0,139,228,367
2011-07-10,0,Jul,14,0,Sun,0,122,227,349
2011-07-10,0,Jul,15,0,Sun,0,142,219,361
2011-07-10,0,Jul,16,0,Sun,0,128,244,372
2011-07-10,0,Jul,17,0,Sun,0,146,217,363
2011-07-10,0,Jul,18,0,Sun,0,141,222,363
2011-07-10,0,Jul,19,0,Sun,0,120,183,303
2011-07-10,0,Jul,20,0,Sun,0,101,167,268
2011-07-10,0,Jul,21,0,Sun,0,65,162,227
2011-07-10,0,Jul,22,0,Sun,0,56,87,143
2011-07-10,0,Jul,23,0,Sun,0,19,53,72
2011-07-11,0,Jul,0,0,Mon,1,10,25,35
2011-07-11,0,Jul,1,0,Mon,1,5,5,10
2011-07-11,0,Jul,2,0,Mon,1,8,4,12
2011-07-11,0,Jul,3,0,Mon,1,2,8,10
2011-07-11,0,Jul,4,0,Mon,1,0,4,4
2011-07-11,0,Jul,5,0,Mon,1,5,21,26
2011-07-11,0,Jul,6,0,Mon,1,19,102,121
2011-07-11,0,Jul,7,0,Mon,1,28,289,317
2011-07-11,0,Jul,8,0,Mon,1,35,385,420
2011-07-11,0,Jul,9,0,Mon,1,41,167,208
2011-07-11,0,Jul,10,0,Mon,1,44,73,117
2011-07-11,0,Jul,11,0,Mon,1,39,89,128
2011-07-11,0,Jul,12,0,Mon,1,40,108,148
2011-07-11,0,Jul,13,0,Mon,1,22,119,141
2011-07-11,0,Jul,14,0,Mon,1,40,94,134
2011-07-11,0,Jul,15,0,Mon,1,38,108,146
2011-07-11,0,Jul,16,0,Mon,1,57,182,239
2011-07-11,0,Jul,17,0,Mon,1,59,455,514
2011-07-11,0,Jul,18,0,Mon,1,57,415,472
2011-07-11,0,Jul,19,0,Mon,1,80,293,373
2011-07-11,0,Jul,20,0,Mon,1,42,194,236
2011-07-11,0,Jul,21,0,Mon,1,21,109,130
2011-07-11,0,Jul,22,0,Mon,1,20,70,90
2011-07-11,0,Jul,23,0,Mon,1,11,44,55
2011-07-12,0,Jul,0,0,Tue,1,3,19,22
2011-07-12,0,Jul,1,0,Tue,1,6,8,14
2011-07-12,0,Jul,2,0,Tue,1,2,7,9
2011-07-12,0,Jul,3,0,Tue,1,2,6,8
2011-07-12,0,Jul,4,0,Tue,1,0,6,6
2011-07-12,0,Jul,5,0,Tue,1,4,21,25
2011-07-12,0,Jul,6,0,Tue,1,13,102,115
2011-07-12,0,Jul,7,0,Tue,1,29,301,330
2011-07-12,0,Jul,8,0,Tue,1,35,382,417
2011-07-12,0,Jul,9,0,Tue,1,27,149,176
2011-07-12,0,Jul,10,0,Tue,1,38,85,123
2011-07-12,0,Jul,11,0,Tue,1,39,86,125
2011-07-12,0,Jul,12,0,Tue,1,38,125,163
2011-07-12,0,Jul,13,0,Tue,1,32,104,136
2011-07-12,0,Jul,14,0,Tue,1,33,91,124
2011-07-12,0,Jul,15,0,Tue,1,37,111,148
2011-07-12,0,Jul,16,0,Tue,1,25,177,202
2011-07-12,0,Jul,17,0,Tue,1,48,380,428
2011-07-12,0,Jul,18,0,Tue,1,39,472,511
2011-07-12,0,Jul,19,0,Tue,1,42,295,337
2011-07-12,0,Jul,20,0,Tue,1,57,251,308
2011-07-12,0,Jul,21,0,Tue,1,49,209,258
2011-07-12,0,Jul,22,0,Tue,1,44,150,194
2011-07-12,0,Jul,23,0,Tue,1,20,59,79
2011-07-13,0,Jul,0,0,Wed,1,9,37,46
2011-07-13,0,Jul,1,0,Wed,1,1,11,12
2011-07-13,0,Jul,2,0,Wed,1,2,3,5
2011-07-13,0,Jul,3,0,Wed,1,0,4,4
2011-07-13,0,Jul,4,0,Wed,1,0,5,5
2011-07-13,0,Jul,5,0,Wed,1,4,22,26
2011-07-13,0,Jul,6,0,Wed,1,18,103,121
2011-07-13,0,Jul,7,0,Wed,1,32,281,313
2011-07-13,0,Jul,8,0,Wed,1,31,418,449
2011-07-13,0,Jul,9,0,Wed,1,23,163,186
2011-07-13,0,Jul,10,0,Wed,1,33,80,113
2011-07-13,0,Jul,11,0,Wed,1,55,110,165
2011-07-13,0,Jul,12,0,Wed,1,40,134,174
2011-07-13,0,Jul,13,0,Wed,1,39,119,158
2011-07-13,0,Jul,14,0,Wed,1,27,89,116
2011-07-13,0,Jul,15,0,Wed,1,13,33,46
2011-07-13,0,Jul,16,0,Wed,1,23,118,141
2011-07-13,0,Jul,17,0,Wed,1,70,418,488
2011-07-13,0,Jul,18,0,Wed,1,51,412,463
2011-07-13,0,Jul,19,0,Wed,1,79,340,419
2011-07-13,0,Jul,20,0,Wed,1,61,281,342
2011-07-13,0,Jul,21,0,Wed,1,56,194,250
2011-07-13,0,Jul,22,0,Wed,1,48,136,184
2011-07-13,0,Jul,23,0,Wed,1,33,83,116
2011-07-14,0,Jul,0,0,Thur,1,14,32,46
2011-07-14,0,Jul,1,0,Thur,1,4,21,25
2011-07-14,0,Jul,2,0,Thur,1,3,7,10
2011-07-14,0,Jul,3,0,Thur,1,1,5,6
2011-07-14,0,Jul,4,0,Thur,1,0,6,6
2011-07-14,0,Jul,5,0,Thur,1,6,22,28
2011-07-14,0,Jul,6,0,Thur,1,14,116,130
2011-07-14,0,Jul,7,0,Thur,1,23,311,334
2011-07-14,0,Jul,8,0,Thur,1,53,433,486
2011-07-14,0,Jul,9,0,Thur,1,29,195,224
2011-07-14,0,Jul,10,0,Thur,1,32,95,127
2011-07-14,0,Jul,11,0,Thur,1,38,110,148
2011-07-14,0,Jul,12,0,Thur,1,51,172,223
2011-07-14,0,Jul,13,0,Thur,1,39,138,177
2011-07-14,0,Jul,14,0,Thur,1,49,129,178
2011-07-14,0,Jul,15,0,Thur,1,42,138,180
2011-07-14,0,Jul,16,0,Thur,1,43,231,274
2011-07-14,0,Jul,17,0,Thur,1,78,517,595
2011-07-14,0,Jul,18,0,Thur,1,94,484,578
2011-07-14,0,Jul,19,0,Thur,1,67,333,400
2011-07-14,0,Jul,20,0,Thur,1,81,267,348
2011-07-14,0,Jul,21,0,Thur,1,58,203,261
2011-07-14,0,Jul,22,0,Thur,1,42,134,176
2011-07-14,0,Jul,23,0,Thur,1,27,97,124
2011-07-15,0,Jul,0,0,Fri,1,23,57,80
2011-07-15,0,Jul,1,0,Fri,1,7,13,20
2011-07-15,0,Jul,2,0,Fri,1,16,22,38
2011-07-15,0,Jul,3,0,Fri,1,1,6,7
2011-07-15,0,Jul,4,0,Fri,1,2,8,10
2011-07-15,0,Jul,5,0,Fri,1,7,16,23
2011-07-15,0,Jul,6,0,Fri,1,12,108,120
2011-07-15,0,Jul,7,0,Fri,1,17,257,274
2011-07-15,0,Jul,8,0,Fri,1,50,514,564
2011-07-15,0,Jul,9,0,Fri,1,31,176,207
2011-07-15,0,Jul,10,0,Fri,1,59,107,166
2011-07-15,0,Jul,11,0,Fri,1,73,137,210
2011-07-15,0,Jul,12,0,Fri,1,61,177,238
2011-07-15,0,Jul,13,0,Fri,1,85,162,247
2011-07-15,0,Jul,14,0,Fri,1,105,160,265
2011-07-15,0,Jul,15,0,Fri,1,74,163,237
2011-07-15,0,Jul,16,0,Fri,1,96,265,361
2011-07-15,0,Jul,17,0,Fri,1,104,483,587
2011-07-15,0,Jul,18,0,Fri,1,102,394,496
2011-07-15,0,Jul,19,0,Fri,1,114,280,394
2011-07-15,0,Jul,20,0,Fri,1,92,251,343
2011-07-15,0,Jul,21,0,Fri,1,75,186,261
2011-07-15,0,Jul,22,0,Fri,1,71,152,223
2011-07-15,0,Jul,23,0,Fri,1,41,126,167
2011-07-16,0,Jul,0,0,Sat,0,42,68,110
2011-07-16,0,Jul,1,0,Sat,0,24,51,75
2011-07-16,0,Jul,2,0,Sat,0,10,48,58
2011-07-16,0,Jul,3,0,Sat,0,6,20,26
2011-07-16,0,Jul,4,0,Sat,0,9,7,16
2011-07-16,0,Jul,5,0,Sat,0,4,6,10
2011-07-16,0,Jul,6,0,Sat,0,16,21,37
2011-07-16,0,Jul,7,0,Sat,0,14,38,52
2011-07-16,0,Jul,8,0,Sat,0,37,90,127
2011-07-16,0,Jul,9,0,Sat,0,72,150,222
2011-07-16,0,Jul,10,0,Sat,0,114,208,322
2011-07-16,0,Jul,11,0,Sat,0,171,225,396
2011-07-16,0,Jul,12,0,Sat,0,187,276,463
2011-07-16,0,Jul,13,0,Sat,0,221,276,497
2011-07-16,0,Jul,14,0,Sat,0,201,232,433
2011-07-16,0,Jul,15,0,Sat,0,205,223,428
2011-07-16,0,Jul,16,0,Sat,0,183,242,425
2011-07-16,0,Jul,17,0,Sat,0,234,241,475
2011-07-16,0,Jul,18,0,Sat,0,185,243,428
2011-07-16,0,Jul,19,0,Sat,0,164,242,406
2011-07-16,0,Jul,20,0,Sat,0,108,188,296
2011-07-16,0,Jul,21,0,Sat,0,85,167,252
2011-07-16,0,Jul,22,0,Sat,0,65,136,201
2011-07-16,0,Jul,23,0,Sat,0,61,107,168
2011-07-17,0,Jul,0,0,Sun,0,34,91,125
2011-07-17,0,Jul,1,0,Sun,0,16,86,102
2011-07-17,0,Jul,2,0,Sun,0,28,66,94
2011-07-17,0,Jul,3,0,Sun,0,21,26,47
2011-07-17,0,Jul,4,0,Sun,0,4,6,10
2011-07-17,0,Jul,5,0,Sun,0,4,8,12
2011-07-17,0,Jul,6,0,Sun,0,10,11,21
2011-07-17,0,Jul,7,0,Sun,0,20,30,50
2011-07-17,0,Jul,8,0,Sun,0,45,73,118
2011-07-17,0,Jul,9,0,Sun,0,74,110,184
2011-07-17,0,Jul,10,0,Sun,0,127,177,304
2011-07-17,0,Jul,11,0,Sun,0,147,244,391
2011-07-17,0,Jul,12,0,Sun,0,177,243,420
2011-07-17,0,Jul,13,0,Sun,0,200,272,472
2011-07-17,0,Jul,14,0,Sun,0,168,262,430
2011-07-17,0,Jul,15,0,Sun,0,129,195,324
2011-07-17,0,Jul,16,0,Sun,0,129,188,317
2011-07-17,0,Jul,17,0,Sun,0,133,236,369
2011-07-17,0,Jul,18,0,Sun,0,147,243,390
2011-07-17,0,Jul,19,0,Sun,0,145,234,379
2011-07-17,0,Jul,20,0,Sun,0,85,177,262
2011-07-17,0,Jul,21,0,Sun,0,59,148,207
2011-07-17,0,Jul,22,0,Sun,0,65,116,181
2011-07-17,0,Jul,23,0,Sun,0,39,54,93
2011-07-18,0,Jul,0,0,Mon,1,21,30,51
2011-07-18,0,Jul,1,0,Mon,1,17,8,25
2011-07-18,0,Jul,2,0,Mon,1,2,8,10
2011-07-18,0,Jul,3,0,Mon,1,3,4,7
2011-07-18,0,Jul,4,0,Mon,1,1,3,4
2011-07-18,0,Jul,5,0,Mon,1,2,15,17
2011-07-18,0,Jul,6,0,Mon,1,10,95,105
2011-07-18,0,Jul,7,0,Mon,1,22,255,277
2011-07-18,0,Jul,8,0,Mon,1,18,329,347
2011-07-18,0,Jul,9,0,Mon,1,33,170,203
2011-07-18,0,Jul,10,0,Mon,1,52,78,130
2011-07-18,0,Jul,11,0,Mon,1,42,99,141
2011-07-18,0,Jul,12,0,Mon,1,39,126,165
2011-07-18,0,Jul,13,0,Mon,1,27,125,152
2011-07-18,0,Jul,14,0,Mon,1,32,106,138
2011-07-18,0,Jul,15,0,Mon,1,53,111,164
2011-07-18,0,Jul,16,0,Mon,1,45,220,265
2011-07-18,0,Jul,17,0,Mon,1,72,473,545
2011-07-18,0,Jul,18,0,Mon,1,80,478,558
2011-07-18,0,Jul,19,0,Mon,1,63,335,398
2011-07-18,0,Jul,20,0,Mon,1,91,232,323
2011-07-18,0,Jul,21,0,Mon,1,48,154,202
2011-07-18,0,Jul,22,0,Mon,1,36,104,140
2011-07-18,0,Jul,23,0,Mon,1,32,59,91
2011-07-19,0,Jul,0,0,Tue,1,25,26,51
2011-07-19,0,Jul,1,0,Tue,1,7,6,13
2011-07-19,0,Jul,2,0,Tue,1,9,4,13
2011-07-19,0,Jul,3,0,Tue,1,2,1,3
2011-07-19,0,Jul,4,0,Tue,1,1,4,5
2011-07-19,0,Jul,5,0,Tue,1,0,19,19
2011-07-19,0,Jul,6,0,Tue,1,8,126,134
2011-07-19,0,Jul,7,0,Tue,1,28,287,315
2011-07-19,0,Jul,8,0,Tue,1,31,381,412
2011-07-19,0,Jul,9,0,Tue,1,22,177,199
2011-07-19,0,Jul,10,0,Tue,1,29,112,141
2011-07-19,0,Jul,11,0,Tue,1,29,98,127
2011-07-19,0,Jul,12,0,Tue,1,26,127,153
2011-07-19,0,Jul,13,0,Tue,1,33,139,172
2011-07-19,0,Jul,14,0,Tue,1,41,111,152
2011-07-19,0,Jul,15,0,Tue,1,48,110,158
2011-07-19,0,Jul,16,0,Tue,1,61,216,277
2011-07-19,0,Jul,17,0,Tue,1,68,445,513
2011-07-19,0,Jul,18,0,Tue,1,80,450,530
2011-07-19,0,Jul,19,0,Tue,1,54,334,388
2011-07-19,0,Jul,20,0,Tue,1,48,229,277
2011-07-19,0,Jul,21,0,Tue,1,47,194,241
2011-07-19,0,Jul,22,0,Tue,1,36,120,156
2011-07-19,0,Jul,23,0,Tue,1,19,73,92
2011-07-20,0,Jul,0,0,Wed,1,11,29,40
2011-07-20,0,Jul,1,0,Wed,1,4,7,11
2011-07-20,0,Jul,2,0,Wed,1,2,7,9
2011-07-20,0,Jul,3,0,Wed,1,2,4,6
2011-07-20,0,Jul,4,0,Wed,1,0,4,4
2011-07-20,0,Jul,5,0,Wed,1,4,19,23
2011-07-20,0,Jul,6,0,Wed,1,5,111,116
2011-07-20,0,Jul,7,0,Wed,1,27,276,303
2011-07-20,0,Jul,8,0,Wed,1,34,404,438
2011-07-20,0,Jul,9,0,Wed,1,28,181,209
2011-07-20,0,Jul,10,0,Wed,1,34,76,110
2011-07-20,0,Jul,11,0,Wed,1,26,116,142
2011-07-20,0,Jul,12,0,Wed,1,28,121,149
2011-07-20,0,Jul,13,0,Wed,1,23,97,120
2011-07-20,0,Jul,14,0,Wed,1,44,83,127
2011-07-20,0,Jul,15,0,Wed,1,36,102,138
2011-07-20,0,Jul,16,0,Wed,1,30,204,234
2011-07-20,0,Jul,17,0,Wed,1,50,405,455
2011-07-20,0,Jul,18,0,Wed,1,68,429,497
2011-07-20,0,Jul,19,0,Wed,1,59,323,382
2011-07-20,0,Jul,20,0,Wed,1,45,264,309
2011-07-20,0,Jul,21,0,Wed,1,33,209,242
2011-07-20,0,Jul,22,0,Wed,1,25,144,169
2011-07-20,0,Jul,23,0,Wed,1,26,73,99
2011-07-21,0,Jul,0,0,Thur,1,13,29,42
2011-07-21,0,Jul,1,0,Thur,1,5,16,21
2011-07-21,0,Jul,2,0,Thur,1,2,4,6
2011-07-21,0,Jul,3,0,Thur,1,1,5,6
2011-07-21,0,Jul,4,0,Thur,1,0,4,4
2011-07-21,0,Jul,5,0,Thur,1,2,16,18
2011-07-21,0,Jul,6,0,Thur,1,6,111,117
2011-07-21,0,Jul,7,0,Thur,1,23,251,274
2011-07-21,0,Jul,8,0,Thur,1,23,358,381
2011-07-21,0,Jul,9,0,Thur,1,34,166,200
2011-07-21,0,Jul,10,0,Thur,1,31,47,78
2011-07-21,0,Jul,11,0,Thur,1,27,79,106
2011-07-21,0,Jul,12,0,Thur,1,29,106,135
2011-07-21,0,Jul,13,0,Thur,1,21,81,102
2011-07-21,0,Jul,14,0,Thur,1,50,97,147
2011-07-21,0,Jul,15,0,Thur,1,40,93,133
2011-07-21,0,Jul,16,0,Thur,1,43,167,210
2011-07-21,0,Jul,17,0,Thur,1,40,374,414
2011-07-21,0,Jul,18,0,Thur,1,39,343,382
2011-07-21,0,Jul,19,0,Thur,1,51,233,284
2011-07-21,0,Jul,20,0,Thur,1,38,199,237
2011-07-21,0,Jul,21,0,Thur,1,38,187,225
2011-07-21,0,Jul,22,0,Thur,1,36,113,149
2011-07-21,0,Jul,23,0,Thur,1,40,73,113
2011-07-22,0,Jul,0,0,Fri,1,9,51,60
2011-07-22,0,Jul,1,0,Fri,1,7,17,24
2011-07-22,0,Jul,2,0,Fri,1,0,14,14
2011-07-22,0,Jul,3,0,Fri,1,1,6,7
2011-07-22,0,Jul,4,0,Fri,1,8,5,13
2011-07-22,0,Jul,5,0,Fri,1,2,17,19
2011-07-22,0,Jul,6,0,Fri,1,13,83,96
2011-07-22,0,Jul,7,0,Fri,1,20,232,252
2011-07-22,0,Jul,8,0,Fri,1,30,292,322
2011-07-22,0,Jul,9,0,Fri,1,31,177,208
2011-07-22,0,Jul,10,0,Fri,1,32,83,115
2011-07-22,0,Jul,11,0,Fri,1,23,86,109
2011-07-22,0,Jul,12,0,Fri,1,20,95,115
2011-07-22,0,Jul,13,0,Fri,1,25,98,123
2011-07-22,0,Jul,14,0,Fri,1,24,77,101
2011-07-22,0,Jul,15,0,Fri,1,32,101,133
2011-07-22,0,Jul,16,0,Fri,1,29,153,182
2011-07-22,0,Jul,17,0,Fri,1,35,271,306
2011-07-22,0,Jul,18,0,Fri,1,34,250,284
2011-07-22,0,Jul,19,0,Fri,1,40,210,250
2011-07-22,0,Jul,20,0,Fri,1,46,166,212
2011-07-22,0,Jul,21,0,Fri,1,38,152,190
2011-07-22,0,Jul,22,0,Fri,1,44,105,149
2011-07-22,0,Jul,23,0,Fri,1,19,84,103
2011-07-23,0,Jul,0,0,Sat,0,16,85,101
2011-07-23,0,Jul,1,0,Sat,0,13,57,70
2011-07-23,0,Jul,2,0,Sat,0,13,48,61
2011-07-23,0,Jul,3,0,Sat,0,6,16,22
2011-07-23,0,Jul,4,0,Sat,0,5,4,9
2011-07-23,0,Jul,5,0,Sat,0,1,6,7
2011-07-23,0,Jul,6,0,Sat,0,6,19,25
2011-07-23,0,Jul,7,0,Sat,0,7,38,45
2011-07-23,0,Jul,8,0,Sat,0,24,85,109
2011-07-23,0,Jul,9,0,Sat,0,30,102,132
2011-07-23,0,Jul,10,0,Sat,0,61,137,198
2011-07-23,0,Jul,11,0,Sat,0,62,154,216
2011-07-23,0,Jul,12,0,Sat,0,71,164,235
2011-07-23,0,Jul,13,0,Sat,0,78,167,245
2011-07-23,0,Jul,14,0,Sat,0,84,152,236
2011-07-23,0,Jul,15,0,Sat,0,78,137,215
2011-07-23,0,Jul,16,0,Sat,0,70,151,221
2011-07-23,0,Jul,17,0,Sat,0,70,127,197
2011-07-23,0,Jul,18,0,Sat,0,62,134,196
2011-07-23,0,Jul,19,0,Sat,0,80,137,217
2011-07-23,0,Jul,20,0,Sat,0,47,98,145
2011-07-23,0,Jul,21,0,Sat,0,39,115,154
2011-07-23,0,Jul,22,0,Sat,0,37,88,125
2011-07-23,0,Jul,23,0,Sat,0,27,77,104
2011-07-24,0,Jul,0,0,Sun,0,42,77,119
2011-07-24,0,Jul,1,0,Sun,0,33,63,96
2011-07-24,0,Jul,2,0,Sun,0,12,48,60
2011-07-24,0,Jul,3,0,Sun,0,17,20,37
2011-07-24,0,Jul,4,0,Sun,0,1,5,6
2011-07-24,0,Jul,5,0,Sun,0,5,3,8
2011-07-24,0,Jul,6,0,Sun,0,9,13,22
2011-07-24,0,Jul,7,0,Sun,0,6,29,35
2011-07-24,0,Jul,8,0,Sun,0,22,82,104
2011-07-24,0,Jul,9,0,Sun,0,42,112,154
2011-07-24,0,Jul,10,0,Sun,0,61,165,226
2011-07-24,0,Jul,11,0,Sun,0,74,169,243
2011-07-24,0,Jul,12,0,Sun,0,85,161,246
2011-07-24,0,Jul,13,0,Sun,0,90,162,252
2011-07-24,0,Jul,14,0,Sun,0,79,204,283
2011-07-24,0,Jul,15,0,Sun,0,68,170,238
2011-07-24,0,Jul,16,0,Sun,0,62,187,249
2011-07-24,0,Jul,17,0,Sun,0,75,174,249
2011-07-24,0,Jul,18,0,Sun,0,67,176,243
2011-07-24,0,Jul,19,0,Sun,0,70,170,240
2011-07-24,0,Jul,20,0,Sun,0,52,143,195
2011-07-24,0,Jul,21,0,Sun,0,42,111,153
2011-07-24,0,Jul,22,0,Sun,0,23,75,98
2011-07-24,0,Jul,23,0,Sun,0,13,37,50
2011-07-25,0,Jul,0,0,Mon,1,17,17,34
2011-07-25,0,Jul,1,0,Mon,1,4,8,12
2011-07-25,0,Jul,2,0,Mon,1,3,3,6
2011-07-25,0,Jul,3,0,Mon,1,2,2,4
2011-07-25,0,Jul,4,0,Mon,1,0,6,6
2011-07-25,0,Jul,5,0,Mon,1,2,22,24
2011-07-25,0,Jul,6,0,Mon,1,7,100,107
2011-07-25,0,Jul,7,0,Mon,1,20,257,277
2011-07-25,0,Jul,8,0,Mon,1,34,353,387
2011-07-25,0,Jul,9,0,Mon,1,11,124,135
2011-07-25,0,Jul,10,0,Mon,1,30,54,84
2011-07-25,0,Jul,11,0,Mon,1,24,83,107
2011-07-25,0,Jul,12,0,Mon,1,17,50,67
2011-07-25,0,Jul,13,0,Mon,1,14,64,78
2011-07-25,0,Jul,14,0,Mon,1,28,62,90
2011-07-25,0,Jul,15,0,Mon,1,16,96,112
2011-07-25,0,Jul,16,0,Mon,1,37,161,198
2011-07-25,0,Jul,17,0,Mon,1,48,437,485
2011-07-25,0,Jul,18,0,Mon,1,60,473,533
2011-07-25,0,Jul,19,0,Mon,1,62,324,386
2011-07-25,0,Jul,20,0,Mon,1,55,247,302
2011-07-25,0,Jul,21,0,Mon,1,41,153,194
2011-07-25,0,Jul,22,0,Mon,1,13,112,125
2011-07-25,0,Jul,23,0,Mon,1,23,64,87
2011-07-26,0,Jul,0,0,Tue,1,8,20,28
2011-07-26,0,Jul,1,0,Tue,1,6,6,12
2011-07-26,0,Jul,2,0,Tue,1,1,6,7
2011-07-26,0,Jul,3,0,Tue,1,2,2,4
2011-07-26,0,Jul,4,0,Tue,1,0,6,6
2011-07-26,0,Jul,5,0,Tue,1,3,24,27
2011-07-26,0,Jul,6,0,Tue,1,2,108,110
2011-07-26,0,Jul,7,0,Tue,1,30,288,318
2011-07-26,0,Jul,8,0,Tue,1,32,392,424
2011-07-26,0,Jul,9,0,Tue,1,25,162,187
2011-07-26,0,Jul,10,0,Tue,1,42,96,138
2011-07-26,0,Jul,11,0,Tue,1,49,102,151
2011-07-26,0,Jul,12,0,Tue,1,25,122,147
2011-07-26,0,Jul,13,0,Tue,1,43,139,182
2011-07-26,0,Jul,14,0,Tue,1,46,101,147
2011-07-26,0,Jul,15,0,Tue,1,49,114,163
2011-07-26,0,Jul,16,0,Tue,1,41,213,254
2011-07-26,0,Jul,17,0,Tue,1,72,465,537
2011-07-26,0,Jul,18,0,Tue,1,68,478,546
2011-07-26,0,Jul,19,0,Tue,1,69,329,398
2011-07-26,0,Jul,20,0,Tue,1,47,243,290
2011-07-26,0,Jul,21,0,Tue,1,45,222,267
2011-07-26,0,Jul,22,0,Tue,1,27,131,158
2011-07-26,0,Jul,23,0,Tue,1,18,71,89
2011-07-27,0,Jul,0,0,Wed,1,19,26,45
2011-07-27,0,Jul,1,0,Wed,1,1,9,10
2011-07-27,0,Jul,2,0,Wed,1,1,5,6
2011-07-27,0,Jul,3,0,Wed,1,0,4,4
2011-07-27,0,Jul,4,0,Wed,1,1,3,4
2011-07-27,0,Jul,5,0,Wed,1,0,18,18
2011-07-27,0,Jul,6,0,Wed,1,4,119,123
2011-07-27,0,Jul,7,0,Wed,1,34,313,347
2011-07-27,0,Jul,8,0,Wed,1,28,405,433
2011-07-27,0,Jul,9,0,Wed,1,27,189,216
2011-07-27,0,Jul,10,0,Wed,1,32,82,114
2011-07-27,0,Jul,11,0,Wed,1,42,94,136
2011-07-27,0,Jul,12,0,Wed,1,37,132,169
2011-07-27,0,Jul,13,0,Wed,1,29,151,180
2011-07-27,0,Jul,14,0,Wed,1,20,107,127
2011-07-27,0,Jul,15,0,Wed,1,37,103,140
2011-07-27,0,Jul,16,0,Wed,1,40,228,268
2011-07-27,0,Jul,17,0,Wed,1,81,491,572
2011-07-27,0,Jul,18,0,Wed,1,78,463,541
2011-07-27,0,Jul,19,0,Wed,1,87,288,375
2011-07-27,0,Jul,20,0,Wed,1,55,239,294
2011-07-27,0,Jul,21,0,Wed,1,49,196,245
2011-07-27,0,Jul,22,0,Wed,1,37,143,180
2011-07-27,0,Jul,23,0,Wed,1,16,93,109
2011-07-28,0,Jul,0,0,Thur,1,14,31,45
2011-07-28,0,Jul,1,0,Thur,1,3,26,29
2011-07-28,0,Jul,2,0,Thur,1,2,5,7
2011-07-28,0,Jul,3,0,Thur,1,0,5,5
2011-07-28,0,Jul,4,0,Thur,1,0,6,6
2011-07-28,0,Jul,5,0,Thur,1,1,26,27
2011-07-28,0,Jul,6,0,Thur,1,6,110,116
2011-07-28,0,Jul,7,0,Thur,1,27,278,305
2011-07-28,0,Jul,8,0,Thur,1,47,409,456
2011-07-28,0,Jul,9,0,Thur,1,21,189,210
2011-07-28,0,Jul,10,0,Thur,1,30,86,116
2011-07-28,0,Jul,11,0,Thur,1,41,113,154
2011-07-28,0,Jul,12,0,Thur,1,35,151,186
2011-07-28,0,Jul,13,0,Thur,1,26,126,152
2011-07-28,0,Jul,14,0,Thur,1,27,111,138
2011-07-28,0,Jul,15,0,Thur,1,22,124,146
2011-07-28,0,Jul,16,0,Thur,1,42,214,256
2011-07-28,0,Jul,17,0,Thur,1,45,423,468
2011-07-28,0,Jul,18,0,Thur,1,55,428,483
2011-07-28,0,Jul,19,0,Thur,1,37,285,322
2011-07-28,0,Jul,20,0,Thur,1,41,229,270
2011-07-28,0,Jul,21,0,Thur,1,31,165,196
2011-07-28,0,Jul,22,0,Thur,1,25,149,174
2011-07-28,0,Jul,23,0,Thur,1,28,95,123
2011-07-29,0,Jul,0,0,Fri,1,12,45,57
2011-07-29,0,Jul,1,0,Fri,1,12,22,34
2011-07-29,0,Jul,2,0,Fri,1,3,10,13
2011-07-29,0,Jul,3,0,Fri,1,2,9,11
2011-07-29,0,Jul,4,0,Fri,1,2,4,6
2011-07-29,0,Jul,5,0,Fri,1,4,23,27
2011-07-29,0,Jul,6,0,Fri,1,7,83,90
2011-07-29,0,Jul,7,0,Fri,1,26,228,254
2011-07-29,0,Jul,8,0,Fri,1,30,354,384
2011-07-29,0,Jul,9,0,Fri,1,28,151,179
2011-07-29,0,Jul,10,0,Fri,1,37,69,106
2011-07-29,0,Jul,11,0,Fri,1,43,118,161
2011-07-29,0,Jul,12,0,Fri,1,40,95,135
2011-07-29,0,Jul,13,0,Fri,1,42,114,156
2011-07-29,0,Jul,14,0,Fri,1,34,114,148
2011-07-29,0,Jul,15,0,Fri,1,40,129,169
2011-07-29,0,Jul,16,0,Fri,1,35,198,233
2011-07-29,0,Jul,17,0,Fri,1,47,374,421
2011-07-29,0,Jul,18,0,Fri,1,49,313,362
2011-07-29,0,Jul,19,0,Fri,1,22,219,241
2011-07-29,0,Jul,20,0,Fri,1,53,153,206
2011-07-29,0,Jul,21,0,Fri,1,29,134,163
2011-07-29,0,Jul,22,0,Fri,1,47,127,174
2011-07-29,0,Jul,23,0,Fri,1,26,90,116
2011-07-30,0,Jul,0,0,Sat,0,60,73,133
2011-07-30,0,Jul,1,0,Sat,0,15,75,90
2011-07-30,0,Jul,2,0,Sat,0,11,31,42
2011-07-30,0,Jul,3,0,Sat,0,18,25,43
2011-07-30,0,Jul,4,0,Sat,0,4,6,10
2011-07-30,0,Jul,5,0,Sat,0,4,9,13
2011-07-30,0,Jul,6,0,Sat,0,6,18,24
2011-07-30,0,Jul,7,0,Sat,0,3,39,42
2011-07-30,0,Jul,8,0,Sat,0,27,87,114
2011-07-30,0,Jul,9,0,Sat,0,49,125,174
2011-07-30,0,Jul,10,0,Sat,0,79,182,261
2011-07-30,0,Jul,11,0,Sat,0,111,206,317
2011-07-30,0,Jul,12,0,Sat,0,111,230,341
2011-07-30,0,Jul,13,0,Sat,0,125,183,308
2011-07-30,0,Jul,14,0,Sat,0,112,193,305
2011-07-30,0,Jul,15,0,Sat,0,113,189,302
2011-07-30,0,Jul,16,0,Sat,0,126,176,302
2011-07-30,0,Jul,17,0,Sat,0,93,209,302
2011-07-30,0,Jul,18,0,Sat,0,92,207,299
2011-07-30,0,Jul,19,0,Sat,0,101,155,256
2011-07-30,0,Jul,20,0,Sat,0,74,132,206
2011-07-30,0,Jul,21,0,Sat,0,82,123,205
2011-07-30,0,Jul,22,0,Sat,0,80,129,209
2011-07-30,0,Jul,23,0,Sat,0,63,114,177
2011-07-31,0,Jul,0,0,Sun,0,33,80,113
2011-07-31,0,Jul,1,0,Sun,0,8,71,79
2011-07-31,0,Jul,2,0,Sun,0,19,48,67
2011-07-31,0,Jul,3,0,Sun,0,24,26,50
2011-07-31,0,Jul,4,0,Sun,0,6,7,13
2011-07-31,0,Jul,5,0,Sun,0,4,4,8
2011-07-31,0,Jul,6,0,Sun,0,5,8,13
2011-07-31,0,Jul,7,0,Sun,0,19,26,45
2011-07-31,0,Jul,8,0,Sun,0,54,88,142
2011-07-31,0,Jul,9,0,Sun,0,55,128,183
2011-07-31,0,Jul,10,0,Sun,0,91,163,254
2011-07-31,0,Jul,11,0,Sun,0,112,163,275
2011-07-31,0,Jul,12,0,Sun,0,146,192,338
2011-07-31,0,Jul,13,0,Sun,0,142,152,294
2011-07-31,0,Jul,14,0,Sun,0,130,196,326
2011-07-31,0,Jul,15,0,Sun,0,109,184,293
2011-07-31,0,Jul,16,0,Sun,0,98,208,306
2011-07-31,0,Jul,17,0,Sun,0,114,206,320
2011-07-31,0,Jul,18,0,Sun,0,91,213,304
2011-07-31,0,Jul,19,0,Sun,0,87,187,274
2011-07-31,0,Jul,20,0,Sun,0,70,205,275
2011-07-31,0,Jul,21,0,Sun,0,68,96,164
2011-07-31,0,Jul,22,0,Sun,0,25,71,96
2011-07-31,0,Jul,23,0,Sun,0,14,56,70
2011-08-01,0,Aug,0,0,Mon,1,7,22,29
2011-08-01,0,Aug,1,0,Mon,1,5,12,17
2011-08-01,0,Aug,2,0,Mon,1,4,7,11
2011-08-01,0,Aug,3,0,Mon,1,0,4,4
2011-08-01,0,Aug,4,0,Mon,1,2,2,4
2011-08-01,0,Aug,5,0,Mon,1,2,24,26
2011-08-01,0,Aug,6,0,Mon,1,3,97,100
2011-08-01,0,Aug,7,0,Mon,1,24,258,282
2011-08-01,0,Aug,8,0,Mon,1,35,347,382
2011-08-01,0,Aug,9,0,Mon,1,27,139,166
2011-08-01,0,Aug,10,0,Mon,1,27,70,97
2011-08-01,0,Aug,11,0,Mon,1,53,66,119
2011-08-01,0,Aug,12,0,Mon,1,53,115,168
2011-08-01,0,Aug,13,0,Mon,1,38,112,150
2011-08-01,0,Aug,14,0,Mon,1,37,86,123
2011-08-01,0,Aug,15,0,Mon,1,52,77,129
2011-08-01,0,Aug,16,0,Mon,1,34,197,231
2011-08-01,0,Aug,17,0,Mon,1,69,445,514
2011-08-01,0,Aug,18,0,Mon,1,68,475,543
2011-08-01,0,Aug,19,0,Mon,1,63,350,413
2011-08-01,0,Aug,20,0,Mon,1,49,256,305
2011-08-01,0,Aug,21,0,Mon,1,42,178,220
2011-08-01,0,Aug,22,0,Mon,1,21,116,137
2011-08-01,0,Aug,23,0,Mon,1,14,82,96
2011-08-02,0,Aug,0,0,Tue,1,11,18,29
2011-08-02,0,Aug,1,0,Tue,1,4,8,12
2011-08-02,0,Aug,2,0,Tue,1,2,6,8
2011-08-02,0,Aug,3,0,Tue,1,0,5,5
2011-08-02,0,Aug,4,0,Tue,1,0,10,10
2011-08-02,0,Aug,5,0,Tue,1,4,17,21
2011-08-02,0,Aug,6,0,Tue,1,12,105,117
2011-08-02,0,Aug,7,0,Tue,1,15,320,335
2011-08-02,0,Aug,8,0,Tue,1,37,398,435
2011-08-02,0,Aug,9,0,Tue,1,31,182,213
2011-08-02,0,Aug,10,0,Tue,1,50,90,140
2011-08-02,0,Aug,11,0,Tue,1,32,96,128
2011-08-02,0,Aug,12,0,Tue,1,45,112,157
2011-08-02,0,Aug,13,0,Tue,1,50,153,203
2011-08-02,0,Aug,14,0,Tue,1,45,114,159
2011-08-02,0,Aug,15,0,Tue,1,48,120,168
2011-08-02,0,Aug,16,0,Tue,1,58,216,274
2011-08-02,0,Aug,17,0,Tue,1,63,493,556
2011-08-02,0,Aug,18,0,Tue,1,65,491,556
2011-08-02,0,Aug,19,0,Tue,1,85,369,454
2011-08-02,0,Aug,20,0,Tue,1,40,248,288
2011-08-02,0,Aug,21,0,Tue,1,53,201,254
2011-08-02,0,Aug,22,0,Tue,1,22,169,191
2011-08-02,0,Aug,23,0,Tue,1,29,103,132
2011-08-03,0,Aug,0,0,Wed,1,11,32,43
2011-08-03,0,Aug,1,0,Wed,1,7,9,16
2011-08-03,0,Aug,2,0,Wed,1,2,9,11
2011-08-03,0,Aug,3,0,Wed,1,0,4,4
2011-08-03,0,Aug,4,0,Wed,1,0,7,7
2011-08-03,0,Aug,5,0,Wed,1,2,22,24
2011-08-03,0,Aug,6,0,Wed,1,9,101,110
2011-08-03,0,Aug,7,0,Wed,1,19,252,271
2011-08-03,0,Aug,8,0,Wed,1,29,408,437
2011-08-03,0,Aug,9,0,Wed,1,23,172,195
2011-08-03,0,Aug,10,0,Wed,1,9,59,68
2011-08-03,0,Aug,11,0,Wed,1,29,93,122
2011-08-03,0,Aug,12,0,Wed,1,19,142,161
2011-08-03,0,Aug,13,0,Wed,1,37,107,144
2011-08-03,0,Aug,14,0,Wed,1,43,104,147
2011-08-03,0,Aug,15,0,Wed,1,31,87,118
2011-08-03,0,Aug,16,0,Wed,1,21,129,150
2011-08-03,0,Aug,17,0,Wed,1,47,378,425
2011-08-03,0,Aug,18,0,Wed,1,49,443,492
2011-08-03,0,Aug,19,0,Wed,1,51,270,321
2011-08-03,0,Aug,20,0,Wed,1,7,80,87
2011-08-03,0,Aug,21,0,Wed,1,7,81,88
2011-08-03,0,Aug,22,0,Wed,1,11,66,77
2011-08-03,0,Aug,23,0,Wed,1,4,52,56
2011-08-04,0,Aug,0,0,Thur,1,2,15,17
2011-08-04,0,Aug,1,0,Thur,1,3,14,17
2011-08-04,0,Aug,2,0,Thur,1,2,5,7
2011-08-04,0,Aug,3,0,Thur,1,0,3,3
2011-08-04,0,Aug,4,0,Thur,1,0,7,7
2011-08-04,0,Aug,5,0,Thur,1,3,17,20
2011-08-04,0,Aug,6,0,Thur,1,7,90,97
2011-08-04,0,Aug,7,0,Thur,1,11,271,282
2011-08-04,0,Aug,8,0,Thur,1,29,369,398
2011-08-04,0,Aug,9,0,Thur,1,25,162,187
2011-08-04,0,Aug,10,0,Thur,1,24,89,113
2011-08-04,0,Aug,11,0,Thur,1,37,112,149
2011-08-04,0,Aug,12,0,Thur,1,53,152,205
2011-08-04,0,Aug,13,0,Thur,1,63,142,205
2011-08-04,0,Aug,14,0,Thur,1,53,114,167
2011-08-04,0,Aug,15,0,Thur,1,50,115,165
2011-08-04,0,Aug,16,0,Thur,1,70,220,290
2011-08-04,0,Aug,17,0,Thur,1,91,464,555
2011-08-04,0,Aug,18,0,Thur,1,88,435,523
2011-08-04,0,Aug,19,0,Thur,1,65,301,366
2011-08-04,0,Aug,20,0,Thur,1,41,245,286
2011-08-04,0,Aug,21,0,Thur,1,25,186,211
2011-08-04,0,Aug,22,0,Thur,1,33,141,174
2011-08-04,0,Aug,23,0,Thur,1,24,108,132
2011-08-05,0,Aug,0,0,Fri,1,13,41,54
2011-08-05,0,Aug,1,0,Fri,1,3,16,19
2011-08-05,0,Aug,2,0,Fri,1,5,14,19
2011-08-05,0,Aug,3,0,Fri,1,0,6,6
2011-08-05,0,Aug,4,0,Fri,1,1,6,7
2011-08-05,0,Aug,5,0,Fri,1,0,16,16
2011-08-05,0,Aug,6,0,Fri,1,7,94,101
2011-08-05,0,Aug,7,0,Fri,1,23,247,270
2011-08-05,0,Aug,8,0,Fri,1,39,415,454
2011-08-05,0,Aug,9,0,Fri,1,43,183,226
2011-08-05,0,Aug,10,0,Fri,1,50,113,163
2011-08-05,0,Aug,11,0,Fri,1,44,103,147
2011-08-05,0,Aug,12,0,Fri,1,57,159,216
2011-08-05,0,Aug,13,0,Fri,1,40,164,204
2011-08-05,0,Aug,14,0,Fri,1,81,164,245
2011-08-05,0,Aug,15,0,Fri,1,50,160,210
2011-08-05,0,Aug,16,0,Fri,1,76,254,330
2011-08-05,0,Aug,17,0,Fri,1,84,466,550
2011-08-05,0,Aug,18,0,Fri,1,105,361,466
2011-08-05,0,Aug,19,0,Fri,1,90,282,372
2011-08-05,0,Aug,20,0,Fri,1,70,221,291
2011-08-05,0,Aug,21,0,Fri,1,54,119,173
2011-08-05,0,Aug,22,0,Fri,1,51,137,188
2011-08-05,0,Aug,23,0,Fri,1,37,102,139
2011-08-06,0,Aug,0,0,Sat,0,29,104,133
2011-08-06,0,Aug,1,0,Sat,0,17,50,67
2011-08-06,0,Aug,2,0,Sat,0,14,39,53
2011-08-06,0,Aug,3,0,Sat,0,14,28,42
2011-08-06,0,Aug,4,0,Sat,0,5,5,10
2011-08-06,0,Aug,5,0,Sat,0,2,4,6
2011-08-06,0,Aug,6,0,Sat,0,5,22,27
2011-08-06,0,Aug,7,0,Sat,0,14,49,63
2011-08-06,0,Aug,8,0,Sat,0,27,94,121
2011-08-06,0,Aug,9,0,Sat,0,60,155,215
2011-08-06,0,Aug,10,0,Sat,0,91,199,290
2011-08-06,0,Aug,11,0,Sat,0,138,211,349
2011-08-06,0,Aug,12,0,Sat,0,130,252,382
2011-08-06,0,Aug,13,0,Sat,0,176,265,441
2011-08-06,0,Aug,14,0,Sat,0,176,204,380
2011-08-06,0,Aug,15,0,Sat,0,130,232,362
2011-08-06,0,Aug,16,0,Sat,0,155,188,343
2011-08-06,0,Aug,17,0,Sat,0,61,88,149
2011-08-06,0,Aug,18,0,Sat,0,81,130,211
2011-08-06,0,Aug,19,0,Sat,0,57,114,171
2011-08-06,0,Aug,20,0,Sat,0,58,79,137
2011-08-06,0,Aug,21,0,Sat,0,28,86,114
2011-08-06,0,Aug,22,0,Sat,0,24,96,120
2011-08-06,0,Aug,23,0,Sat,0,29,79,108
2011-08-07,0,Aug,0,0,Sun,0,14,66,80
2011-08-07,0,Aug,1,0,Sun,0,10,63,73
2011-08-07,0,Aug,2,0,Sun,0,18,48,66
2011-08-07,0,Aug,3,0,Sun,0,9,23,32
2011-08-07,0,Aug,4,0,Sun,0,1,5,6
2011-08-07,0,Aug,5,0,Sun,0,1,4,5
2011-08-07,0,Aug,6,0,Sun,0,3,10,13
2011-08-07,0,Aug,7,0,Sun,0,11,28,39
2011-08-07,0,Aug,8,0,Sun,0,23,66,89
2011-08-07,0,Aug,9,0,Sun,0,82,102,184
2011-08-07,0,Aug,10,0,Sun,0,88,178,266
2011-08-07,0,Aug,11,0,Sun,0,113,156,269
2011-08-07,0,Aug,12,0,Sun,0,161,209,370
2011-08-07,0,Aug,13,0,Sun,0,118,206,324
2011-08-07,0,Aug,14,0,Sun,0,130,192,322
2011-08-07,0,Aug,15,0,Sun,0,118,208,326
2011-08-07,0,Aug,16,0,Sun,0,74,119,193
2011-08-07,0,Aug,17,0,Sun,0,63,131,194
2011-08-07,0,Aug,18,0,Sun,0,74,155,229
2011-08-07,0,Aug,19,0,Sun,0,68,160,228
2011-08-07,0,Aug,20,0,Sun,0,50,133,183
2011-08-07,0,Aug,21,0,Sun,0,36,100,136
2011-08-07,0,Aug,22,0,Sun,0,21,82,103
2011-08-07,0,Aug,23,0,Sun,0,12,43,55
2011-08-08,0,Aug,0,0,Mon,1,13,17,30
2011-08-08,0,Aug,1,0,Mon,1,4,8,12
2011-08-08,0,Aug,2,0,Mon,1,4,3,7
2011-08-08,0,Aug,3,0,Mon,1,1,0,1
2011-08-08,0,Aug,4,0,Mon,1,2,8,10
2011-08-08,0,Aug,5,0,Mon,1,1,14,15
2011-08-08,0,Aug,6,0,Mon,1,8,87,95
2011-08-08,0,Aug,7,0,Mon,1,18,249,267
2011-08-08,0,Aug,8,0,Mon,1,29,320,349
2011-08-08,0,Aug,9,0,Mon,1,37,146,183
2011-08-08,0,Aug,10,0,Mon,1,62,62,124
2011-08-08,0,Aug,11,0,Mon,1,90,89,179
2011-08-08,0,Aug,12,0,Mon,1,48,134,182
2011-08-08,0,Aug,13,0,Mon,1,43,108,151
2011-08-08,0,Aug,14,0,Mon,1,41,109,150
2011-08-08,0,Aug,15,0,Mon,1,40,86,126
2011-08-08,0,Aug,16,0,Mon,1,64,218,282
2011-08-08,0,Aug,17,0,Mon,1,67,460,527
2011-08-08,0,Aug,18,0,Mon,1,64,465,529
2011-08-08,0,Aug,19,0,Mon,1,64,352,416
2011-08-08,0,Aug,20,0,Mon,1,71,215,286
2011-08-08,0,Aug,21,0,Mon,1,30,156,186
2011-08-08,0,Aug,22,0,Mon,1,26,121,147
2011-08-08,0,Aug,23,0,Mon,1,19,53,72
2011-08-09,0,Aug,0,0,Tue,1,10,25,35
2011-08-09,0,Aug,1,0,Tue,1,5,9,14
2011-08-09,0,Aug,2,0,Tue,1,9,3,12
2011-08-09,0,Aug,3,0,Tue,1,0,3,3
2011-08-09,0,Aug,4,0,Tue,1,1,6,7
2011-08-09,0,Aug,5,0,Tue,1,5,25,30
2011-08-09,0,Aug,6,0,Tue,1,6,95,101
2011-08-09,0,Aug,7,0,Tue,1,30,313,343
2011-08-09,0,Aug,8,0,Tue,1,40,352,392
2011-08-09,0,Aug,9,0,Tue,1,34,141,175
2011-08-09,0,Aug,10,0,Tue,1,55,89,144
2011-08-09,0,Aug,11,0,Tue,1,61,88,149
2011-08-09,0,Aug,12,0,Tue,1,60,125,185
2011-08-09,0,Aug,13,0,Tue,1,48,127,175
2011-08-09,0,Aug,14,0,Tue,1,53,95,148
2011-08-09,0,Aug,15,0,Tue,1,58,106,164
2011-08-09,0,Aug,16,0,Tue,1,57,228,285
2011-08-09,0,Aug,17,0,Tue,1,79,453,532
2011-08-09,0,Aug,18,0,Tue,1,97,488,585
2011-08-09,0,Aug,19,0,Tue,1,69,302,371
2011-08-09,0,Aug,20,0,Tue,1,34,258,292
2011-08-09,0,Aug,21,0,Tue,1,46,184,230
2011-08-09,0,Aug,22,0,Tue,1,28,127,155
2011-08-09,0,Aug,23,0,Tue,1,22,53,75
2011-08-10,0,Aug,0,0,Wed,1,19,18,37
2011-08-10,0,Aug,1,0,Wed,1,7,10,17
2011-08-10,0,Aug,2,0,Wed,1,1,10,11
2011-08-10,0,Aug,3,0,Wed,1,1,3,4
2011-08-10,0,Aug,4,0,Wed,1,1,4,5
2011-08-10,0,Aug,5,0,Wed,1,2,30,32
2011-08-10,0,Aug,6,0,Wed,1,9,110,119
2011-08-10,0,Aug,7,0,Wed,1,16,289,305
2011-08-10,0,Aug,8,0,Wed,1,38,361,399
2011-08-10,0,Aug,9,0,Wed,1,32,148,180
2011-08-10,0,Aug,10,0,Wed,1,41,72,113
2011-08-10,0,Aug,11,0,Wed,1,54,95,149
2011-08-10,0,Aug,12,0,Wed,1,74,166,240
2011-08-10,0,Aug,13,0,Wed,1,41,150,191
2011-08-10,0,Aug,14,0,Wed,1,62,116,178
2011-08-10,0,Aug,15,0,Wed,1,53,141,194
2011-08-10,0,Aug,16,0,Wed,1,76,206,282
2011-08-10,0,Aug,17,0,Wed,1,71,513,584
2011-08-10,0,Aug,18,0,Wed,1,70,489,559
2011-08-10,0,Aug,19,0,Wed,1,79,334,413
2011-08-10,0,Aug,20,0,Wed,1,59,253,312
2011-08-10,0,Aug,21,0,Wed,1,47,162,209
2011-08-10,0,Aug,22,0,Wed,1,17,122,139
2011-08-10,0,Aug,23,0,Wed,1,14,94,108
2011-08-11,0,Aug,0,0,Thur,1,6,40,46
2011-08-11,0,Aug,1,0,Thur,1,9,17,26
2011-08-11,0,Aug,2,0,Thur,1,3,8,11
2011-08-11,0,Aug,3,0,Thur,1,2,7,9
2011-08-11,0,Aug,4,0,Thur,1,1,4,5
2011-08-11,0,Aug,5,0,Thur,1,2,23,25
2011-08-11,0,Aug,6,0,Thur,1,5,101,106
2011-08-11,0,Aug,7,0,Thur,1,15,292,307
2011-08-11,0,Aug,8,0,Thur,1,29,361,390
2011-08-11,0,Aug,9,0,Thur,1,31,166,197
2011-08-11,0,Aug,10,0,Thur,1,36,96,132
2011-08-11,0,Aug,11,0,Thur,1,59,128,187
2011-08-11,0,Aug,12,0,Thur,1,50,164,214
2011-08-11,0,Aug,13,0,Thur,1,51,166,217
2011-08-11,0,Aug,14,0,Thur,1,39,103,142
2011-08-11,0,Aug,15,0,Thur,1,52,126,178
2011-08-11,0,Aug,16,0,Thur,1,57,241,298
2011-08-11,0,Aug,17,0,Thur,1,96,486,582
2011-08-11,0,Aug,18,0,Thur,1,74,497,571
2011-08-11,0,Aug,19,0,Thur,1,48,323,371
2011-08-11,0,Aug,20,0,Thur,1,56,232,288
2011-08-11,0,Aug,21,0,Thur,1,35,171,206
2011-08-11,0,Aug,22,0,Thur,1,34,123,157
2011-08-11,0,Aug,23,0,Thur,1,22,105,127
2011-08-12,0,Aug,0,0,Fri,1,12,53,65
2011-08-12,0,Aug,1,0,Fri,1,4,19,23
2011-08-12,0,Aug,2,0,Fri,1,0,15,15
2011-08-12,0,Aug,3,0,Fri,1,0,9,9
2011-08-12,0,Aug,4,0,Fri,1,0,5,5
2011-08-12,0,Aug,5,0,Fri,1,2,24,26
2011-08-12,0,Aug,6,0,Fri,1,3,73,76
2011-08-12,0,Aug,7,0,Fri,1,17,247,264
2011-08-12,0,Aug,8,0,Fri,1,29,397,426
2011-08-12,0,Aug,9,0,Fri,1,27,178,205
2011-08-12,0,Aug,10,0,Fri,1,44,86,130
2011-08-12,0,Aug,11,0,Fri,1,48,108,156
2011-08-12,0,Aug,12,0,Fri,1,55,167,222
2011-08-12,0,Aug,13,0,Fri,1,74,179,253
2011-08-12,0,Aug,14,0,Fri,1,51,135,186
2011-08-12,0,Aug,15,0,Fri,1,59,190,249
2011-08-12,0,Aug,16,0,Fri,1,68,266,334
2011-08-12,0,Aug,17,0,Fri,1,93,423,516
2011-08-12,0,Aug,18,0,Fri,1,89,376,465
2011-08-12,0,Aug,19,0,Fri,1,101,284,385
2011-08-12,0,Aug,20,0,Fri,1,77,210,287
2011-08-12,0,Aug,21,0,Fri,1,73,153,226
2011-08-12,0,Aug,22,0,Fri,1,74,157,231
2011-08-12,0,Aug,23,0,Fri,1,51,100,151
2011-08-13,0,Aug,0,0,Sat,0,15,69,84
2011-08-13,0,Aug,1,0,Sat,0,13,64,77
2011-08-13,0,Aug,2,0,Sat,0,16,58,74
2011-08-13,0,Aug,3,0,Sat,0,9,18,27
2011-08-13,0,Aug,4,0,Sat,0,5,5,10
2011-08-13,0,Aug,5,0,Sat,0,3,15,18
2011-08-13,0,Aug,6,0,Sat,0,3,19,22
2011-08-13,0,Aug,7,0,Sat,0,10,34,44
2011-08-13,0,Aug,8,0,Sat,0,28,90,118
2011-08-13,0,Aug,9,0,Sat,0,70,138,208
2011-08-13,0,Aug,10,0,Sat,0,97,163,260
2011-08-13,0,Aug,11,0,Sat,0,122,192,314
2011-08-13,0,Aug,12,0,Sat,0,175,246,421
2011-08-13,0,Aug,13,0,Sat,0,61,92,153
2011-08-13,0,Aug,14,0,Sat,0,113,146,259
2011-08-13,0,Aug,15,0,Sat,0,150,208,358
2011-08-13,0,Aug,16,0,Sat,0,148,133,281
2011-08-13,0,Aug,17,0,Sat,0,97,172,269
2011-08-13,0,Aug,18,0,Sat,0,123,169,292
2011-08-13,0,Aug,19,0,Sat,0,67,170,237
2011-08-13,0,Aug,20,0,Sat,0,78,105,183
2011-08-13,0,Aug,21,0,Sat,0,40,127,167
2011-08-13,0,Aug,22,0,Sat,0,36,118,154
2011-08-13,0,Aug,23,0,Sat,0,25,95,120
2011-08-14,0,Aug,0,0,Sun,0,19,71,90
2011-08-14,0,Aug,1,0,Sun,0,16,57,73
2011-08-14,0,Aug,2,0,Sun,0,13,49,62
2011-08-14,0,Aug,3,0,Sun,0,5,22,27
2011-08-14,0,Aug,4,0,Sun,0,1,2,3
2011-08-14,0,Aug,5,0,Sun,0,1,9,10
2011-08-14,0,Aug,6,0,Sun,0,2,4,6
2011-08-14,0,Aug,7,0,Sun,0,4,20,24
2011-08-14,0,Aug,8,0,Sun,0,20,21,41
2011-08-14,0,Aug,9,0,Sun,0,27,76,103
2011-08-14,0,Aug,10,0,Sun,0,67,116,183
2011-08-14,0,Aug,11,0,Sun,0,81,117,198
2011-08-14,0,Aug,12,0,Sun,0,98,183,281
2011-08-14,0,Aug,13,0,Sun,0,144,233,377
2011-08-14,0,Aug,14,0,Sun,0,126,244,370
2011-08-14,0,Aug,15,0,Sun,0,128,203,331
2011-08-14,0,Aug,16,0,Sun,0,116,176,292
2011-08-14,0,Aug,17,0,Sun,0,133,196,329
2011-08-14,0,Aug,18,0,Sun,0,125,222,347
2011-08-14,0,Aug,19,0,Sun,0,75,184,259
2011-08-14,0,Aug,20,0,Sun,0,67,126,193
2011-08-14,0,Aug,21,0,Sun,0,51,104,155
2011-08-14,0,Aug,22,0,Sun,0,14,25,39
2011-08-14,0,Aug,23,0,Sun,0,5,22,27
2011-08-15,0,Aug,0,0,Mon,1,7,18,25
2011-08-15,0,Aug,1,0,Mon,1,1,9,10
2011-08-15,0,Aug,2,0,Mon,1,0,3,3
2011-08-15,0,Aug,3,0,Mon,1,1,6,7
2011-08-15,0,Aug,4,0,Mon,1,1,4,5
2011-08-15,0,Aug,5,0,Mon,1,3,14,17
2011-08-15,0,Aug,6,0,Mon,1,3,87,90
2011-08-15,0,Aug,7,0,Mon,1,10,248,258
2011-08-15,0,Aug,8,0,Mon,1,29,326,355
2011-08-15,0,Aug,9,0,Mon,1,52,170,222
2011-08-15,0,Aug,10,0,Mon,1,54,87,141
2011-08-15,0,Aug,11,0,Mon,1,41,112,153
2011-08-15,0,Aug,12,0,Mon,1,62,116,178
2011-08-15,0,Aug,13,0,Mon,1,53,140,193
2011-08-15,0,Aug,14,0,Mon,1,56,95,151
2011-08-15,0,Aug,15,0,Mon,1,49,133,182
2011-08-15,0,Aug,16,0,Mon,1,58,225,283
2011-08-15,0,Aug,17,0,Mon,1,59,471,530
2011-08-15,0,Aug,18,0,Mon,1,70,413,483
2011-08-15,0,Aug,19,0,Mon,1,54,343,397
2011-08-15,0,Aug,20,0,Mon,1,45,240,285
2011-08-15,0,Aug,21,0,Mon,1,34,150,184
2011-08-15,0,Aug,22,0,Mon,1,22,76,98
2011-08-15,0,Aug,23,0,Mon,1,11,77,88
2011-08-16,0,Aug,0,0,Tue,1,8,23,31
2011-08-16,0,Aug,1,0,Tue,1,4,12,16
2011-08-16,0,Aug,2,0,Tue,1,1,3,4
2011-08-16,0,Aug,3,0,Tue,1,1,5,6
2011-08-16,0,Aug,4,0,Tue,1,0,5,5
2011-08-16,0,Aug,5,0,Tue,1,1,29,30
2011-08-16,0,Aug,6,0,Tue,1,4,115,119
2011-08-16,0,Aug,7,0,Tue,1,18,328,346
2011-08-16,0,Aug,8,0,Tue,1,24,417,441
2011-08-16,0,Aug,9,0,Tue,1,27,171,198
2011-08-16,0,Aug,10,0,Tue,1,28,83,111
2011-08-16,0,Aug,11,0,Tue,1,40,110,150
2011-08-16,0,Aug,12,0,Tue,1,42,120,162
2011-08-16,0,Aug,13,0,Tue,1,45,147,192
2011-08-16,0,Aug,14,0,Tue,1,65,117,182
2011-08-16,0,Aug,15,0,Tue,1,36,123,159
2011-08-16,0,Aug,16,0,Tue,1,55,248,303
2011-08-16,0,Aug,17,0,Tue,1,75,525,600
2011-08-16,0,Aug,18,0,Tue,1,54,516,570
2011-08-16,0,Aug,19,0,Tue,1,56,320,376
2011-08-16,0,Aug,20,0,Tue,1,48,232,280
2011-08-16,0,Aug,21,0,Tue,1,38,177,215
2011-08-16,0,Aug,22,0,Tue,1,31,121,152
2011-08-16,0,Aug,23,0,Tue,1,20,57,77
2011-08-17,0,Aug,0,0,Wed,1,8,16,24
2011-08-17,0,Aug,1,0,Wed,1,2,12,14
2011-08-17,0,Aug,2,0,Wed,1,0,6,6
2011-08-17,0,Aug,3,0,Wed,1,1,4,5
2011-08-17,0,Aug,4,0,Wed,1,0,5,5
2011-08-17,0,Aug,5,0,Wed,1,0,28,28
2011-08-17,0,Aug,6,0,Wed,1,4,101,105
2011-08-17,0,Aug,7,0,Wed,1,12,296,308
2011-08-17,0,Aug,8,0,Wed,1,35,452,487
2011-08-17,0,Aug,9,0,Wed,1,31,178,209
2011-08-17,0,Aug,10,0,Wed,1,27,91,118
2011-08-17,0,Aug,11,0,Wed,1,20,108,128
2011-08-17,0,Aug,12,0,Wed,1,26,163,189
2011-08-17,0,Aug,13,0,Wed,1,38,138,176
2011-08-17,0,Aug,14,0,Wed,1,54,138,192
2011-08-17,0,Aug,15,0,Wed,1,42,117,159
2011-08-17,0,Aug,16,0,Wed,1,62,238,300
2011-08-17,0,Aug,17,0,Wed,1,46,506,552
2011-08-17,0,Aug,18,0,Wed,1,86,470,556
2011-08-17,0,Aug,19,0,Wed,1,50,297,347
2011-08-17,0,Aug,20,0,Wed,1,37,243,280
2011-08-17,0,Aug,21,0,Wed,1,38,192,230
2011-08-17,0,Aug,22,0,Wed,1,29,142,171
2011-08-17,0,Aug,23,0,Wed,1,20,85,105
2011-08-18,0,Aug,0,0,Thur,1,18,38,56
2011-08-18,0,Aug,1,0,Thur,1,13,11,24
2011-08-18,0,Aug,2,0,Thur,1,2,4,6
2011-08-18,0,Aug,3,0,Thur,1,0,6,6
2011-08-18,0,Aug,4,0,Thur,1,0,9,9
2011-08-18,0,Aug,5,0,Thur,1,0,27,27
2011-08-18,0,Aug,6,0,Thur,1,6,97,103
2011-08-18,0,Aug,7,0,Thur,1,19,289,308
2011-08-18,0,Aug,8,0,Thur,1,27,393,420
2011-08-18,0,Aug,9,0,Thur,1,42,186,228
2011-08-18,0,Aug,10,0,Thur,1,37,92,129
2011-08-18,0,Aug,11,0,Thur,1,44,97,141
2011-08-18,0,Aug,12,0,Thur,1,34,139,173
2011-08-18,0,Aug,13,0,Thur,1,33,154,187
2011-08-18,0,Aug,14,0,Thur,1,67,115,182
2011-08-18,0,Aug,15,0,Thur,1,56,118,174
2011-08-18,0,Aug,16,0,Thur,1,49,196,245
2011-08-18,0,Aug,17,0,Thur,1,44,365,409
2011-08-18,0,Aug,18,0,Thur,1,48,226,274
2011-08-18,0,Aug,19,0,Thur,1,26,115,141
2011-08-18,0,Aug,20,0,Thur,1,24,141,165
2011-08-18,0,Aug,21,0,Thur,1,12,137,149
2011-08-18,0,Aug,22,0,Thur,1,18,117,135
2011-08-18,0,Aug,23,0,Thur,1,20,94,114
2011-08-19,0,Aug,0,0,Fri,1,9,53,62
2011-08-19,0,Aug,1,0,Fri,1,1,19,20
2011-08-19,0,Aug,2,0,Fri,1,0,8,8
2011-08-19,0,Aug,3,0,Fri,1,2,1,3
2011-08-19,0,Aug,4,0,Fri,1,1,7,8
2011-08-19,0,Aug,5,0,Fri,1,1,16,17
2011-08-19,0,Aug,6,0,Fri,1,2,91,93
2011-08-19,0,Aug,7,0,Fri,1,12,251,263
2011-08-19,0,Aug,8,0,Fri,1,30,368,398
2011-08-19,0,Aug,9,0,Fri,1,31,187,218
2011-08-19,0,Aug,10,0,Fri,1,57,108,165
2011-08-19,0,Aug,11,0,Fri,1,45,120,165
2011-08-19,0,Aug,12,0,Fri,1,54,168,222
2011-08-19,0,Aug,13,0,Fri,1,63,169,232
2011-08-19,0,Aug,14,0,Fri,1,78,142,220
2011-08-19,0,Aug,15,0,Fri,1,66,156,222
2011-08-19,0,Aug,16,0,Fri,1,66,261,327
2011-08-19,0,Aug,17,0,Fri,1,85,442,527
2011-08-19,0,Aug,18,0,Fri,1,88,337,425
2011-08-19,0,Aug,19,0,Fri,1,33,132,165
2011-08-19,0,Aug,20,0,Fri,1,12,46,58
2011-08-19,0,Aug,21,0,Fri,1,18,89,107
2011-08-19,0,Aug,22,0,Fri,1,25,97,122
2011-08-19,0,Aug,23,0,Fri,1,18,88,106
2011-08-20,0,Aug,0,0,Sat,0,21,107,128
2011-08-20,0,Aug,1,0,Sat,0,12,35,47
2011-08-20,0,Aug,2,0,Sat,0,10,59,69
2011-08-20,0,Aug,3,0,Sat,0,9,42,51
2011-08-20,0,Aug,4,0,Sat,0,1,6,7
2011-08-20,0,Aug,5,0,Sat,0,0,8,8
2011-08-20,0,Aug,6,0,Sat,0,6,18,24
2011-08-20,0,Aug,7,0,Sat,0,8,36,44
2011-08-20,0,Aug,8,0,Sat,0,27,106,133
2011-08-20,0,Aug,9,0,Sat,0,51,139,190
2011-08-20,0,Aug,10,0,Sat,0,114,192,306
2011-08-20,0,Aug,11,0,Sat,0,115,223,338
2011-08-20,0,Aug,12,0,Sat,0,156,253,409
2011-08-20,0,Aug,13,0,Sat,0,158,220,378
2011-08-20,0,Aug,14,0,Sat,0,147,228,375
2011-08-20,0,Aug,15,0,Sat,0,175,215,390
2011-08-20,0,Aug,16,0,Sat,0,151,222,373
2011-08-20,0,Aug,17,0,Sat,0,180,203,383
2011-08-20,0,Aug,18,0,Sat,0,169,225,394
2011-08-20,0,Aug,19,0,Sat,0,109,182,291
2011-08-20,0,Aug,20,0,Sat,0,78,170,248
2011-08-20,0,Aug,21,0,Sat,0,81,144,225
2011-08-20,0,Aug,22,0,Sat,0,77,146,223
2011-08-20,0,Aug,23,0,Sat,0,59,98,157
2011-08-21,0,Aug,0,0,Sun,0,6,68,74
2011-08-21,0,Aug,1,0,Sun,0,17,69,86
2011-08-21,0,Aug,2,0,Sun,0,13,51,64
2011-08-21,0,Aug,3,0,Sun,0,25,26,51
2011-08-21,0,Aug,4,0,Sun,0,1,5,6
2011-08-21,0,Aug,5,0,Sun,0,0,8,8
2011-08-21,0,Aug,6,0,Sun,0,4,10,14
2011-08-21,0,Aug,7,0,Sun,0,12,19,31
2011-08-21,0,Aug,8,0,Sun,0,30,62,92
2011-08-21,0,Aug,9,0,Sun,0,80,151,231
2011-08-21,0,Aug,10,0,Sun,0,97,177,274
2011-08-21,0,Aug,11,0,Sun,0,132,181,313
2011-08-21,0,Aug,12,0,Sun,0,135,239,374
2011-08-21,0,Aug,13,0,Sun,0,94,216,310
2011-08-21,0,Aug,14,0,Sun,0,78,157,235
2011-08-21,0,Aug,15,0,Sun,0,17,51,68
2011-08-21,0,Aug,16,0,Sun,0,97,161,258
2011-08-21,0,Aug,17,0,Sun,0,91,179,270
2011-08-21,0,Aug,18,0,Sun,0,96,215,311
2011-08-21,0,Aug,19,0,Sun,0,81,201,282
2011-08-21,0,Aug,20,0,Sun,0,41,140,181
2011-08-21,0,Aug,21,0,Sun,0,45,93,138
2011-08-21,0,Aug,22,0,Sun,0,37,97,134
2011-08-21,0,Aug,23,0,Sun,0,20,48,68
2011-08-22,0,Aug,0,0,Mon,1,18,22,40
2011-08-22,0,Aug,1,0,Mon,1,8,13,21
2011-08-22,0,Aug,2,0,Mon,1,2,6,8
2011-08-22,0,Aug,3,0,Mon,1,0,5,5
2011-08-22,0,Aug,4,0,Mon,1,2,10,12
2011-08-22,0,Aug,5,0,Mon,1,1,23,24
2011-08-22,0,Aug,6,0,Mon,1,6,106,112
2011-08-22,0,Aug,7,0,Mon,1,11,270,281
2011-08-22,0,Aug,8,0,Mon,1,20,331,351
2011-08-22,0,Aug,9,0,Mon,1,36,151,187
2011-08-22,0,Aug,10,0,Mon,1,36,85,121
2011-08-22,0,Aug,11,0,Mon,1,46,85,131
2011-08-22,0,Aug,12,0,Mon,1,54,153,207
2011-08-22,0,Aug,13,0,Mon,1,47,158,205
2011-08-22,0,Aug,14,0,Mon,1,88,137,225
2011-08-22,0,Aug,15,0,Mon,1,72,127,199
2011-08-22,0,Aug,16,0,Mon,1,66,254,320
2011-08-22,0,Aug,17,0,Mon,1,82,509,591
2011-08-22,0,Aug,18,0,Mon,1,72,537,609
2011-08-22,0,Aug,19,0,Mon,1,66,350,416
2011-08-22,0,Aug,20,0,Mon,1,21,247,268
2011-08-22,0,Aug,21,0,Mon,1,28,180,208
2011-08-22,0,Aug,22,0,Mon,1,32,121,153
2011-08-22,0,Aug,23,0,Mon,1,19,45,64
2011-08-23,0,Aug,0,0,Tue,1,13,22,35
2011-08-23,0,Aug,1,0,Tue,1,6,13,19
2011-08-23,0,Aug,2,0,Tue,1,2,4,6
2011-08-23,0,Aug,3,0,Tue,1,2,4,6
2011-08-23,0,Aug,4,0,Tue,1,0,5,5
2011-08-23,0,Aug,5,0,Tue,1,1,35,36
2011-08-23,0,Aug,6,0,Tue,1,3,111,114
2011-08-23,0,Aug,7,0,Tue,1,11,333,344
2011-08-23,0,Aug,8,0,Tue,1,43,461,504
2011-08-23,0,Aug,9,0,Tue,1,34,191,225
2011-08-23,0,Aug,10,0,Tue,1,56,92,148
2011-08-23,0,Aug,11,0,Tue,1,62,124,186
2011-08-23,0,Aug,12,0,Tue,1,60,177,237
2011-08-23,0,Aug,13,0,Tue,1,70,164,234
2011-08-23,0,Aug,14,0,Tue,1,149,502,651
2011-08-23,0,Aug,15,0,Tue,1,178,423,601
2011-08-23,0,Aug,16,0,Tue,1,133,311,444
2011-08-23,0,Aug,17,0,Tue,1,133,339,472
2011-08-23,0,Aug,18,0,Tue,1,98,421,519
2011-08-23,0,Aug,19,0,Tue,1,70,297,367
2011-08-23,0,Aug,20,0,Tue,1,54,206,260
2011-08-23,0,Aug,21,0,Tue,1,38,173,211
2011-08-23,0,Aug,22,0,Tue,1,46,145,191
2011-08-23,0,Aug,23,0,Tue,1,19,61,80
2011-08-24,0,Aug,0,0,Wed,1,9,29,38
2011-08-24,0,Aug,1,0,Wed,1,7,17,24
2011-08-24,0,Aug,2,0,Wed,1,2,4,6
2011-08-24,0,Aug,3,0,Wed,1,0,1,1
2011-08-24,0,Aug,4,0,Wed,1,0,7,7
2011-08-24,0,Aug,5,0,Wed,1,1,26,27
2011-08-24,0,Aug,6,0,Wed,1,3,105,108
2011-08-24,0,Aug,7,0,Wed,1,11,297,308
2011-08-24,0,Aug,8,0,Wed,1,32,436,468
2011-08-24,0,Aug,9,0,Wed,1,44,169,213
2011-08-24,0,Aug,10,0,Wed,1,51,95,146
2011-08-24,0,Aug,11,0,Wed,1,57,128,185
2011-08-24,0,Aug,12,0,Wed,1,60,175,235
2011-08-24,0,Aug,13,0,Wed,1,56,180,236
2011-08-24,0,Aug,14,0,Wed,1,77,127,204
2011-08-24,0,Aug,15,0,Wed,1,63,141,204
2011-08-24,0,Aug,16,0,Wed,1,49,222,271
2011-08-24,0,Aug,17,0,Wed,1,83,484,567
2011-08-24,0,Aug,18,0,Wed,1,102,519,621
2011-08-24,0,Aug,19,0,Wed,1,93,347,440
2011-08-24,0,Aug,20,0,Wed,1,45,289,334
2011-08-24,0,Aug,21,0,Wed,1,47,189,236
2011-08-24,0,Aug,22,0,Wed,1,41,140,181
2011-08-24,0,Aug,23,0,Wed,1,16,54,70
2011-08-25,0,Aug,0,0,Thur,1,11,41,52
2011-08-25,0,Aug,1,0,Thur,1,4,11,15
2011-08-25,0,Aug,2,0,Thur,1,3,2,5
2011-08-25,0,Aug,3,0,Thur,1,2,2,4
2011-08-25,0,Aug,4,0,Thur,1,1,6,7
2011-08-25,0,Aug,5,0,Thur,1,1,25,26
2011-08-25,0,Aug,6,0,Thur,1,1,101,102
2011-08-25,0,Aug,7,0,Thur,1,17,296,313
2011-08-25,0,Aug,8,0,Thur,1,23,461,484
2011-08-25,0,Aug,9,0,Thur,1,21,141,162
2011-08-25,0,Aug,10,0,Thur,1,37,105,142
2011-08-25,0,Aug,11,0,Thur,1,39,112,151
2011-08-25,0,Aug,12,0,Thur,1,9,32,41
2011-08-25,0,Aug,13,0,Thur,1,7,30,37
2011-08-25,0,Aug,14,0,Thur,1,27,86,113
2011-08-25,0,Aug,15,0,Thur,1,28,104,132
2011-08-25,0,Aug,16,0,Thur,1,16,105,121
2011-08-25,0,Aug,17,0,Thur,1,28,284,312
2011-08-25,0,Aug,18,0,Thur,1,31,377,408
2011-08-25,0,Aug,19,0,Thur,1,31,241,272
2011-08-25,0,Aug,20,0,Thur,1,33,192,225
2011-08-25,0,Aug,21,0,Thur,1,29,158,187
2011-08-25,0,Aug,22,0,Thur,1,21,126,147
2011-08-25,0,Aug,23,0,Thur,1,15,69,84
2011-08-26,0,Aug,0,0,Fri,1,9,42,51
2011-08-26,0,Aug,1,0,Fri,1,10,13,23
2011-08-26,0,Aug,2,0,Fri,1,4,16,20
2011-08-26,0,Aug,3,0,Fri,1,3,8,11
2011-08-26,0,Aug,4,0,Fri,1,2,6,8
2011-08-26,0,Aug,5,0,Fri,1,3,23,26
2011-08-26,0,Aug,6,0,Fri,1,5,100,105
2011-08-26,0,Aug,7,0,Fri,1,3,263,266
2011-08-26,0,Aug,8,0,Fri,1,17,387,404
2011-08-26,0,Aug,9,0,Fri,1,39,191,230
2011-08-26,0,Aug,10,0,Fri,1,34,89,123
2011-08-26,0,Aug,11,0,Fri,1,63,151,214
2011-08-26,0,Aug,12,0,Fri,1,70,173,243
2011-08-26,0,Aug,13,0,Fri,1,72,165,237
2011-08-26,0,Aug,14,0,Fri,1,55,164,219
2011-08-26,0,Aug,15,0,Fri,1,53,196,249
2011-08-26,0,Aug,16,0,Fri,1,50,293,343
2011-08-26,0,Aug,17,0,Fri,1,56,433,489
2011-08-26,0,Aug,18,0,Fri,1,40,370,410
2011-08-26,0,Aug,19,0,Fri,1,55,235,290
2011-08-26,0,Aug,20,0,Fri,1,39,183,222
2011-08-26,0,Aug,21,0,Fri,1,38,152,190
2011-08-26,0,Aug,22,0,Fri,1,26,126,152
2011-08-26,0,Aug,23,0,Fri,1,22,114,136
2011-08-27,0,Aug,0,0,Sat,0,33,112,145
2011-08-27,0,Aug,1,0,Sat,0,13,51,64
2011-08-27,0,Aug,2,0,Sat,0,18,59,77
2011-08-27,0,Aug,3,0,Sat,0,8,22,30
2011-08-27,0,Aug,4,0,Sat,0,1,3,4
2011-08-27,0,Aug,5,0,Sat,0,1,11,12
2011-08-27,0,Aug,6,0,Sat,0,3,15,18
2011-08-27,0,Aug,7,0,Sat,0,2,26,28
2011-08-27,0,Aug,8,0,Sat,0,14,62,76
2011-08-27,0,Aug,9,0,Sat,0,28,128,156
2011-08-27,0,Aug,10,0,Sat,0,51,154,205
2011-08-27,0,Aug,11,0,Sat,0,15,73,88
2011-08-27,0,Aug,12,0,Sat,0,11,65,76
2011-08-27,0,Aug,13,0,Sat,0,10,33,43
2011-08-27,0,Aug,14,0,Sat,0,4,19,23
2011-08-27,0,Aug,15,0,Sat,0,2,28,30
2011-08-27,0,Aug,16,0,Sat,0,10,14,24
2011-08-27,0,Aug,17,0,Sat,0,2,14,16
2011-08-28,0,Aug,7,0,Sun,0,0,1,1
2011-08-28,0,Aug,8,0,Sun,0,2,6,8
2011-08-28,0,Aug,9,0,Sun,0,7,46,53
2011-08-28,0,Aug,10,0,Sun,0,27,115,142
2011-08-28,0,Aug,11,0,Sun,0,59,178,237
2011-08-28,0,Aug,12,0,Sun,0,88,218,306
2011-08-28,0,Aug,13,0,Sun,0,129,302,431
2011-08-28,0,Aug,14,0,Sun,0,157,290,447
2011-08-28,0,Aug,15,0,Sun,0,155,314,469
2011-08-28,0,Aug,16,0,Sun,0,196,295,491
2011-08-28,0,Aug,17,0,Sun,0,145,253,398
2011-08-28,0,Aug,18,0,Sun,0,145,257,402
2011-08-28,0,Aug,19,0,Sun,0,140,247,387
2011-08-28,0,Aug,20,0,Sun,0,64,150,214
2011-08-28,0,Aug,21,0,Sun,0,60,126,186
2011-08-28,0,Aug,22,0,Sun,0,25,73,98
2011-08-28,0,Aug,23,0,Sun,0,16,48,64
2011-08-29,0,Aug,0,0,Mon,1,13,21,34
2011-08-29,0,Aug,1,0,Mon,1,5,15,20
2011-08-29,0,Aug,2,0,Mon,1,8,5,13
2011-08-29,0,Aug,3,0,Mon,1,1,5,6
2011-08-29,0,Aug,4,0,Mon,1,0,3,3
2011-08-29,0,Aug,5,0,Mon,1,0,17,17
2011-08-29,0,Aug,6,0,Mon,1,3,99,102
2011-08-29,0,Aug,7,0,Mon,1,11,273,284
2011-08-29,0,Aug,8,0,Mon,1,20,384,404
2011-08-29,0,Aug,9,0,Mon,1,22,166,188
2011-08-29,0,Aug,10,0,Mon,1,42,73,115
2011-08-29,0,Aug,11,0,Mon,1,38,100,138
2011-08-29,0,Aug,12,0,Mon,1,48,159,207
2011-08-29,0,Aug,13,0,Mon,1,48,170,218
2011-08-29,0,Aug,14,0,Mon,1,55,127,182
2011-08-29,0,Aug,15,0,Mon,1,56,164,220
2011-08-29,0,Aug,16,0,Mon,1,56,226,282
2011-08-29,0,Aug,17,0,Mon,1,67,524,591
2011-08-29,0,Aug,18,0,Mon,1,60,487,547
2011-08-29,0,Aug,19,0,Mon,1,50,317,367
2011-08-29,0,Aug,20,0,Mon,1,50,227,277
2011-08-29,0,Aug,21,0,Mon,1,34,168,202
2011-08-29,0,Aug,22,0,Mon,1,23,119,142
2011-08-29,0,Aug,23,0,Mon,1,19,56,75
2011-08-30,0,Aug,0,0,Tue,1,10,17,27
2011-08-30,0,Aug,1,0,Tue,1,6,7,13
2011-08-30,0,Aug,2,0,Tue,1,2,8,10
2011-08-30,0,Aug,3,0,Tue,1,2,2,4
2011-08-30,0,Aug,4,0,Tue,1,0,6,6
2011-08-30,0,Aug,5,0,Tue,1,1,27,28
2011-08-30,0,Aug,6,0,Tue,1,4,115,119
2011-08-30,0,Aug,7,0,Tue,1,19,338,357
2011-08-30,0,Aug,8,0,Tue,1,34,459,493
2011-08-30,0,Aug,9,0,Tue,1,38,180,218
2011-08-30,0,Aug,10,0,Tue,1,28,109,137
2011-08-30,0,Aug,11,0,Tue,1,60,115,175
2011-08-30,0,Aug,12,0,Tue,1,65,172,237
2011-08-30,0,Aug,13,0,Tue,1,59,170,229
2011-08-30,0,Aug,14,0,Tue,1,58,151,209
2011-08-30,0,Aug,15,0,Tue,1,34,162,196
2011-08-30,0,Aug,16,0,Tue,1,42,295,337
2011-08-30,0,Aug,17,0,Tue,1,62,549,611
2011-08-30,0,Aug,18,0,Tue,1,60,516,576
2011-08-30,0,Aug,19,0,Tue,1,68,397,465
2011-08-30,0,Aug,20,0,Tue,1,39,259,298
2011-08-30,0,Aug,21,0,Tue,1,43,180,223
2011-08-30,0,Aug,22,0,Tue,1,22,121,143
2011-08-30,0,Aug,23,0,Tue,1,19,74,93
2011-08-31,0,Aug,0,0,Wed,1,8,24,32
2011-08-31,0,Aug,1,0,Wed,1,2,13,15
2011-08-31,0,Aug,2,0,Wed,1,1,5,6
2011-08-31,0,Aug,3,0,Wed,1,2,4,6
2011-08-31,0,Aug,4,0,Wed,1,0,5,5
2011-08-31,0,Aug,5,0,Wed,1,2,25,27
2011-08-31,0,Aug,6,0,Wed,1,4,107,111
2011-08-31,0,Aug,7,0,Wed,1,12,316,328
2011-08-31,0,Aug,8,0,Wed,1,27,440,467
2011-08-31,0,Aug,9,0,Wed,1,27,217,244
2011-08-31,0,Aug,10,0,Wed,1,33,105,138
2011-08-31,0,Aug,11,0,Wed,1,28,143,171
2011-08-31,0,Aug,12,0,Wed,1,68,192,260
2011-08-31,0,Aug,13,0,Wed,1,39,182,221
2011-08-31,0,Aug,14,0,Wed,1,48,148,196
2011-08-31,0,Aug,15,0,Wed,1,34,138,172
2011-08-31,0,Aug,16,0,Wed,1,46,263,309
2011-08-31,0,Aug,17,0,Wed,1,83,525,608
2011-08-31,0,Aug,18,0,Wed,1,70,495,565
2011-08-31,0,Aug,19,0,Wed,1,53,393,446
2011-08-31,0,Aug,20,0,Wed,1,30,259,289
2011-08-31,0,Aug,21,0,Wed,1,27,174,201
2011-08-31,0,Aug,22,0,Wed,1,20,137,157
2011-08-31,0,Aug,23,0,Wed,1,24,60,84
2011-09-01,0,Sep,0,0,Thur,1,18,33,51
2011-09-01,0,Sep,1,0,Thur,1,7,14,21
2011-09-01,0,Sep,2,0,Thur,1,14,11,25
2011-09-01,0,Sep,3,0,Thur,1,7,7,14
2011-09-01,0,Sep,4,0,Thur,1,0,7,7
2011-09-01,0,Sep,5,0,Thur,1,1,22,23
2011-09-01,0,Sep,6,0,Thur,1,2,103,105
2011-09-01,0,Sep,7,0,Thur,1,7,335,342
2011-09-01,0,Sep,8,0,Thur,1,31,467,498
2011-09-01,0,Sep,9,0,Thur,1,29,178,207
2011-09-01,0,Sep,10,0,Thur,1,46,92,138
2011-09-01,0,Sep,11,0,Thur,1,51,141,192
2011-09-01,0,Sep,12,0,Thur,1,64,165,229
2011-09-01,0,Sep,13,0,Thur,1,50,169,219
2011-09-01,0,Sep,14,0,Thur,1,54,144,198
2011-09-01,0,Sep,15,0,Thur,1,39,135,174
2011-09-01,0,Sep,16,0,Thur,1,55,253,308
2011-09-01,0,Sep,17,0,Thur,1,61,567,628
2011-09-01,0,Sep,18,0,Thur,1,69,462,531
2011-09-01,0,Sep,19,0,Thur,1,79,364,443
2011-09-01,0,Sep,20,0,Thur,1,33,247,280
2011-09-01,0,Sep,21,0,Thur,1,17,160,177
2011-09-01,0,Sep,22,0,Thur,1,34,145,179
2011-09-01,0,Sep,23,0,Thur,1,15,111,126
2011-09-02,0,Sep,0,0,Fri,1,6,58,64
2011-09-02,0,Sep,1,0,Fri,1,4,28,32
2011-09-02,0,Sep,2,0,Fri,1,9,11,20
2011-09-02,0,Sep,3,0,Fri,1,4,4,8
2011-09-02,0,Sep,4,0,Fri,1,2,2,4
2011-09-02,0,Sep,5,0,Fri,1,0,20,20
2011-09-02,0,Sep,6,0,Fri,1,3,73,76
2011-09-02,0,Sep,7,0,Fri,1,6,253,259
2011-09-02,0,Sep,8,0,Fri,1,22,434,456
2011-09-02,0,Sep,9,0,Fri,1,30,190,220
2011-09-02,0,Sep,10,0,Fri,1,34,106,140
2011-09-02,0,Sep,11,0,Fri,1,51,141,192
2011-09-02,0,Sep,12,0,Fri,1,82,178,260
2011-09-02,0,Sep,13,0,Fri,1,72,207,279
2011-09-02,0,Sep,14,0,Fri,1,75,208,283
2011-09-02,0,Sep,15,0,Fri,1,69,277,346
2011-09-02,0,Sep,16,0,Fri,1,82,299,381
2011-09-02,0,Sep,17,0,Fri,1,78,377,455
2011-09-02,0,Sep,18,0,Fri,1,50,305,355
2011-09-02,0,Sep,19,0,Fri,1,67,220,287
2011-09-02,0,Sep,20,0,Fri,1,38,158,196
2011-09-02,0,Sep,21,0,Fri,1,28,121,149
2011-09-02,0,Sep,22,0,Fri,1,33,114,147
2011-09-02,0,Sep,23,0,Fri,1,30,68,98
2011-09-03,0,Sep,0,0,Sat,0,22,65,87
2011-09-03,0,Sep,1,0,Sat,0,17,57,74
2011-09-03,0,Sep,2,0,Sat,0,15,26,41
2011-09-03,0,Sep,3,0,Sat,0,17,18,35
2011-09-03,0,Sep,4,0,Sat,0,3,4,7
2011-09-03,0,Sep,5,0,Sat,0,3,9,12
2011-09-03,0,Sep,6,0,Sat,0,4,19,23
2011-09-03,0,Sep,7,0,Sat,0,5,33,38
2011-09-03,0,Sep,8,0,Sat,0,24,65,89
2011-09-03,0,Sep,9,0,Sat,0,83,118,201
2011-09-03,0,Sep,10,0,Sat,0,90,168,258
2011-09-03,0,Sep,11,0,Sat,0,66,128,194
2011-09-03,0,Sep,12,0,Sat,0,97,160,257
2011-09-03,0,Sep,13,0,Sat,0,153,200,353
2011-09-03,0,Sep,14,0,Sat,0,204,176,380
2011-09-03,0,Sep,15,0,Sat,0,187,201,388
2011-09-03,0,Sep,16,0,Sat,0,186,188,374
2011-09-03,0,Sep,17,0,Sat,0,170,201,371
2011-09-03,0,Sep,18,0,Sat,0,160,179,339
2011-09-03,0,Sep,19,0,Sat,0,147,148,295
2011-09-03,0,Sep,20,0,Sat,0,99,120,219
2011-09-03,0,Sep,21,0,Sat,0,71,93,164
2011-09-03,0,Sep,22,0,Sat,0,66,96,162
2011-09-03,0,Sep,23,0,Sat,0,46,77,123
2011-09-04,0,Sep,0,0,Sun,0,33,76,109
2011-09-04,0,Sep,1,0,Sun,0,37,38,75
2011-09-04,0,Sep,2,0,Sun,0,17,43,60
2011-09-04,0,Sep,3,0,Sun,0,20,23,43
2011-09-04,0,Sep,4,0,Sun,0,0,4,4
2011-09-04,0,Sep,5,0,Sun,0,1,5,6
2011-09-04,0,Sep,6,0,Sun,0,0,3,3
2011-09-04,0,Sep,7,0,Sun,0,10,20,30
2011-09-04,0,Sep,8,0,Sun,0,21,49,70
2011-09-04,0,Sep,9,0,Sun,0,87,102,189
2011-09-04,0,Sep,10,0,Sun,0,150,147,297
2011-09-04,0,Sep,11,0,Sun,0,174,163,337
2011-09-04,0,Sep,12,0,Sun,0,214,221,435
2011-09-04,0,Sep,13,0,Sun,0,245,174,419
2011-09-04,0,Sep,14,0,Sun,0,205,156,361
2011-09-04,0,Sep,15,0,Sun,0,218,192,410
2011-09-04,0,Sep,16,0,Sun,0,196,141,337
2011-09-04,0,Sep,17,0,Sun,0,204,172,376
2011-09-04,0,Sep,18,0,Sun,0,187,169,356
2011-09-04,0,Sep,19,0,Sun,0,178,150,328
2011-09-04,0,Sep,20,0,Sun,0,104,125,229
2011-09-04,0,Sep,21,0,Sun,0,104,103,207
2011-09-04,0,Sep,22,0,Sun,0,70,85,155
2011-09-04,0,Sep,23,0,Sun,0,46,58,104
2011-09-05,0,Sep,0,1,Mon,0,31,66,97
2011-09-05,0,Sep,1,1,Mon,0,19,35,54
2011-09-05,0,Sep,2,1,Mon,0,17,22,39
2011-09-05,0,Sep,3,1,Mon,0,4,12,16
2011-09-05,0,Sep,4,1,Mon,0,3,5,8
2011-09-05,0,Sep,5,1,Mon,0,2,4,6
2011-09-05,0,Sep,6,1,Mon,0,6,5,11
2011-09-05,0,Sep,7,1,Mon,0,11,30,41
2011-09-05,0,Sep,8,1,Mon,0,45,56,101
2011-09-05,0,Sep,9,1,Mon,0,63,89,152
2011-09-05,0,Sep,10,1,Mon,0,107,137,244
2011-09-05,0,Sep,11,1,Mon,0,101,207,308
2011-09-05,0,Sep,12,1,Mon,0,141,212,353
2011-09-05,0,Sep,13,1,Mon,0,154,235,389
2011-09-05,0,Sep,14,1,Mon,0,145,212,357
2011-09-05,0,Sep,15,1,Mon,0,111,142,253
2011-09-05,0,Sep,16,1,Mon,0,92,192,284
2011-09-05,0,Sep,17,1,Mon,0,37,77,114
2011-09-05,0,Sep,18,1,Mon,0,31,92,123
2011-09-05,0,Sep,19,1,Mon,0,52,123,175
2011-09-05,0,Sep,20,1,Mon,0,26,56,82
2011-09-05,0,Sep,21,1,Mon,0,20,40,60
2011-09-05,0,Sep,22,1,Mon,0,15,49,64
2011-09-05,0,Sep,23,1,Mon,0,3,17,20
2011-09-06,0,Sep,0,0,Tue,1,1,7,8
2011-09-06,0,Sep,2,0,Tue,1,0,2,2
2011-09-06,0,Sep,3,0,Tue,1,1,0,1
2011-09-06,0,Sep,4,0,Tue,1,1,3,4
2011-09-06,0,Sep,5,0,Tue,1,1,20,21
2011-09-06,0,Sep,6,0,Tue,1,0,72,72
2011-09-06,0,Sep,7,0,Tue,1,6,166,172
2011-09-06,0,Sep,8,0,Tue,1,15,349,364
2011-09-06,0,Sep,9,0,Tue,1,18,167,185
2011-09-06,0,Sep,10,0,Tue,1,16,90,106
2011-09-06,0,Sep,11,0,Tue,1,11,78,89
2011-09-06,0,Sep,12,0,Tue,1,16,51,67
2011-09-06,0,Sep,13,0,Tue,1,5,24,29
2011-09-06,0,Sep,14,0,Tue,1,3,21,24
2011-09-06,0,Sep,15,0,Tue,1,18,71,89
2011-09-06,0,Sep,16,0,Tue,1,11,95,106
2011-09-06,0,Sep,17,0,Tue,1,15,276,291
2011-09-06,0,Sep,18,0,Tue,1,22,351,373
2011-09-06,0,Sep,19,0,Tue,1,12,269,281
2011-09-06,0,Sep,20,0,Tue,1,13,150,163
2011-09-06,0,Sep,21,0,Tue,1,12,109,121
2011-09-06,0,Sep,22,0,Tue,1,5,79,84
2011-09-06,0,Sep,23,0,Tue,1,2,56,58
2011-09-07,0,Sep,0,0,Wed,1,1,12,13
2011-09-07,0,Sep,1,0,Wed,1,2,3,5
2011-09-07,0,Sep,2,0,Wed,1,2,4,6
2011-09-07,0,Sep,3,0,Wed,1,1,1,2
2011-09-07,0,Sep,4,0,Wed,1,0,4,4
2011-09-07,0,Sep,5,0,Wed,1,1,15,16
2011-09-07,0,Sep,6,0,Wed,1,1,74,75
2011-09-07,0,Sep,7,0,Wed,1,3,83,86
2011-09-07,0,Sep,8,0,Wed,1,9,319,328
2011-09-07,0,Sep,9,0,Wed,1,14,176,190
2011-09-07,0,Sep,10,0,Wed,1,3,63,66
2011-09-07,0,Sep,11,0,Wed,1,1,9,10
2011-09-07,0,Sep,12,0,Wed,1,1,21,22
2011-09-07,0,Sep,13,0,Wed,1,2,9,11
2011-09-07,0,Sep,14,0,Wed,1,1,24,25
2011-09-07,0,Sep,15,0,Wed,1,3,55,58
2011-09-07,0,Sep,16,0,Wed,1,7,137,144
2011-09-07,0,Sep,17,0,Wed,1,21,264,285
2011-09-07,0,Sep,18,0,Wed,1,18,219,237
2011-09-07,0,Sep,19,0,Wed,1,14,212,226
2011-09-07,0,Sep,20,0,Wed,1,3,93,96
2011-09-07,0,Sep,21,0,Wed,1,4,34,38
2011-09-07,0,Sep,22,0,Wed,1,3,26,29
2011-09-07,0,Sep,23,0,Wed,1,3,21,24
2011-09-08,0,Sep,0,0,Thur,1,3,11,14
2011-09-08,0,Sep,1,0,Thur,1,0,4,4
2011-09-08,0,Sep,3,0,Thur,1,0,2,2
2011-09-08,0,Sep,4,0,Thur,1,0,3,3
2011-09-08,0,Sep,5,0,Thur,1,1,13,14
2011-09-08,0,Sep,6,0,Thur,1,1,55,56
2011-09-08,0,Sep,7,0,Thur,1,7,172,179
2011-09-08,0,Sep,8,0,Thur,1,7,188,195
2011-09-08,0,Sep,9,0,Thur,1,4,65,69
2011-09-08,0,Sep,10,0,Thur,1,8,57,65
2011-09-08,0,Sep,11,0,Thur,1,16,82,98
2011-09-08,0,Sep,12,0,Thur,1,17,85,102
2011-09-08,0,Sep,13,0,Thur,1,14,112,126
2011-09-08,0,Sep,14,0,Thur,1,15,105,120
2011-09-08,0,Sep,15,0,Thur,1,24,115,139
2011-09-08,0,Sep,16,0,Thur,1,5,151,156
2011-09-08,0,Sep,17,0,Thur,1,11,102,113
2011-09-08,0,Sep,18,0,Thur,1,2,66,68
2011-09-08,0,Sep,19,0,Thur,1,1,51,52
2011-09-08,0,Sep,20,0,Thur,1,6,83,89
2011-09-08,0,Sep,21,0,Thur,1,6,76,82
2011-09-08,0,Sep,22,0,Thur,1,5,65,70
2011-09-08,0,Sep,23,0,Thur,1,0,26,26
2011-09-09,0,Sep,0,0,Fri,1,1,15,16
2011-09-09,0,Sep,1,0,Fri,1,0,8,8
2011-09-09,0,Sep,2,0,Fri,1,1,7,8
2011-09-09,0,Sep,3,0,Fri,1,1,1,2
2011-09-09,0,Sep,4,0,Fri,1,0,3,3
2011-09-09,0,Sep,5,0,Fri,1,0,14,14
2011-09-09,0,Sep,6,0,Fri,1,3,54,57
2011-09-09,0,Sep,7,0,Fri,1,4,104,108
2011-09-09,0,Sep,8,0,Fri,1,12,276,288
2011-09-09,0,Sep,9,0,Fri,1,5,131,136
2011-09-09,0,Sep,10,0,Fri,1,2,27,29
2011-09-09,0,Sep,11,0,Fri,1,6,66,72
2011-09-09,0,Sep,12,0,Fri,1,4,71,75
2011-09-09,0,Sep,13,0,Fri,1,14,108,122
2011-09-09,0,Sep,14,0,Fri,1,29,119,148
2011-09-09,0,Sep,15,0,Fri,1,27,161,188
2011-09-09,0,Sep,16,0,Fri,1,41,244,285
2011-09-09,0,Sep,17,0,Fri,1,54,451,505
2011-09-09,0,Sep,18,0,Fri,1,33,377,410
2011-09-09,0,Sep,19,0,Fri,1,33,316,349
2011-09-09,0,Sep,20,0,Fri,1,30,180,210
2011-09-09,0,Sep,21,0,Fri,1,49,154,203
2011-09-09,0,Sep,22,0,Fri,1,33,127,160
2011-09-09,0,Sep,23,0,Fri,1,35,113,148
2011-09-10,0,Sep,0,0,Sat,0,32,84,116
2011-09-10,0,Sep,1,0,Sat,0,16,67,83
2011-09-10,0,Sep,2,0,Sat,0,18,46,64
2011-09-10,0,Sep,3,0,Sat,0,8,29,37
2011-09-10,0,Sep,4,0,Sat,0,3,4,7
2011-09-10,0,Sep,5,0,Sat,0,2,6,8
2011-09-10,0,Sep,6,0,Sat,0,0,6,6
2011-09-10,0,Sep,7,0,Sat,0,9,43,52
2011-09-10,0,Sep,8,0,Sat,0,16,103,119
2011-09-10,0,Sep,9,0,Sat,0,39,168,207
2011-09-10,0,Sep,10,0,Sat,0,85,233,318
2011-09-10,0,Sep,11,0,Sat,0,108,252,360
2011-09-10,0,Sep,12,0,Sat,0,144,260,404
2011-09-10,0,Sep,13,0,Sat,0,131,239,370
2011-09-10,0,Sep,14,0,Sat,0,129,230,359
2011-09-10,0,Sep,15,0,Sat,0,217,263,480
2011-09-10,0,Sep,16,0,Sat,0,170,261,431
2011-09-10,0,Sep,17,0,Sat,0,185,275,460
2011-09-10,0,Sep,18,0,Sat,0,119,241,360
2011-09-10,0,Sep,19,0,Sat,0,101,214,315
2011-09-10,0,Sep,20,0,Sat,0,78,167,245
2011-09-10,0,Sep,21,0,Sat,0,59,171,230
2011-09-10,0,Sep,22,0,Sat,0,49,126,175
2011-09-10,0,Sep,23,0,Sat,0,32,107,139
2011-09-11,0,Sep,0,0,Sun,0,29,79,108
2011-09-11,0,Sep,1,0,Sun,0,22,66,88
2011-09-11,0,Sep,2,0,Sun,0,16,60,76
2011-09-11,0,Sep,3,0,Sun,0,15,30,45
2011-09-11,0,Sep,4,0,Sun,0,3,6,9
2011-09-11,0,Sep,5,0,Sun,0,15,24,39
2011-09-11,0,Sep,6,0,Sun,0,4,16,20
2011-09-11,0,Sep,7,0,Sun,0,9,28,37
2011-09-11,0,Sep,8,0,Sun,0,25,69,94
2011-09-11,0,Sep,9,0,Sun,0,59,168,227
2011-09-11,0,Sep,10,0,Sun,0,120,214,334
2011-09-11,0,Sep,11,0,Sun,0,144,258,402
2011-09-11,0,Sep,12,0,Sun,0,113,298,411
2011-09-11,0,Sep,13,0,Sun,0,119,231,350
2011-09-11,0,Sep,14,0,Sun,0,120,222,342
2011-09-11,0,Sep,15,0,Sun,0,134,270,404
2011-09-11,0,Sep,16,0,Sun,0,180,303,483
2011-09-11,0,Sep,17,0,Sun,0,152,228,380
2011-09-11,0,Sep,18,0,Sun,0,110,229,339
2011-09-11,0,Sep,19,0,Sun,0,101,232,333
2011-09-11,0,Sep,20,0,Sun,0,65,161,226
2011-09-11,0,Sep,21,0,Sun,0,45,114,159
2011-09-11,0,Sep,22,0,Sun,0,21,74,95
2011-09-11,0,Sep,23,0,Sun,0,12,33,45
2011-09-12,0,Sep,0,0,Mon,1,5,11,16
2011-09-12,0,Sep,1,0,Mon,1,1,11,12
2011-09-12,0,Sep,2,0,Mon,1,2,0,2
2011-09-12,0,Sep,4,0,Mon,1,0,4,4
2011-09-12,0,Sep,5,0,Mon,1,1,23,24
2011-09-12,0,Sep,6,0,Mon,1,1,108,109
2011-09-12,0,Sep,7,0,Mon,1,12,300,312
2011-09-12,0,Sep,8,0,Mon,1,26,382,408
2011-09-12,0,Sep,9,0,Mon,1,21,155,176
2011-09-12,0,Sep,10,0,Mon,1,40,89,129
2011-09-12,0,Sep,11,0,Mon,1,34,131,165
2011-09-12,0,Sep,12,0,Mon,1,37,147,184
2011-09-12,0,Sep,13,0,Mon,1,43,120,163
2011-09-12,0,Sep,14,0,Mon,1,60,129,189
2011-09-12,0,Sep,15,0,Mon,1,60,152,212
2011-09-12,0,Sep,16,0,Mon,1,60,238,298
2011-09-12,0,Sep,17,0,Mon,1,75,515,590
2011-09-12,0,Sep,18,0,Mon,1,56,515,571
2011-09-12,0,Sep,19,0,Mon,1,63,373,436
2011-09-12,0,Sep,20,0,Mon,1,41,258,299
2011-09-12,0,Sep,21,0,Mon,1,29,166,195
2011-09-12,0,Sep,22,0,Mon,1,16,134,150
2011-09-12,0,Sep,23,0,Mon,1,7,62,69
2011-09-13,0,Sep,0,0,Tue,1,7,19,26
2011-09-13,0,Sep,1,0,Tue,1,4,6,10
2011-09-13,0,Sep,2,0,Tue,1,2,0,2
2011-09-13,0,Sep,3,0,Tue,1,2,2,4
2011-09-13,0,Sep,4,0,Tue,1,2,6,8
2011-09-13,0,Sep,5,0,Tue,1,1,19,20
2011-09-13,0,Sep,6,0,Tue,1,6,116,122
2011-09-13,0,Sep,7,0,Tue,1,14,348,362
2011-09-13,0,Sep,8,0,Tue,1,26,399,425
2011-09-13,0,Sep,9,0,Tue,1,35,179,214
2011-09-13,0,Sep,10,0,Tue,1,42,93,135
2011-09-13,0,Sep,11,0,Tue,1,33,120,153
2011-09-13,0,Sep,12,0,Tue,1,43,144,187
2011-09-13,0,Sep,13,0,Tue,1,48,136,184
2011-09-13,0,Sep,14,0,Tue,1,51,139,190
2011-09-13,0,Sep,15,0,Tue,1,35,145,180
2011-09-13,0,Sep,16,0,Tue,1,41,251,292
2011-09-13,0,Sep,17,0,Tue,1,72,507,579
2011-09-13,0,Sep,18,0,Tue,1,67,472,539
2011-09-13,0,Sep,19,0,Tue,1,55,341,396
2011-09-13,0,Sep,20,0,Tue,1,31,241,272
2011-09-13,0,Sep,21,0,Tue,1,45,200,245
2011-09-13,0,Sep,22,0,Tue,1,24,120,144
2011-09-13,0,Sep,23,0,Tue,1,15,59,74
2011-09-14,0,Sep,0,0,Wed,1,5,28,33
2011-09-14,0,Sep,1,0,Wed,1,1,7,8
2011-09-14,0,Sep,2,0,Wed,1,1,4,5
2011-09-14,0,Sep,3,0,Wed,1,1,7,8
2011-09-14,0,Sep,4,0,Wed,1,1,8,9
2011-09-14,0,Sep,5,0,Wed,1,1,30,31
2011-09-14,0,Sep,6,0,Wed,1,7,138,145
2011-09-14,0,Sep,7,0,Wed,1,20,350,370
2011-09-14,0,Sep,8,0,Wed,1,33,396,429
2011-09-14,0,Sep,9,0,Wed,1,19,183,202
2011-09-14,0,Sep,10,0,Wed,1,27,115,142
2011-09-14,0,Sep,11,0,Wed,1,43,121,164
2011-09-14,0,Sep,12,0,Wed,1,56,156,212
2011-09-14,0,Sep,13,0,Wed,1,39,139,178
2011-09-14,0,Sep,14,0,Wed,1,19,105,124
2011-09-14,0,Sep,15,0,Wed,1,30,146,176
2011-09-14,0,Sep,16,0,Wed,1,36,241,277
2011-09-14,0,Sep,17,0,Wed,1,87,512,599
2011-09-14,0,Sep,18,0,Wed,1,83,503,586
2011-09-14,0,Sep,19,0,Wed,1,44,337,381
2011-09-14,0,Sep,20,0,Wed,1,40,221,261
2011-09-14,0,Sep,21,0,Wed,1,24,189,213
2011-09-14,0,Sep,22,0,Wed,1,20,140,160
2011-09-14,0,Sep,23,0,Wed,1,10,62,72
2011-09-15,0,Sep,0,0,Thur,1,3,34,37
2011-09-15,0,Sep,1,0,Thur,1,0,20,20
2011-09-15,0,Sep,2,0,Thur,1,0,5,5
2011-09-15,0,Sep,3,0,Thur,1,3,5,8
2011-09-15,0,Sep,4,0,Thur,1,2,5,7
2011-09-15,0,Sep,5,0,Thur,1,1,30,31
2011-09-15,0,Sep,6,0,Thur,1,5,119,124
2011-09-15,0,Sep,7,0,Thur,1,17,321,338
2011-09-15,0,Sep,8,0,Thur,1,27,364,391
2011-09-15,0,Sep,9,0,Thur,1,23,186,209
2011-09-15,0,Sep,10,0,Thur,1,25,96,121
2011-09-15,0,Sep,11,0,Thur,1,39,120,159
2011-09-15,0,Sep,12,0,Thur,1,31,148,179
2011-09-15,0,Sep,13,0,Thur,1,38,151,189
2011-09-15,0,Sep,14,0,Thur,1,36,134,170
2011-09-15,0,Sep,15,0,Thur,1,25,110,135
2011-09-15,0,Sep,16,0,Thur,1,29,193,222
2011-09-15,0,Sep,17,0,Thur,1,31,230,261
2011-09-15,0,Sep,18,0,Thur,1,22,222,244
2011-09-15,0,Sep,19,0,Thur,1,20,212,232
2011-09-15,0,Sep,20,0,Thur,1,25,223,248
2011-09-15,0,Sep,21,0,Thur,1,11,134,145
2011-09-15,0,Sep,22,0,Thur,1,7,108,115
2011-09-15,0,Sep,23,0,Thur,1,8,61,69
2011-09-16,0,Sep,0,0,Fri,1,5,43,48
2011-09-16,0,Sep,1,0,Fri,1,7,19,26
2011-09-16,0,Sep,2,0,Fri,1,3,7,10
2011-09-16,0,Sep,3,0,Fri,1,2,4,6
2011-09-16,0,Sep,4,0,Fri,1,1,3,4
2011-09-16,0,Sep,5,0,Fri,1,2,30,32
2011-09-16,0,Sep,6,0,Fri,1,6,87,93
2011-09-16,0,Sep,7,0,Fri,1,16,283,299
2011-09-16,0,Sep,8,0,Fri,1,23,386,409
2011-09-16,0,Sep,9,0,Fri,1,21,189,210
2011-09-16,0,Sep,10,0,Fri,1,36,104,140
2011-09-16,0,Sep,11,0,Fri,1,40,139,179
2011-09-16,0,Sep,12,0,Fri,1,39,212,251
2011-09-16,0,Sep,13,0,Fri,1,55,168,223
2011-09-16,0,Sep,14,0,Fri,1,49,176,225
2011-09-16,0,Sep,15,0,Fri,1,38,165,203
2011-09-16,0,Sep,16,0,Fri,1,67,291,358
2011-09-16,0,Sep,17,0,Fri,1,86,480,566
2011-09-16,0,Sep,18,0,Fri,1,55,427,482
2011-09-16,0,Sep,19,0,Fri,1,59,256,315
2011-09-16,0,Sep,20,0,Fri,1,41,184,225
2011-09-16,0,Sep,21,0,Fri,1,39,124,163
2011-09-16,0,Sep,22,0,Fri,1,32,135,167
2011-09-16,0,Sep,23,0,Fri,1,20,106,126
2011-09-17,0,Sep,0,0,Sat,0,28,80,108
2011-09-17,0,Sep,1,0,Sat,0,28,52,80
2011-09-17,0,Sep,2,0,Sat,0,18,61,79
2011-09-17,0,Sep,3,0,Sat,0,7,21,28
2011-09-17,0,Sep,4,0,Sat,0,1,4,5
2011-09-17,0,Sep,5,0,Sat,0,2,3,5
2011-09-17,0,Sep,6,0,Sat,0,5,17,22
2011-09-17,0,Sep,7,0,Sat,0,4,33,37
2011-09-17,0,Sep,8,0,Sat,0,27,81,108
2011-09-17,0,Sep,9,0,Sat,0,32,145,177
2011-09-17,0,Sep,10,0,Sat,0,72,177,249
2011-09-17,0,Sep,11,0,Sat,0,119,248,367
2011-09-17,0,Sep,12,0,Sat,0,115,257,372
2011-09-17,0,Sep,13,0,Sat,0,124,225,349
2011-09-17,0,Sep,14,0,Sat,0,123,174,297
2011-09-17,0,Sep,15,0,Sat,0,148,206,354
2011-09-17,0,Sep,16,0,Sat,0,116,189,305
2011-09-17,0,Sep,17,0,Sat,0,141,218,359
2011-09-17,0,Sep,18,0,Sat,0,95,234,329
2011-09-17,0,Sep,19,0,Sat,0,70,186,256
2011-09-17,0,Sep,20,0,Sat,0,43,133,176
2011-09-17,0,Sep,21,0,Sat,0,49,121,170
2011-09-17,0,Sep,22,0,Sat,0,31,112,143
2011-09-17,0,Sep,23,0,Sat,0,36,100,136
2011-09-18,0,Sep,0,0,Sun,0,24,88,112
2011-09-18,0,Sep,1,0,Sun,0,13,66,79
2011-09-18,0,Sep,2,0,Sun,0,21,68,89
2011-09-18,0,Sep,3,0,Sun,0,11,25,36
2011-09-18,0,Sep,4,0,Sun,0,1,0,1
2011-09-18,0,Sep,5,0,Sun,0,1,5,6
2011-09-18,0,Sep,6,0,Sun,0,2,10,12
2011-09-18,0,Sep,7,0,Sun,0,15,29,44
2011-09-18,0,Sep,8,0,Sun,0,16,53,69
2011-09-18,0,Sep,9,0,Sun,0,46,94,140
2011-09-18,0,Sep,10,0,Sun,0,82,178,260
2011-09-18,0,Sep,11,0,Sun,0,116,201,317
2011-09-18,0,Sep,12,0,Sun,0,135,229,364
2011-09-18,0,Sep,13,0,Sun,0,162,214,376
2011-09-18,0,Sep,14,0,Sun,0,127,184,311
2011-09-18,0,Sep,15,0,Sun,0,132,233,365
2011-09-18,0,Sep,16,0,Sun,0,134,235,369
2011-09-18,0,Sep,17,0,Sun,0,95,230,325
2011-09-18,0,Sep,18,0,Sun,0,66,223,289
2011-09-18,0,Sep,19,0,Sun,0,54,191,245
2011-09-18,0,Sep,20,0,Sun,0,44,136,180
2011-09-18,0,Sep,21,0,Sun,0,37,110,147
2011-09-18,0,Sep,22,0,Sun,0,9,75,84
2011-09-18,0,Sep,23,0,Sun,0,10,44,54
2011-09-19,0,Sep,0,0,Mon,1,14,23,37
2011-09-19,0,Sep,1,0,Mon,1,3,7,10
2011-09-19,0,Sep,2,0,Mon,1,6,7,13
2011-09-19,0,Sep,3,0,Mon,1,1,4,5
2011-09-19,0,Sep,4,0,Mon,1,2,6,8
2011-09-19,0,Sep,5,0,Mon,1,2,26,28
2011-09-19,0,Sep,6,0,Mon,1,6,107,113
2011-09-19,0,Sep,7,0,Mon,1,20,312,332
2011-09-19,0,Sep,8,0,Mon,1,29,391,420
2011-09-19,0,Sep,9,0,Mon,1,32,183,215
2011-09-19,0,Sep,10,0,Mon,1,21,84,105
2011-09-19,0,Sep,11,0,Mon,1,41,98,139
2011-09-19,0,Sep,12,0,Mon,1,51,138,189
2011-09-19,0,Sep,13,0,Mon,1,53,124,177
2011-09-19,0,Sep,14,0,Mon,1,45,143,188
2011-09-19,0,Sep,15,0,Mon,1,44,143,187
2011-09-19,0,Sep,16,0,Mon,1,55,208,263
2011-09-19,0,Sep,17,0,Mon,1,85,483,568
2011-09-19,0,Sep,18,0,Mon,1,56,484,540
2011-09-19,0,Sep,19,0,Mon,1,41,333,374
2011-09-19,0,Sep,20,0,Mon,1,27,204,231
2011-09-19,0,Sep,21,0,Mon,1,19,181,200
2011-09-19,0,Sep,22,0,Mon,1,25,104,129
2011-09-19,0,Sep,23,0,Mon,1,13,55,68
2011-09-20,0,Sep,0,0,Tue,1,4,21,25
2011-09-20,0,Sep,1,0,Tue,1,3,11,14
2011-09-20,0,Sep,2,0,Tue,1,1,4,5
2011-09-20,0,Sep,3,0,Tue,1,0,3,3
2011-09-20,0,Sep,4,0,Tue,1,2,4,6
2011-09-20,0,Sep,5,0,Tue,1,1,21,22
2011-09-20,0,Sep,6,0,Tue,1,3,111,114
2011-09-20,0,Sep,7,0,Tue,1,23,306,329
2011-09-20,0,Sep,8,0,Tue,1,13,196,209
2011-09-20,0,Sep,9,0,Tue,1,5,64,69
2011-09-20,0,Sep,10,0,Tue,1,4,26,30
2011-09-20,0,Sep,11,0,Tue,1,8,48,56
2011-09-20,0,Sep,12,0,Tue,1,13,47,60
2011-09-20,0,Sep,13,0,Tue,1,22,81,103
2011-09-20,0,Sep,14,0,Tue,1,27,85,112
2011-09-20,0,Sep,15,0,Tue,1,34,158,192
2011-09-20,0,Sep,16,0,Tue,1,23,241,264
2011-09-20,0,Sep,17,0,Tue,1,66,445,511
2011-09-20,0,Sep,18,0,Tue,1,39,453,492
2011-09-20,0,Sep,19,0,Tue,1,43,294,337
2011-09-20,0,Sep,20,0,Tue,1,41,212,253
2011-09-20,0,Sep,21,0,Tue,1,29,177,206
2011-09-20,0,Sep,22,0,Tue,1,23,125,148
2011-09-20,0,Sep,23,0,Tue,1,11,70,81
2011-09-21,0,Sep,0,0,Wed,1,7,20,27
2011-09-21,0,Sep,1,0,Wed,1,0,17,17
2011-09-21,0,Sep,2,0,Wed,1,1,5,6
2011-09-21,0,Sep,3,0,Wed,1,0,6,6
2011-09-21,0,Sep,4,0,Wed,1,2,5,7
2011-09-21,0,Sep,5,0,Wed,1,1,30,31
2011-09-21,0,Sep,6,0,Wed,1,5,112,117
2011-09-21,0,Sep,7,0,Wed,1,18,312,330
2011-09-21,0,Sep,8,0,Wed,1,18,444,462
2011-09-21,0,Sep,9,0,Wed,1,21,187,208
2011-09-21,0,Sep,10,0,Wed,1,30,103,133
2011-09-21,0,Sep,11,0,Wed,1,42,138,180
2011-09-21,0,Sep,12,0,Wed,1,42,151,193
2011-09-21,0,Sep,13,0,Wed,1,37,144,181
2011-09-21,0,Sep,14,0,Wed,1,40,139,179
2011-09-21,0,Sep,15,0,Wed,1,43,142,185
2011-09-21,0,Sep,16,0,Wed,1,51,230,281
2011-09-21,0,Sep,17,0,Wed,1,61,475,536
2011-09-21,0,Sep,18,0,Wed,1,24,384,408
2011-09-21,0,Sep,19,0,Wed,1,30,253,283
2011-09-21,0,Sep,20,0,Wed,1,11,149,160
2011-09-21,0,Sep,21,0,Wed,1,25,175,200
2011-09-21,0,Sep,22,0,Wed,1,15,112,127
2011-09-21,0,Sep,23,0,Wed,1,15,80,95
2011-09-22,0,Sep,0,0,Thur,1,11,30,41
2011-09-22,0,Sep,1,0,Thur,1,5,6,11
2011-09-22,0,Sep,2,0,Thur,1,2,8,10
2011-09-22,0,Sep,3,0,Thur,1,5,7,12
2011-09-22,0,Sep,4,0,Thur,1,0,2,2
2011-09-22,0,Sep,5,0,Thur,1,2,28,30
2011-09-22,0,Sep,6,0,Thur,1,7,94,101
2011-09-22,0,Sep,7,0,Thur,1,16,295,311
2011-09-22,0,Sep,8,0,Thur,1,26,389,415
2011-09-22,0,Sep,9,0,Thur,1,35,168,203
2011-09-22,0,Sep,10,0,Thur,1,19,101,120
2011-09-22,0,Sep,11,0,Thur,1,23,142,165
2011-09-22,0,Sep,12,0,Thur,1,25,151,176
2011-09-22,0,Sep,13,0,Thur,1,38,155,193
2011-09-22,0,Sep,14,0,Thur,1,41,142,183
2011-09-22,0,Sep,15,0,Thur,1,32,149,181
2011-09-22,0,Sep,16,0,Thur,1,39,262,301
2011-09-22,0,Sep,17,0,Thur,1,50,513,563
2011-09-22,0,Sep,18,0,Thur,1,50,501,551
2011-09-22,0,Sep,19,0,Thur,1,32,388,420
2011-09-22,0,Sep,20,0,Thur,1,35,250,285
2011-09-22,0,Sep,21,0,Thur,1,27,194,221
2011-09-22,0,Sep,22,0,Thur,1,21,166,187
2011-09-22,0,Sep,23,0,Thur,1,14,99,113
2011-09-23,0,Sep,0,0,Fri,1,11,41,52
2011-09-23,0,Sep,1,0,Fri,1,2,29,31
2011-09-23,0,Sep,2,0,Fri,1,6,14,20
2011-09-23,0,Sep,3,0,Fri,1,3,5,8
2011-09-23,0,Sep,4,0,Fri,1,6,7,13
2011-09-23,0,Sep,5,0,Fri,1,2,20,22
2011-09-23,0,Sep,6,0,Fri,1,5,99,104
2011-09-23,0,Sep,7,0,Fri,1,14,240,254
2011-09-23,0,Sep,8,0,Fri,1,20,297,317
2011-09-23,0,Sep,9,0,Fri,1,3,108,111
2011-09-23,0,Sep,10,0,Fri,1,7,28,35
2011-09-23,0,Sep,11,0,Fri,1,1,20,21
2011-09-23,0,Sep,12,0,Fri,1,1,28,29
2011-09-23,0,Sep,13,0,Fri,1,7,27,34
2011-09-23,0,Sep,14,0,Fri,1,3,21,24
2011-09-23,0,Sep,15,0,Fri,1,9,52,61
2011-09-23,0,Sep,16,0,Fri,1,5,51,56
2011-09-23,0,Sep,17,0,Fri,1,13,86,99
2011-09-23,0,Sep,18,0,Fri,1,14,220,234
2011-09-23,0,Sep,19,0,Fri,1,16,232,248
2011-09-23,0,Sep,20,0,Fri,1,21,158,179
2011-09-23,0,Sep,21,0,Fri,1,17,121,138
2011-09-23,0,Sep,22,0,Fri,1,31,126,157
2011-09-23,0,Sep,23,0,Fri,1,41,107,148
2011-09-24,0,Sep,0,0,Sat,0,7,86,93
2011-09-24,0,Sep,1,0,Sat,0,18,61,79
2011-09-24,0,Sep,2,0,Sat,0,14,54,68
2011-09-24,0,Sep,3,0,Sat,0,4,27,31
2011-09-24,0,Sep,4,0,Sat,0,1,7,8
2011-09-24,0,Sep,5,0,Sat,0,2,3,5
2011-09-24,0,Sep,6,0,Sat,0,6,12,18
2011-09-24,0,Sep,7,0,Sat,0,12,34,46
2011-09-24,0,Sep,8,0,Sat,0,19,102,121
2011-09-24,0,Sep,9,0,Sat,0,41,134,175
2011-09-24,0,Sep,10,0,Sat,0,90,203,293
2011-09-24,0,Sep,11,0,Sat,0,118,268,386
2011-09-24,0,Sep,12,0,Sat,0,141,266,407
2011-09-24,0,Sep,13,0,Sat,0,170,290,460
2011-09-24,0,Sep,14,0,Sat,0,164,226,390
2011-09-24,0,Sep,15,0,Sat,0,168,284,452
2011-09-24,0,Sep,16,0,Sat,0,167,282,449
2011-09-24,0,Sep,17,0,Sat,0,180,246,426
2011-09-24,0,Sep,18,0,Sat,0,157,243,400
2011-09-24,0,Sep,19,0,Sat,0,77,231,308
2011-09-24,0,Sep,20,0,Sat,0,77,166,243
2011-09-24,0,Sep,21,0,Sat,0,66,156,222
2011-09-24,0,Sep,22,0,Sat,0,50,143,193
2011-09-24,0,Sep,23,0,Sat,0,27,123,150
2011-09-25,0,Sep,0,0,Sun,0,37,136,173
2011-09-25,0,Sep,1,0,Sun,0,31,93,124
2011-09-25,0,Sep,2,0,Sun,0,27,79,106
2011-09-25,0,Sep,3,0,Sun,0,20,39,59
2011-09-25,0,Sep,4,0,Sun,0,3,5,8
2011-09-25,0,Sep,5,0,Sun,0,1,2,3
2011-09-25,0,Sep,6,0,Sun,0,4,13,17
2011-09-25,0,Sep,7,0,Sun,0,15,23,38
2011-09-25,0,Sep,8,0,Sun,0,27,59,86
2011-09-25,0,Sep,9,0,Sun,0,55,100,155
2011-09-25,0,Sep,10,0,Sun,0,85,190,275
2011-09-25,0,Sep,11,0,Sun,0,131,230,361
2011-09-25,0,Sep,12,0,Sun,0,143,270,413
2011-09-25,0,Sep,13,0,Sun,0,122,247,369
2011-09-25,0,Sep,14,0,Sun,0,116,231,347
2011-09-25,0,Sep,15,0,Sun,0,119,234,353
2011-09-25,0,Sep,16,0,Sun,0,144,320,464
2011-09-25,0,Sep,17,0,Sun,0,145,275,420
2011-09-25,0,Sep,18,0,Sun,0,125,279,404
2011-09-25,0,Sep,19,0,Sun,0,87,242,329
2011-09-25,0,Sep,20,0,Sun,0,51,135,186
2011-09-25,0,Sep,21,0,Sun,0,24,113,137
2011-09-25,0,Sep,22,0,Sun,0,20,84,104
2011-09-25,0,Sep,23,0,Sun,0,12,67,79
2011-09-26,0,Sep,0,0,Mon,1,6,23,29
2011-09-26,0,Sep,1,0,Mon,1,3,14,17
2011-09-26,0,Sep,2,0,Mon,1,4,4,8
2011-09-26,0,Sep,3,0,Mon,1,0,5,5
2011-09-26,0,Sep,4,0,Mon,1,2,4,6
2011-09-26,0,Sep,5,0,Mon,1,0,25,25
2011-09-26,0,Sep,6,0,Mon,1,6,107,113
2011-09-26,0,Sep,7,0,Mon,1,17,315,332
2011-09-26,0,Sep,8,0,Mon,1,29,326,355
2011-09-26,0,Sep,9,0,Mon,1,44,161,205
2011-09-26,0,Sep,10,0,Mon,1,37,117,154
2011-09-26,0,Sep,11,0,Mon,1,43,116,159
2011-09-26,0,Sep,12,0,Mon,1,48,161,209
2011-09-26,0,Sep,13,0,Mon,1,48,139,187
2011-09-26,0,Sep,14,0,Mon,1,44,110,154
2011-09-26,0,Sep,15,0,Mon,1,52,157,209
2011-09-26,0,Sep,16,0,Mon,1,74,239,313
2011-09-26,0,Sep,17,0,Mon,1,61,509,570
2011-09-26,0,Sep,18,0,Mon,1,63,490,553
2011-09-26,0,Sep,19,0,Mon,1,36,347,383
2011-09-26,0,Sep,20,0,Mon,1,24,227,251
2011-09-26,0,Sep,21,0,Mon,1,18,164,182
2011-09-26,0,Sep,22,0,Mon,1,14,122,136
2011-09-26,0,Sep,23,0,Mon,1,11,64,75
2011-09-27,0,Sep,0,0,Tue,1,9,28,37
2011-09-27,0,Sep,1,0,Tue,1,4,6,10
2011-09-27,0,Sep,2,0,Tue,1,7,4,11
2011-09-27,0,Sep,3,0,Tue,1,5,5,10
2011-09-27,0,Sep,4,0,Tue,1,5,3,8
2011-09-27,0,Sep,5,0,Tue,1,0,24,24
2011-09-27,0,Sep,6,0,Tue,1,8,116,124
2011-09-27,0,Sep,7,0,Tue,1,15,234,249
2011-09-27,0,Sep,8,0,Tue,1,27,400,427
2011-09-27,0,Sep,9,0,Tue,1,20,173,193
2011-09-27,0,Sep,10,0,Tue,1,21,101,122
2011-09-27,0,Sep,11,0,Tue,1,26,97,123
2011-09-27,0,Sep,12,0,Tue,1,33,129,162
2011-09-27,0,Sep,13,0,Tue,1,29,122,151
2011-09-27,0,Sep,14,0,Tue,1,29,123,152
2011-09-27,0,Sep,15,0,Tue,1,35,170,205
2011-09-27,0,Sep,16,0,Tue,1,33,225,258
2011-09-27,0,Sep,17,0,Tue,1,50,480,530
2011-09-27,0,Sep,18,0,Tue,1,31,325,356
2011-09-27,0,Sep,19,0,Tue,1,26,294,320
2011-09-27,0,Sep,20,0,Tue,1,17,221,238
2011-09-27,0,Sep,21,0,Tue,1,17,179,196
2011-09-27,0,Sep,22,0,Tue,1,19,102,121
2011-09-27,0,Sep,23,0,Tue,1,11,82,93
2011-09-28,0,Sep,0,0,Wed,1,7,29,36
2011-09-28,0,Sep,1,0,Wed,1,1,13,14
2011-09-28,0,Sep,2,0,Wed,1,0,9,9
2011-09-28,0,Sep,3,0,Wed,1,0,3,3
2011-09-28,0,Sep,4,0,Wed,1,1,3,4
2011-09-28,0,Sep,5,0,Wed,1,2,20,22
2011-09-28,0,Sep,6,0,Wed,1,3,111,114
2011-09-28,0,Sep,7,0,Wed,1,8,177,185
2011-09-28,0,Sep,8,0,Wed,1,17,270,287
2011-09-28,0,Sep,9,0,Wed,1,14,141,155
2011-09-28,0,Sep,10,0,Wed,1,20,109,129
2011-09-28,0,Sep,11,0,Wed,1,24,127,151
2011-09-28,0,Sep,12,0,Wed,1,25,159,184
2011-09-28,0,Sep,13,0,Wed,1,24,138,162
2011-09-28,0,Sep,14,0,Wed,1,25,145,170
2011-09-28,0,Sep,15,0,Wed,1,35,146,181
2011-09-28,0,Sep,16,0,Wed,1,39,241,280
2011-09-28,0,Sep,17,0,Wed,1,64,527,591
2011-09-28,0,Sep,18,0,Wed,1,65,459,524
2011-09-28,0,Sep,19,0,Wed,1,57,315,372
2011-09-28,0,Sep,20,0,Wed,1,11,91,102
2011-09-28,0,Sep,21,0,Wed,1,7,67,74
2011-09-28,0,Sep,22,0,Wed,1,19,68,87
2011-09-28,0,Sep,23,0,Wed,1,12,59,71
2011-09-29,0,Sep,0,0,Thur,1,7,33,40
2011-09-29,0,Sep,1,0,Thur,1,3,20,23
2011-09-29,0,Sep,2,0,Thur,1,0,2,2
2011-09-29,0,Sep,3,0,Thur,1,0,8,8
2011-09-29,0,Sep,4,0,Thur,1,2,5,7
2011-09-29,0,Sep,5,0,Thur,1,0,22,22
2011-09-29,0,Sep,6,0,Thur,1,5,106,111
2011-09-29,0,Sep,7,0,Thur,1,14,269,283
2011-09-29,0,Sep,8,0,Thur,1,29,402,431
2011-09-29,0,Sep,9,0,Thur,1,27,198,225
2011-09-29,0,Sep,10,0,Thur,1,24,103,127
2011-09-29,0,Sep,11,0,Thur,1,36,122,158
2011-09-29,0,Sep,12,0,Thur,1,38,157,195
2011-09-29,0,Sep,13,0,Thur,1,36,175,211
2011-09-29,0,Sep,14,0,Thur,1,33,134,167
2011-09-29,0,Sep,15,0,Thur,1,42,185,227
2011-09-29,0,Sep,16,0,Thur,1,64,227,291
2011-09-29,0,Sep,17,0,Thur,1,62,527,589
2011-09-29,0,Sep,18,0,Thur,1,84,500,584
2011-09-29,0,Sep,19,0,Thur,1,36,348,384
2011-09-29,0,Sep,20,0,Thur,1,39,234,273
2011-09-29,0,Sep,21,0,Thur,1,30,195,225
2011-09-29,0,Sep,22,0,Thur,1,25,150,175
2011-09-29,0,Sep,23,0,Thur,1,17,64,81
2011-09-30,0,Sep,0,0,Fri,1,7,53,60
2011-09-30,0,Sep,1,0,Fri,1,5,18,23
2011-09-30,0,Sep,2,0,Fri,1,6,9,15
2011-09-30,0,Sep,3,0,Fri,1,0,3,3
2011-09-30,0,Sep,4,0,Fri,1,2,6,8
2011-09-30,0,Sep,5,0,Fri,1,3,23,26
2011-09-30,0,Sep,6,0,Fri,1,0,98,98
2011-09-30,0,Sep,7,0,Fri,1,14,283,297
2011-09-30,0,Sep,8,0,Fri,1,31,425,456
2011-09-30,0,Sep,9,0,Fri,1,23,214,237
2011-09-30,0,Sep,10,0,Fri,1,46,122,168
2011-09-30,0,Sep,11,0,Fri,1,49,168,217
2011-09-30,0,Sep,12,0,Fri,1,59,195,254
2011-09-30,0,Sep,13,0,Fri,1,72,194,266
2011-09-30,0,Sep,14,0,Fri,1,93,173,266
2011-09-30,0,Sep,15,0,Fri,1,52,193,245
2011-09-30,0,Sep,16,0,Fri,1,62,298,360
2011-09-30,0,Sep,17,0,Fri,1,94,497,591
2011-09-30,0,Sep,18,0,Fri,1,62,449,511
2011-09-30,0,Sep,19,0,Fri,1,42,332,374
2011-09-30,0,Sep,20,0,Fri,1,28,202,230
2011-09-30,0,Sep,21,0,Fri,1,27,179,206
2011-09-30,0,Sep,22,0,Fri,1,30,129,159
2011-09-30,0,Sep,23,0,Fri,1,23,109,132
2011-10-01,0,Oct,0,0,Sat,0,24,106,130
2011-10-01,0,Oct,1,0,Sat,0,11,47,58
2011-10-01,0,Oct,2,0,Sat,0,21,46,67
2011-10-01,0,Oct,3,0,Sat,0,8,17,25
2011-10-01,0,Oct,4,0,Sat,0,2,6,8
2011-10-01,0,Oct,5,0,Sat,0,1,4,5
2011-10-01,0,Oct,6,0,Sat,0,4,15,19
2011-10-01,0,Oct,7,0,Sat,0,6,30,36
2011-10-01,0,Oct,8,0,Sat,0,9,58,67
2011-10-01,0,Oct,9,0,Sat,0,17,112,129
2011-10-01,0,Oct,10,0,Sat,0,21,100,121
2011-10-01,0,Oct,11,0,Sat,0,30,102,132
2011-10-01,0,Oct,12,0,Sat,0,28,130,158
2011-10-01,0,Oct,13,0,Sat,0,27,98,125
2011-10-01,0,Oct,14,0,Sat,0,33,147,180
2011-10-01,0,Oct,15,0,Sat,0,41,154,195
2011-10-01,0,Oct,16,0,Sat,0,58,165,223
2011-10-01,0,Oct,17,0,Sat,0,58,170,228
2011-10-01,0,Oct,18,0,Sat,0,23,117,140
2011-10-01,0,Oct,19,0,Sat,0,27,99,126
2011-10-01,0,Oct,20,0,Sat,0,8,58,66
2011-10-01,0,Oct,21,0,Sat,0,3,53,56
2011-10-01,0,Oct,22,0,Sat,0,12,58,70
2011-10-01,0,Oct,23,0,Sat,0,8,57,65
2011-10-02,0,Oct,0,0,Sun,0,4,43,47
2011-10-02,0,Oct,1,0,Sun,0,1,23,24
2011-10-02,0,Oct,2,0,Sun,0,3,27,30
2011-10-02,0,Oct,3,0,Sun,0,4,5,9
2011-10-02,0,Oct,4,0,Sun,0,4,3,7
2011-10-02,0,Oct,5,0,Sun,0,0,7,7
2011-10-02,0,Oct,6,0,Sun,0,2,13,15
2011-10-02,0,Oct,7,0,Sun,0,5,24,29
2011-10-02,0,Oct,8,0,Sun,0,14,50,64
2011-10-02,0,Oct,9,0,Sun,0,19,96,115
2011-10-02,0,Oct,10,0,Sun,0,60,188,248
2011-10-02,0,Oct,11,0,Sun,0,74,218,292
2011-10-02,0,Oct,12,0,Sun,0,78,243,321
2011-10-02,0,Oct,13,0,Sun,0,84,224,308
2011-10-02,0,Oct,14,0,Sun,0,61,195,256
2011-10-02,0,Oct,15,0,Sun,0,29,144,173
2011-10-02,0,Oct,16,0,Sun,0,44,162,206
2011-10-02,0,Oct,17,0,Sun,0,32,135,167
2011-10-02,0,Oct,18,0,Sun,0,16,158,174
2011-10-02,0,Oct,19,0,Sun,0,34,128,162
2011-10-02,0,Oct,20,0,Sun,0,16,71,87
2011-10-02,0,Oct,21,0,Sun,0,17,71,88
2011-10-02,0,Oct,22,0,Sun,0,9,55,64
2011-10-02,0,Oct,23,0,Sun,0,6,19,25
2011-10-03,0,Oct,0,0,Mon,1,3,13,16
2011-10-03,0,Oct,1,0,Mon,1,1,5,6
2011-10-03,0,Oct,2,0,Mon,1,0,4,4
2011-10-03,0,Oct,3,0,Mon,1,1,6,7
2011-10-03,0,Oct,4,0,Mon,1,2,6,8
2011-10-03,0,Oct,5,0,Mon,1,4,17,21
2011-10-03,0,Oct,6,0,Mon,1,3,91,94
2011-10-03,0,Oct,7,0,Mon,1,8,241,249
2011-10-03,0,Oct,8,0,Mon,1,13,359,372
2011-10-03,0,Oct,9,0,Mon,1,12,141,153
2011-10-03,0,Oct,10,0,Mon,1,19,82,101
2011-10-03,0,Oct,11,0,Mon,1,26,100,126
2011-10-03,0,Oct,12,0,Mon,1,29,118,147
2011-10-03,0,Oct,13,0,Mon,1,16,102,118
2011-10-03,0,Oct,14,0,Mon,1,26,94,120
2011-10-03,0,Oct,15,0,Mon,1,22,79,101
2011-10-03,0,Oct,16,0,Mon,1,16,202,218
2011-10-03,0,Oct,17,0,Mon,1,40,455,495
2011-10-03,0,Oct,18,0,Mon,1,28,384,412
2011-10-03,0,Oct,19,0,Mon,1,15,300,315
2011-10-03,0,Oct,20,0,Mon,1,13,191,204
2011-10-03,0,Oct,21,0,Mon,1,10,128,138
2011-10-03,0,Oct,22,0,Mon,1,12,79,91
2011-10-03,0,Oct,23,0,Mon,1,11,43,54
2011-10-04,0,Oct,0,0,Tue,1,5,22,27
2011-10-04,0,Oct,1,0,Tue,1,1,8,9
2011-10-04,0,Oct,2,0,Tue,1,1,2,3
2011-10-04,0,Oct,3,0,Tue,1,3,3,6
2011-10-04,0,Oct,4,0,Tue,1,3,4,7
2011-10-04,0,Oct,5,0,Tue,1,2,25,27
2011-10-04,0,Oct,6,0,Tue,1,3,109,112
2011-10-04,0,Oct,7,0,Tue,1,11,298,309
2011-10-04,0,Oct,8,0,Tue,1,28,372,400
2011-10-04,0,Oct,9,0,Tue,1,19,168,187
2011-10-04,0,Oct,10,0,Tue,1,19,107,126
2011-10-04,0,Oct,11,0,Tue,1,22,102,124
2011-10-04,0,Oct,12,0,Tue,1,39,160,199
2011-10-04,0,Oct,13,0,Tue,1,20,153,173
2011-10-04,0,Oct,14,0,Tue,1,27,156,183
2011-10-04,0,Oct,15,0,Tue,1,28,166,194
2011-10-04,0,Oct,16,0,Tue,1,36,273,309
2011-10-04,0,Oct,17,0,Tue,1,55,530,585
2011-10-04,0,Oct,18,0,Tue,1,68,456,524
2011-10-04,0,Oct,19,0,Tue,1,35,310,345
2011-10-04,0,Oct,20,0,Tue,1,25,236,261
2011-10-04,0,Oct,21,0,Tue,1,22,144,166
2011-10-04,0,Oct,22,0,Tue,1,8,106,114
2011-10-04,0,Oct,23,0,Tue,1,6,60,66
2011-10-05,0,Oct,0,0,Wed,1,7,36,43
2011-10-05,0,Oct,1,0,Wed,1,4,7,11
2011-10-05,0,Oct,2,0,Wed,1,1,2,3
2011-10-05,0,Oct,3,0,Wed,1,1,5,6
2011-10-05,0,Oct,4,0,Wed,1,1,4,5
2011-10-05,0,Oct,5,0,Wed,1,3,29,32
2011-10-05,0,Oct,6,0,Wed,1,5,112,117
2011-10-05,0,Oct,7,0,Wed,1,9,292,301
2011-10-05,0,Oct,8,0,Wed,1,26,441,467
2011-10-05,0,Oct,9,0,Wed,1,32,187,219
2011-10-05,0,Oct,10,0,Wed,1,30,103,133
2011-10-05,0,Oct,11,0,Wed,1,32,138,170
2011-10-05,0,Oct,12,0,Wed,1,34,180,214
2011-10-05,0,Oct,13,0,Wed,1,30,189,219
2011-10-05,0,Oct,14,0,Wed,1,34,156,190
2011-10-05,0,Oct,15,0,Wed,1,35,147,182
2011-10-05,0,Oct,16,0,Wed,1,37,245,282
2011-10-05,0,Oct,17,0,Wed,1,66,525,591
2011-10-05,0,Oct,18,0,Wed,1,57,536,593
2011-10-05,0,Oct,19,0,Wed,1,40,334,374
2011-10-05,0,Oct,20,0,Wed,1,18,228,246
2011-10-05,0,Oct,21,0,Wed,1,28,173,201
2011-10-05,0,Oct,22,0,Wed,1,20,134,154
2011-10-05,0,Oct,23,0,Wed,1,9,64,73
2011-10-06,0,Oct,0,0,Thur,1,6,34,40
2011-10-06,0,Oct,1,0,Thur,1,5,17,22
2011-10-06,0,Oct,2,0,Thur,1,2,8,10
2011-10-06,0,Oct,3,0,Thur,1,1,4,5
2011-10-06,0,Oct,4,0,Thur,1,0,5,5
2011-10-06,0,Oct,5,0,Thur,1,0,24,24
2011-10-06,0,Oct,6,0,Thur,1,4,110,114
2011-10-06,0,Oct,7,0,Thur,1,15,287,302
2011-10-06,0,Oct,8,0,Thur,1,20,437,457
2011-10-06,0,Oct,9,0,Thur,1,20,188,208
2011-10-06,0,Oct,10,0,Thur,1,24,105,129
2011-10-06,0,Oct,11,0,Thur,1,29,115,144
2011-10-06,0,Oct,12,0,Thur,1,46,180,226
2011-10-06,0,Oct,13,0,Thur,1,33,158,191
2011-10-06,0,Oct,14,0,Thur,1,56,139,195
2011-10-06,0,Oct,15,0,Thur,1,62,157,219
2011-10-06,0,Oct,16,0,Thur,1,51,272,323
2011-10-06,0,Oct,17,0,Thur,1,63,505,568
2011-10-06,0,Oct,18,0,Thur,1,59,479,538
2011-10-06,0,Oct,19,0,Thur,1,38,305,343
2011-10-06,0,Oct,20,0,Thur,1,29,231,260
2011-10-06,0,Oct,21,0,Thur,1,34,161,195
2011-10-06,0,Oct,22,0,Thur,1,24,124,148
2011-10-06,0,Oct,23,0,Thur,1,18,81,99
2011-10-07,0,Oct,0,0,Fri,1,19,48,67
2011-10-07,0,Oct,1,0,Fri,1,3,25,28
2011-10-07,0,Oct,2,0,Fri,1,0,5,5
2011-10-07,0,Oct,3,0,Fri,1,1,9,10
2011-10-07,0,Oct,4,0,Fri,1,0,5,5
2011-10-07,0,Oct,5,0,Fri,1,3,24,27
2011-10-07,0,Oct,6,0,Fri,1,3,84,87
2011-10-07,0,Oct,7,0,Fri,1,5,237,242
2011-10-07,0,Oct,8,0,Fri,1,31,386,417
2011-10-07,0,Oct,9,0,Fri,1,34,207,241
2011-10-07,0,Oct,10,0,Fri,1,48,126,174
2011-10-07,0,Oct,11,0,Fri,1,80,150,230
2011-10-07,0,Oct,12,0,Fri,1,61,174,235
2011-10-07,0,Oct,13,0,Fri,1,95,210,305
2011-10-07,0,Oct,14,0,Fri,1,77,179,256
2011-10-07,0,Oct,15,0,Fri,1,68,202,270
2011-10-07,0,Oct,16,0,Fri,1,73,346,419
2011-10-07,0,Oct,17,0,Fri,1,101,462,563
2011-10-07,0,Oct,18,0,Fri,1,94,371,465
2011-10-07,0,Oct,19,0,Fri,1,51,243,294
2011-10-07,0,Oct,20,0,Fri,1,30,167,197
2011-10-07,0,Oct,21,0,Fri,1,22,144,166
2011-10-07,0,Oct,22,0,Fri,1,27,119,146
2011-10-07,0,Oct,23,0,Fri,1,23,113,136
2011-10-08,0,Oct,0,0,Sat,0,17,72,89
2011-10-08,0,Oct,1,0,Sat,0,14,51,65
2011-10-08,0,Oct,2,0,Sat,0,4,41,45
2011-10-08,0,Oct,3,0,Sat,0,4,16,20
2011-10-08,0,Oct,4,0,Sat,0,3,7,10
2011-10-08,0,Oct,5,0,Sat,0,1,7,8
2011-10-08,0,Oct,6,0,Sat,0,6,16,22
2011-10-08,0,Oct,7,0,Sat,0,27,46,73
2011-10-08,0,Oct,8,0,Sat,0,14,89,103
2011-10-08,0,Oct,9,0,Sat,0,54,163,217
2011-10-08,0,Oct,10,0,Sat,0,120,217,337
2011-10-08,0,Oct,11,0,Sat,0,176,221,397
2011-10-08,0,Oct,12,0,Sat,0,191,255,446
2011-10-08,0,Oct,13,0,Sat,0,256,229,485
2011-10-08,0,Oct,14,0,Sat,0,251,214,465
2011-10-08,0,Oct,15,0,Sat,0,262,234,496
2011-10-08,0,Oct,16,0,Sat,0,221,230,451
2011-10-08,0,Oct,17,0,Sat,0,174,219,393
2011-10-08,0,Oct,18,0,Sat,0,135,224,359
2011-10-08,0,Oct,19,0,Sat,0,76,172,248
2011-10-08,0,Oct,20,0,Sat,0,78,124,202
2011-10-08,0,Oct,21,0,Sat,0,54,133,187
2011-10-08,0,Oct,22,0,Sat,0,45,104,149
2011-10-08,0,Oct,23,0,Sat,0,52,90,142
2011-10-09,0,Oct,0,0,Sun,0,46,83,129
2011-10-09,0,Oct,1,0,Sun,0,15,63,78
2011-10-09,0,Oct,2,0,Sun,0,20,35,55
2011-10-09,0,Oct,3,0,Sun,0,10,20,30
2011-10-09,0,Oct,4,0,Sun,0,7,7,14
2011-10-09,0,Oct,5,0,Sun,0,1,14,15
2011-10-09,0,Oct,6,0,Sun,0,7,14,21
2011-10-09,0,Oct,7,0,Sun,0,18,26,44
2011-10-09,0,Oct,8,0,Sun,0,25,82,107
2011-10-09,0,Oct,9,0,Sun,0,66,119,185
2011-10-09,0,Oct,10,0,Sun,0,155,210,365
2011-10-09,0,Oct,11,0,Sun,0,189,234,423
2011-10-09,0,Oct,12,0,Sun,0,212,243,455
2011-10-09,0,Oct,13,0,Sun,0,225,193,418
2011-10-09,0,Oct,14,0,Sun,0,272,228,500
2011-10-09,0,Oct,15,0,Sun,0,198,209,407
2011-10-09,0,Oct,16,0,Sun,0,223,247,470
2011-10-09,0,Oct,17,0,Sun,0,208,230,438
2011-10-09,0,Oct,18,0,Sun,0,186,228,414
2011-10-09,0,Oct,19,0,Sun,0,116,186,302
2011-10-09,0,Oct,20,0,Sun,0,59,134,193
2011-10-09,0,Oct,21,0,Sun,0,53,120,173
2011-10-09,0,Oct,22,0,Sun,0,48,104,152
2011-10-09,0,Oct,23,0,Sun,0,38,85,123
2011-10-10,0,Oct,0,1,Mon,0,11,42,53
2011-10-10,0,Oct,1,1,Mon,0,4,30,34
2011-10-10,0,Oct,2,1,Mon,0,4,15,19
2011-10-10,0,Oct,3,1,Mon,0,2,9,11
2011-10-10,0,Oct,4,1,Mon,0,2,4,6
2011-10-10,0,Oct,5,1,Mon,0,2,19,21
2011-10-10,0,Oct,6,1,Mon,0,5,39,44
2011-10-10,0,Oct,7,1,Mon,0,12,102,114
2011-10-10,0,Oct,8,1,Mon,0,27,227,254
2011-10-10,0,Oct,9,1,Mon,0,58,161,219
2011-10-10,0,Oct,10,1,Mon,0,107,158,265
2011-10-10,0,Oct,11,1,Mon,0,139,183,322
2011-10-10,0,Oct,12,1,Mon,0,164,201,365
2011-10-10,0,Oct,13,1,Mon,0,146,219,365
2011-10-10,0,Oct,14,1,Mon,0,147,223,370
2011-10-10,0,Oct,15,1,Mon,0,130,254,384
2011-10-10,0,Oct,16,1,Mon,0,154,248,402
2011-10-10,0,Oct,17,1,Mon,0,125,334,459
2011-10-10,0,Oct,18,1,Mon,0,108,365,473
2011-10-10,0,Oct,19,1,Mon,0,69,267,336
2011-10-10,0,Oct,20,1,Mon,0,37,188,225
2011-10-10,0,Oct,21,1,Mon,0,27,148,175
2011-10-10,0,Oct,22,1,Mon,0,22,104,126
2011-10-10,0,Oct,23,1,Mon,0,12,63,75
2011-10-11,0,Oct,0,0,Tue,1,14,16,30
2011-10-11,0,Oct,1,0,Tue,1,2,9,11
2011-10-11,0,Oct,2,0,Tue,1,1,4,5
2011-10-11,0,Oct,3,0,Tue,1,2,1,3
2011-10-11,0,Oct,4,0,Tue,1,0,5,5
2011-10-11,0,Oct,5,0,Tue,1,0,20,20
2011-10-11,0,Oct,6,0,Tue,1,9,114,123
2011-10-11,0,Oct,7,0,Tue,1,19,333,352
2011-10-11,0,Oct,8,0,Tue,1,31,375,406
2011-10-11,0,Oct,9,0,Tue,1,40,195,235
2011-10-11,0,Oct,10,0,Tue,1,38,111,149
2011-10-11,0,Oct,11,0,Tue,1,31,92,123
2011-10-11,0,Oct,12,0,Tue,1,51,130,181
2011-10-11,0,Oct,13,0,Tue,1,42,138,180
2011-10-11,0,Oct,14,0,Tue,1,54,117,171
2011-10-11,0,Oct,15,0,Tue,1,36,139,175
2011-10-11,0,Oct,16,0,Tue,1,63,257,320
2011-10-11,0,Oct,17,0,Tue,1,70,534,604
2011-10-11,0,Oct,18,0,Tue,1,46,493,539
2011-10-11,0,Oct,19,0,Tue,1,33,285,318
2011-10-11,0,Oct,20,0,Tue,1,31,203,234
2011-10-11,0,Oct,21,0,Tue,1,17,158,175
2011-10-11,0,Oct,22,0,Tue,1,27,120,147
2011-10-11,0,Oct,23,0,Tue,1,10,47,57
2011-10-12,0,Oct,0,0,Wed,1,2,23,25
2011-10-12,0,Oct,1,0,Wed,1,2,8,10
2011-10-12,0,Oct,2,0,Wed,1,0,2,2
2011-10-12,0,Oct,3,0,Wed,1,0,2,2
2011-10-12,0,Oct,4,0,Wed,1,1,6,7
2011-10-12,0,Oct,5,0,Wed,1,0,22,22
2011-10-12,0,Oct,6,0,Wed,1,5,107,112
2011-10-12,0,Oct,7,0,Wed,1,15,244,259
2011-10-12,0,Oct,8,0,Wed,1,27,377,404
2011-10-12,0,Oct,9,0,Wed,1,14,183,197
2011-10-12,0,Oct,10,0,Wed,1,15,98,113
2011-10-12,0,Oct,11,0,Wed,1,18,102,120
2011-10-12,0,Oct,12,0,Wed,1,9,53,62
2011-10-12,0,Oct,13,0,Wed,1,25,76,101
2011-10-12,0,Oct,14,0,Wed,1,8,70,78
2011-10-12,0,Oct,15,0,Wed,1,3,42,45
2011-10-12,0,Oct,16,0,Wed,1,5,50,55
2011-10-12,0,Oct,17,0,Wed,1,16,235,251
2011-10-12,0,Oct,18,0,Wed,1,11,161,172
2011-10-12,0,Oct,19,0,Wed,1,7,102,109
2011-10-12,0,Oct,20,0,Wed,1,9,81,90
2011-10-12,0,Oct,21,0,Wed,1,9,74,83
2011-10-12,0,Oct,22,0,Wed,1,3,40,43
2011-10-12,0,Oct,23,0,Wed,1,13,41,54
2011-10-13,0,Oct,0,0,Thur,1,1,14,15
2011-10-13,0,Oct,1,0,Thur,1,3,9,12
2011-10-13,0,Oct,2,0,Thur,1,0,4,4
2011-10-13,0,Oct,3,0,Thur,1,2,4,6
2011-10-13,0,Oct,4,0,Thur,1,2,5,7
2011-10-13,0,Oct,5,0,Thur,1,1,16,17
2011-10-13,0,Oct,6,0,Thur,1,1,51,52
2011-10-13,0,Oct,7,0,Thur,1,5,76,81
2011-10-13,0,Oct,8,0,Thur,1,10,199,209
2011-10-13,0,Oct,9,0,Thur,1,3,106,109
2011-10-13,0,Oct,10,0,Thur,1,16,53,69
2011-10-13,0,Oct,11,0,Thur,1,8,76,84
2011-10-13,0,Oct,12,0,Thur,1,10,95,105
2011-10-13,0,Oct,13,0,Thur,1,20,142,162
2011-10-13,0,Oct,14,0,Thur,1,22,111,133
2011-10-13,0,Oct,15,0,Thur,1,27,128,155
2011-10-13,0,Oct,16,0,Thur,1,36,240,276
2011-10-13,0,Oct,17,0,Thur,1,47,432,479
2011-10-13,0,Oct,18,0,Thur,1,20,248,268
2011-10-13,0,Oct,19,0,Thur,1,18,187,205
2011-10-13,0,Oct,20,0,Thur,1,15,166,181
2011-10-13,0,Oct,21,0,Thur,1,8,115,123
2011-10-13,0,Oct,22,0,Thur,1,13,101,114
2011-10-13,0,Oct,23,0,Thur,1,2,45,47
2011-10-14,0,Oct,0,0,Fri,1,10,29,39
2011-10-14,0,Oct,1,0,Fri,1,8,16,24
2011-10-14,0,Oct,2,0,Fri,1,0,6,6
2011-10-14,0,Oct,3,0,Fri,1,1,6,7
2011-10-14,0,Oct,4,0,Fri,1,0,8,8
2011-10-14,0,Oct,5,0,Fri,1,0,17,17
2011-10-14,0,Oct,6,0,Fri,1,4,90,94
2011-10-14,0,Oct,7,0,Fri,1,10,137,147
2011-10-14,0,Oct,8,0,Fri,1,23,186,209
2011-10-14,0,Oct,9,0,Fri,1,16,164,180
2011-10-14,0,Oct,10,0,Fri,1,17,108,125
2011-10-14,0,Oct,11,0,Fri,1,11,76,87
2011-10-14,0,Oct,12,0,Fri,1,13,62,75
2011-10-14,0,Oct,13,0,Fri,1,18,114,132
2011-10-14,0,Oct,14,0,Fri,1,37,119,156
2011-10-14,0,Oct,15,0,Fri,1,61,169,230
2011-10-14,0,Oct,16,0,Fri,1,80,264,344
2011-10-14,0,Oct,17,0,Fri,1,55,426,481
2011-10-14,0,Oct,18,0,Fri,1,62,361,423
2011-10-14,0,Oct,19,0,Fri,1,27,221,248
2011-10-14,0,Oct,20,0,Fri,1,19,177,196
2011-10-14,0,Oct,21,0,Fri,1,22,156,178
2011-10-14,0,Oct,22,0,Fri,1,20,123,143
2011-10-14,0,Oct,23,0,Fri,1,15,80,95
2011-10-15,0,Oct,0,0,Sat,0,18,88,106
2011-10-15,0,Oct,1,0,Sat,0,9,64,73
2011-10-15,0,Oct,2,0,Sat,0,17,39,56
2011-10-15,0,Oct,3,0,Sat,0,5,18,23
2011-10-15,0,Oct,4,0,Sat,0,0,6,6
2011-10-15,0,Oct,5,0,Sat,0,1,6,7
2011-10-15,0,Oct,6,0,Sat,0,5,15,20
2011-10-15,0,Oct,7,0,Sat,0,17,40,57
2011-10-15,0,Oct,8,0,Sat,0,24,101,125
2011-10-15,0,Oct,9,0,Sat,0,50,157,207
2011-10-15,0,Oct,10,0,Sat,0,115,207,322
2011-10-15,0,Oct,11,0,Sat,0,153,221,374
2011-10-15,0,Oct,12,0,Sat,0,195,261,456
2011-10-15,0,Oct,13,0,Sat,0,171,223,394
2011-10-15,0,Oct,14,0,Sat,0,242,230,472
2011-10-15,0,Oct,15,0,Sat,0,166,211,377
2011-10-15,0,Oct,16,0,Sat,0,179,264,443
2011-10-15,0,Oct,17,0,Sat,0,177,264,441
2011-10-15,0,Oct,18,0,Sat,0,121,251,372
2011-10-15,0,Oct,19,0,Sat,0,61,177,238
2011-10-15,0,Oct,20,0,Sat,0,42,137,179
2011-10-15,0,Oct,21,0,Sat,0,53,115,168
2011-10-15,0,Oct,22,0,Sat,0,45,121,166
2011-10-15,0,Oct,23,0,Sat,0,33,102,135
2011-10-16,0,Oct,0,0,Sun,0,22,85,107
2011-10-16,0,Oct,1,0,Sun,0,13,64,77
2011-10-16,0,Oct,2,0,Sun,0,13,52,65
2011-10-16,0,Oct,3,0,Sun,0,11,31,42
2011-10-16,0,Oct,4,0,Sun,0,5,7,12
2011-10-16,0,Oct,5,0,Sun,0,1,6,7
2011-10-16,0,Oct,6,0,Sun,0,3,7,10
2011-10-16,0,Oct,7,0,Sun,0,9,39,48
2011-10-16,0,Oct,8,0,Sun,0,28,71,99
2011-10-16,0,Oct,9,0,Sun,0,39,151,190
2011-10-16,0,Oct,10,0,Sun,0,121,226,347
2011-10-16,0,Oct,11,0,Sun,0,159,218,377
2011-10-16,0,Oct,12,0,Sun,0,167,277,444
2011-10-16,0,Oct,13,0,Sun,0,169,269,438
2011-10-16,0,Oct,14,0,Sun,0,204,258,462
2011-10-16,0,Oct,15,0,Sun,0,182,230,412
2011-10-16,0,Oct,16,0,Sun,0,177,289,466
2011-10-16,0,Oct,17,0,Sun,0,152,253,405
2011-10-16,0,Oct,18,0,Sun,0,102,226,328
2011-10-16,0,Oct,19,0,Sun,0,52,181,233
2011-10-16,0,Oct,20,0,Sun,0,49,129,178
2011-10-16,0,Oct,21,0,Sun,0,14,88,102
2011-10-16,0,Oct,22,0,Sun,0,42,88,130
2011-10-16,0,Oct,23,0,Sun,0,14,48,62
2011-10-17,0,Oct,0,0,Mon,1,12,25,37
2011-10-17,0,Oct,1,0,Mon,1,2,15,17
2011-10-17,0,Oct,2,0,Mon,1,4,3,7
2011-10-17,0,Oct,3,0,Mon,1,0,2,2
2011-10-17,0,Oct,4,0,Mon,1,2,3,5
2011-10-17,0,Oct,5,0,Mon,1,1,28,29
2011-10-17,0,Oct,6,0,Mon,1,7,107,114
2011-10-17,0,Oct,7,0,Mon,1,10,299,309
2011-10-17,0,Oct,8,0,Mon,1,33,381,414
2011-10-17,0,Oct,9,0,Mon,1,26,180,206
2011-10-17,0,Oct,10,0,Mon,1,43,92,135
2011-10-17,0,Oct,11,0,Mon,1,35,131,166
2011-10-17,0,Oct,12,0,Mon,1,39,166,205
2011-10-17,0,Oct,13,0,Mon,1,49,156,205
2011-10-17,0,Oct,14,0,Mon,1,44,122,166
2011-10-17,0,Oct,15,0,Mon,1,66,142,208
2011-10-17,0,Oct,16,0,Mon,1,64,238,302
2011-10-17,0,Oct,17,0,Mon,1,80,540,620
2011-10-17,0,Oct,18,0,Mon,1,49,469,518
2011-10-17,0,Oct,19,0,Mon,1,45,288,333
2011-10-17,0,Oct,20,0,Mon,1,40,189,229
2011-10-17,0,Oct,21,0,Mon,1,36,141,177
2011-10-17,0,Oct,22,0,Mon,1,16,88,104
2011-10-17,0,Oct,23,0,Mon,1,10,52,62
2011-10-18,0,Oct,0,0,Tue,1,8,23,31
2011-10-18,0,Oct,1,0,Tue,1,4,7,11
2011-10-18,0,Oct,2,0,Tue,1,1,4,5
2011-10-18,0,Oct,3,0,Tue,1,0,1,1
2011-10-18,0,Oct,4,0,Tue,1,0,4,4
2011-10-18,0,Oct,5,0,Tue,1,2,19,21
2011-10-18,0,Oct,6,0,Tue,1,4,105,109
2011-10-18,0,Oct,7,0,Tue,1,15,326,341
2011-10-18,0,Oct,8,0,Tue,1,25,474,499
2011-10-18,0,Oct,9,0,Tue,1,29,198,227
2011-10-18,0,Oct,10,0,Tue,1,27,75,102
2011-10-18,0,Oct,11,0,Tue,1,35,112,147
2011-10-18,0,Oct,12,0,Tue,1,42,159,201
2011-10-18,0,Oct,13,0,Tue,1,48,171,219
2011-10-18,0,Oct,14,0,Tue,1,32,137,169
2011-10-18,0,Oct,15,0,Tue,1,66,139,205
2011-10-18,0,Oct,16,0,Tue,1,58,246,304
2011-10-18,0,Oct,17,0,Tue,1,72,553,625
2011-10-18,0,Oct,18,0,Tue,1,58,512,570
2011-10-18,0,Oct,19,0,Tue,1,31,286,317
2011-10-18,0,Oct,20,0,Tue,1,23,204,227
2011-10-18,0,Oct,21,0,Tue,1,28,178,206
2011-10-18,0,Oct,22,0,Tue,1,22,115,137
2011-10-18,0,Oct,23,0,Tue,1,7,63,70
2011-10-19,0,Oct,0,0,Wed,1,11,23,34
2011-10-19,0,Oct,1,0,Wed,1,7,9,16
2011-10-19,0,Oct,2,0,Wed,1,1,6,7
2011-10-19,0,Oct,4,0,Wed,1,0,3,3
2011-10-19,0,Oct,5,0,Wed,1,0,3,3
2011-10-19,0,Oct,6,0,Wed,1,3,28,31
2011-10-19,0,Oct,7,0,Wed,1,1,67,68
2011-10-19,0,Oct,8,0,Wed,1,10,200,210
2011-10-19,0,Oct,9,0,Wed,1,17,185,202
2011-10-19,0,Oct,10,0,Wed,1,14,109,123
2011-10-19,0,Oct,11,0,Wed,1,33,116,149
2011-10-19,0,Oct,12,0,Wed,1,13,117,130
2011-10-19,0,Oct,13,0,Wed,1,20,86,106
2011-10-19,0,Oct,14,0,Wed,1,17,80,97
2011-10-19,0,Oct,15,0,Wed,1,21,99,120
2011-10-19,0,Oct,16,0,Wed,1,21,180,201
2011-10-19,0,Oct,17,0,Wed,1,11,170,181
2011-10-19,0,Oct,18,0,Wed,1,8,132,140
2011-10-19,0,Oct,19,0,Wed,1,8,189,197
2011-10-19,0,Oct,20,0,Wed,1,5,140,145
2011-10-19,0,Oct,21,0,Wed,1,6,79,85
2011-10-19,0,Oct,22,0,Wed,1,13,94,107
2011-10-19,0,Oct,23,0,Wed,1,14,55,69
2011-10-20,0,Oct,0,0,Thur,1,4,22,26
2011-10-20,0,Oct,1,0,Thur,1,4,11,15
2011-10-20,0,Oct,2,0,Thur,1,0,4,4
2011-10-20,0,Oct,3,0,Thur,1,0,1,1
2011-10-20,0,Oct,4,0,Thur,1,2,6,8
2011-10-20,0,Oct,5,0,Thur,1,2,24,26
2011-10-20,0,Oct,6,0,Thur,1,5,87,92
2011-10-20,0,Oct,7,0,Thur,1,15,303,318
2011-10-20,0,Oct,8,0,Thur,1,17,409,426
2011-10-20,0,Oct,9,0,Thur,1,26,197,223
2011-10-20,0,Oct,10,0,Thur,1,25,105,130
2011-10-20,0,Oct,11,0,Thur,1,30,99,129
2011-10-20,0,Oct,12,0,Thur,1,28,171,199
2011-10-20,0,Oct,13,0,Thur,1,28,136,164
2011-10-20,0,Oct,14,0,Thur,1,38,117,155
2011-10-20,0,Oct,15,0,Thur,1,22,138,160
2011-10-20,0,Oct,16,0,Thur,1,31,203,234
2011-10-20,0,Oct,17,0,Thur,1,56,438,494
2011-10-20,0,Oct,18,0,Thur,1,39,430,469
2011-10-20,0,Oct,19,0,Thur,1,20,278,298
2011-10-20,0,Oct,20,0,Thur,1,34,207,241
2011-10-20,0,Oct,21,0,Thur,1,16,149,165
2011-10-20,0,Oct,22,0,Thur,1,22,106,128
2011-10-20,0,Oct,23,0,Thur,1,7,83,90
2011-10-21,0,Oct,0,0,Fri,1,8,42,50
2011-10-21,0,Oct,1,0,Fri,1,7,19,26
2011-10-21,0,Oct,2,0,Fri,1,6,12,18
2011-10-21,0,Oct,3,0,Fri,1,0,7,7
2011-10-21,0,Oct,4,0,Fri,1,0,6,6
2011-10-21,0,Oct,5,0,Fri,1,0,31,31
2011-10-21,0,Oct,6,0,Fri,1,7,78,85
2011-10-21,0,Oct,7,0,Fri,1,5,228,233
2011-10-21,0,Oct,8,0,Fri,1,16,386,402
2011-10-21,0,Oct,9,0,Fri,1,33,189,222
2011-10-21,0,Oct,10,0,Fri,1,32,106,138
2011-10-21,0,Oct,11,0,Fri,1,39,135,174
2011-10-21,0,Oct,12,0,Fri,1,47,193,240
2011-10-21,0,Oct,13,0,Fri,1,43,163,206
2011-10-21,0,Oct,14,0,Fri,1,67,131,198
2011-10-21,0,Oct,15,0,Fri,1,57,178,235
2011-10-21,0,Oct,16,0,Fri,1,60,242,302
2011-10-21,0,Oct,17,0,Fri,1,79,445,524
2011-10-21,0,Oct,18,0,Fri,1,43,354,397
2011-10-21,0,Oct,19,0,Fri,1,25,228,253
2011-10-21,0,Oct,20,0,Fri,1,29,155,184
2011-10-21,0,Oct,21,0,Fri,1,31,112,143
2011-10-21,0,Oct,22,0,Fri,1,24,89,113
2011-10-21,0,Oct,23,0,Fri,1,18,99,117
2011-10-22,0,Oct,0,0,Sat,0,16,80,96
2011-10-22,0,Oct,1,0,Sat,0,20,50,70
2011-10-22,0,Oct,2,0,Sat,0,6,25,31
2011-10-22,0,Oct,3,0,Sat,0,1,19,20
2011-10-22,0,Oct,4,0,Sat,0,4,4,8
2011-10-22,0,Oct,5,0,Sat,0,1,7,8
2011-10-22,0,Oct,6,0,Sat,0,1,17,18
2011-10-22,0,Oct,7,0,Sat,0,8,49,57
2011-10-22,0,Oct,8,0,Sat,0,26,88,114
2011-10-22,0,Oct,9,0,Sat,0,47,122,169
2011-10-22,0,Oct,10,0,Sat,0,87,149,236
2011-10-22,0,Oct,11,0,Sat,0,110,172,282
2011-10-22,0,Oct,12,0,Sat,0,132,211,343
2011-10-22,0,Oct,13,0,Sat,0,136,186,322
2011-10-22,0,Oct,14,0,Sat,0,133,177,310
2011-10-22,0,Oct,15,0,Sat,0,159,223,382
2011-10-22,0,Oct,16,0,Sat,0,169,190,359
2011-10-22,0,Oct,17,0,Sat,0,143,217,360
2011-10-22,0,Oct,18,0,Sat,0,111,224,335
2011-10-22,0,Oct,19,0,Sat,0,47,173,220
2011-10-22,0,Oct,20,0,Sat,0,48,111,159
2011-10-22,0,Oct,21,0,Sat,0,37,120,157
2011-10-22,0,Oct,22,0,Sat,0,30,114,144
2011-10-22,0,Oct,23,0,Sat,0,27,81,108
2011-10-23,0,Oct,0,0,Sun,0,24,64,88
2011-10-23,0,Oct,1,0,Sun,0,11,60,71
2011-10-23,0,Oct,2,0,Sun,0,10,40,50
2011-10-23,0,Oct,3,0,Sun,0,15,31,46
2011-10-23,0,Oct,4,0,Sun,0,5,1,6
2011-10-23,0,Oct,5,0,Sun,0,1,2,3
2011-10-23,0,Oct,6,0,Sun,0,0,12,12
2011-10-23,0,Oct,7,0,Sun,0,3,18,21
2011-10-23,0,Oct,8,0,Sun,0,32,56,88
2011-10-23,0,Oct,9,0,Sun,0,48,95,143
2011-10-23,0,Oct,10,0,Sun,0,104,185,289
2011-10-23,0,Oct,11,0,Sun,0,131,202,333
2011-10-23,0,Oct,12,0,Sun,0,164,249,413
2011-10-23,0,Oct,13,0,Sun,0,160,255,415
2011-10-23,0,Oct,14,0,Sun,0,192,216,408
2011-10-23,0,Oct,15,0,Sun,0,171,216,387
2011-10-23,0,Oct,16,0,Sun,0,188,217,405
2011-10-23,0,Oct,17,0,Sun,0,120,220,340
2011-10-23,0,Oct,18,0,Sun,0,88,196,284
2011-10-23,0,Oct,19,0,Sun,0,53,140,193
2011-10-23,0,Oct,20,0,Sun,0,32,112,144
2011-10-23,0,Oct,21,0,Sun,0,24,75,99
2011-10-23,0,Oct,22,0,Sun,0,25,69,94
2011-10-23,0,Oct,23,0,Sun,0,18,31,49
2011-10-24,0,Oct,0,0,Mon,1,6,26,32
2011-10-24,0,Oct,1,0,Mon,1,7,8,15
2011-10-24,0,Oct,2,0,Mon,1,1,6,7
2011-10-24,0,Oct,3,0,Mon,1,1,3,4
2011-10-24,0,Oct,4,0,Mon,1,1,5,6
2011-10-24,0,Oct,5,0,Mon,1,2,19,21
2011-10-24,0,Oct,6,0,Mon,1,3,83,86
2011-10-24,0,Oct,7,0,Mon,1,11,274,285
2011-10-24,0,Oct,8,0,Mon,1,20,378,398
2011-10-24,0,Oct,9,0,Mon,1,29,166,195
2011-10-24,0,Oct,10,0,Mon,1,47,82,129
2011-10-24,0,Oct,11,0,Mon,1,59,109,168
2011-10-24,0,Oct,12,0,Mon,1,64,156,220
2011-10-24,0,Oct,13,0,Mon,1,60,138,198
2011-10-24,0,Oct,14,0,Mon,1,63,143,206
2011-10-24,0,Oct,15,0,Mon,1,52,125,177
2011-10-24,0,Oct,16,0,Mon,1,68,242,310
2011-10-24,0,Oct,17,0,Mon,1,87,527,614
2011-10-24,0,Oct,18,0,Mon,1,58,428,486
2011-10-24,0,Oct,19,0,Mon,1,25,212,237
2011-10-24,0,Oct,20,0,Mon,1,11,118,129
2011-10-24,0,Oct,21,0,Mon,1,12,114,126
2011-10-24,0,Oct,22,0,Mon,1,3,76,79
2011-10-24,0,Oct,23,0,Mon,1,9,50,59
2011-10-25,0,Oct,0,0,Tue,1,4,26,30
2011-10-25,0,Oct,1,0,Tue,1,5,6,11
2011-10-25,0,Oct,2,0,Tue,1,2,3,5
2011-10-25,0,Oct,3,0,Tue,1,1,3,4
2011-10-25,0,Oct,4,0,Tue,1,0,5,5
2011-10-25,0,Oct,5,0,Tue,1,0,24,24
2011-10-25,0,Oct,6,0,Tue,1,3,95,98
2011-10-25,0,Oct,7,0,Tue,1,15,299,314
2011-10-25,0,Oct,8,0,Tue,1,25,383,408
2011-10-25,0,Oct,9,0,Tue,1,29,194,223
2011-10-25,0,Oct,10,0,Tue,1,26,102,128
2011-10-25,0,Oct,11,0,Tue,1,46,120,166
2011-10-25,0,Oct,12,0,Tue,1,35,165,200
2011-10-25,0,Oct,13,0,Tue,1,37,161,198
2011-10-25,0,Oct,14,0,Tue,1,66,134,200
2011-10-25,0,Oct,15,0,Tue,1,63,171,234
2011-10-25,0,Oct,16,0,Tue,1,52,233,285
2011-10-25,0,Oct,17,0,Tue,1,68,517,585
2011-10-25,0,Oct,18,0,Tue,1,65,453,518
2011-10-25,0,Oct,19,0,Tue,1,44,294,338
2011-10-25,0,Oct,20,0,Tue,1,40,208,248
2011-10-25,0,Oct,21,0,Tue,1,32,169,201
2011-10-25,0,Oct,22,0,Tue,1,22,148,170
2011-10-25,0,Oct,23,0,Tue,1,15,79,94
2011-10-26,0,Oct,0,0,Wed,1,4,28,32
2011-10-26,0,Oct,1,0,Wed,1,3,9,12
2011-10-26,0,Oct,2,0,Wed,1,2,1,3
2011-10-26,0,Oct,3,0,Wed,1,0,3,3
2011-10-26,0,Oct,4,0,Wed,1,0,5,5
2011-10-26,0,Oct,5,0,Wed,1,0,21,21
2011-10-26,0,Oct,6,0,Wed,1,0,92,92
2011-10-26,0,Oct,7,0,Wed,1,15,284,299
2011-10-26,0,Oct,8,0,Wed,1,26,438,464
2011-10-26,0,Oct,9,0,Wed,1,14,226,240
2011-10-26,0,Oct,10,0,Wed,1,26,105,131
2011-10-26,0,Oct,11,0,Wed,1,23,132,155
2011-10-26,0,Oct,12,0,Wed,1,39,155,194
2011-10-26,0,Oct,13,0,Wed,1,20,62,82
2011-10-26,0,Oct,14,0,Wed,1,14,52,66
2011-10-26,0,Oct,15,0,Wed,1,11,59,70
2011-10-26,0,Oct,16,0,Wed,1,17,196,213
2011-10-26,0,Oct,17,0,Wed,1,40,414,454
2011-10-26,0,Oct,18,0,Wed,1,55,398,453
2011-10-26,0,Oct,19,0,Wed,1,25,306,331
2011-10-26,0,Oct,20,0,Wed,1,27,180,207
2011-10-26,0,Oct,21,0,Wed,1,17,140,157
2011-10-26,0,Oct,22,0,Wed,1,23,112,135
2011-10-26,0,Oct,23,0,Wed,1,3,72,75
2011-10-27,0,Oct,0,0,Thur,1,3,23,26
2011-10-27,0,Oct,1,0,Thur,1,2,9,11
2011-10-27,0,Oct,2,0,Thur,1,3,5,8
2011-10-27,0,Oct,3,0,Thur,1,1,3,4
2011-10-27,0,Oct,4,0,Thur,1,1,3,4
2011-10-27,0,Oct,5,0,Thur,1,1,14,15
2011-10-27,0,Oct,6,0,Thur,1,4,42,46
2011-10-27,0,Oct,7,0,Thur,1,9,128,137
2011-10-27,0,Oct,8,0,Thur,1,12,304,316
2011-10-27,0,Oct,9,0,Thur,1,16,155,171
2011-10-27,0,Oct,10,0,Thur,1,10,52,62
2011-10-27,0,Oct,11,0,Thur,1,8,44,52
2011-10-27,0,Oct,12,0,Thur,1,8,45,53
2011-10-27,0,Oct,13,0,Thur,1,10,64,74
2011-10-27,0,Oct,14,0,Thur,1,16,76,92
2011-10-27,0,Oct,15,0,Thur,1,12,95,107
2011-10-27,0,Oct,16,0,Thur,1,14,193,207
2011-10-27,0,Oct,17,0,Thur,1,31,291,322
2011-10-27,0,Oct,18,0,Thur,1,14,226,240
2011-10-27,0,Oct,19,0,Thur,1,19,200,219
2011-10-27,0,Oct,20,0,Thur,1,11,171,182
2011-10-27,0,Oct,21,0,Thur,1,13,119,132
2011-10-27,0,Oct,22,0,Thur,1,14,97,111
2011-10-27,0,Oct,23,0,Thur,1,8,60,68
2011-10-28,0,Oct,0,0,Fri,1,4,40,44
2011-10-28,0,Oct,1,0,Fri,1,7,9,16
2011-10-28,0,Oct,2,0,Fri,1,1,3,4
2011-10-28,0,Oct,3,0,Fri,1,4,4,8
2011-10-28,0,Oct,4,0,Fri,1,5,5,10
2011-10-28,0,Oct,5,0,Fri,1,0,25,25
2011-10-28,0,Oct,6,0,Fri,1,1,74,75
2011-10-28,0,Oct,7,0,Fri,1,6,199,205
2011-10-28,0,Oct,8,0,Fri,1,13,361,374
2011-10-28,0,Oct,9,0,Fri,1,19,210,229
2011-10-28,0,Oct,10,0,Fri,1,28,102,130
2011-10-28,0,Oct,11,0,Fri,1,40,128,168
2011-10-28,0,Oct,12,0,Fri,1,46,167,213
2011-10-28,0,Oct,13,0,Fri,1,43,185,228
2011-10-28,0,Oct,14,0,Fri,1,33,152,185
2011-10-28,0,Oct,15,0,Fri,1,44,171,215
2011-10-28,0,Oct,16,0,Fri,1,46,262,308
2011-10-28,0,Oct,17,0,Fri,1,35,411,446
2011-10-28,0,Oct,18,0,Fri,1,36,332,368
2011-10-28,0,Oct,19,0,Fri,1,16,188,204
2011-10-28,0,Oct,20,0,Fri,1,12,131,143
2011-10-28,0,Oct,21,0,Fri,1,5,69,74
2011-10-28,0,Oct,22,0,Fri,1,4,32,36
2011-10-28,0,Oct,23,0,Fri,1,8,31,39
2011-10-29,0,Oct,0,0,Sat,0,0,19,19
2011-10-29,0,Oct,1,0,Sat,0,0,18,18
2011-10-29,0,Oct,2,0,Sat,0,1,16,17
2011-10-29,0,Oct,3,0,Sat,0,0,8,8
2011-10-29,0,Oct,4,0,Sat,0,0,1,1
2011-10-29,0,Oct,5,0,Sat,0,0,1,1
2011-10-29,0,Oct,6,0,Sat,0,4,1,5
2011-10-29,0,Oct,7,0,Sat,0,1,6,7
2011-10-29,0,Oct,8,0,Sat,0,4,16,20
2011-10-29,0,Oct,9,0,Sat,0,1,19,20
2011-10-29,0,Oct,10,0,Sat,0,0,12,12
2011-10-29,0,Oct,11,0,Sat,0,1,26,27
2011-10-29,0,Oct,12,0,Sat,0,6,44,50
2011-10-29,0,Oct,13,0,Sat,0,0,30,30
2011-10-29,0,Oct,14,0,Sat,0,0,29,29
2011-10-29,0,Oct,15,0,Sat,0,3,38,41
2011-10-29,0,Oct,16,0,Sat,0,3,19,22
2011-10-29,0,Oct,17,0,Sat,0,3,28,31
2011-10-29,0,Oct,18,0,Sat,0,6,37,43
2011-10-29,0,Oct,19,0,Sat,0,3,36,39
2011-10-29,0,Oct,20,0,Sat,0,7,40,47
2011-10-29,0,Oct,21,0,Sat,0,1,49,50
2011-10-29,0,Oct,22,0,Sat,0,10,44,54
2011-10-29,0,Oct,23,0,Sat,0,3,33,36
2011-10-30,0,Oct,0,0,Sun,0,7,47,54
2011-10-30,0,Oct,1,0,Sun,0,9,34,43
2011-10-30,0,Oct,2,0,Sun,0,7,43,50
2011-10-30,0,Oct,3,0,Sun,0,7,26,33
2011-10-30,0,Oct,4,0,Sun,0,1,10,11
2011-10-30,0,Oct,5,0,Sun,0,0,4,4
2011-10-30,0,Oct,6,0,Sun,0,2,8,10
2011-10-30,0,Oct,7,0,Sun,0,7,15,22
2011-10-30,0,Oct,8,0,Sun,0,20,60,80
2011-10-30,0,Oct,9,0,Sun,0,55,92,147
2011-10-30,0,Oct,10,0,Sun,0,53,125,178
2011-10-30,0,Oct,11,0,Sun,0,58,182,240
2011-10-30,0,Oct,12,0,Sun,0,85,229,314
2011-10-30,0,Oct,13,0,Sun,0,113,232,345
2011-10-30,0,Oct,14,0,Sun,0,91,209,300
2011-10-30,0,Oct,15,0,Sun,0,88,202,290
2011-10-30,0,Oct,16,0,Sun,0,107,213,320
2011-10-30,0,Oct,17,0,Sun,0,54,191,245
2011-10-30,0,Oct,18,0,Sun,0,51,162,213
2011-10-30,0,Oct,19,0,Sun,0,28,125,153
2011-10-30,0,Oct,20,0,Sun,0,18,74,92
2011-10-30,0,Oct,21,0,Sun,0,4,75,79
2011-10-30,0,Oct,22,0,Sun,0,13,58,71
2011-10-30,0,Oct,23,0,Sun,0,7,30,37
2011-10-31,0,Oct,0,0,Mon,1,3,20,23
2011-10-31,0,Oct,1,0,Mon,1,5,8,13
2011-10-31,0,Oct,2,0,Mon,1,0,3,3
2011-10-31,0,Oct,3,0,Mon,1,0,3,3
2011-10-31,0,Oct,4,0,Mon,1,1,5,6
2011-10-31,0,Oct,5,0,Mon,1,0,18,18
2011-10-31,0,Oct,6,0,Mon,1,4,82,86
2011-10-31,0,Oct,7,0,Mon,1,11,216,227
2011-10-31,0,Oct,8,0,Mon,1,17,355,372
2011-10-31,0,Oct,9,0,Mon,1,14,197,211
2011-10-31,0,Oct,10,0,Mon,1,18,87,105
2011-10-31,0,Oct,11,0,Mon,1,31,97,128
2011-10-31,0,Oct,12,0,Mon,1,30,140,170
2011-10-31,0,Oct,13,0,Mon,1,24,128,152
2011-10-31,0,Oct,14,0,Mon,1,22,119,141
2011-10-31,0,Oct,15,0,Mon,1,27,141,168
2011-10-31,0,Oct,16,0,Mon,1,30,242,272
2011-10-31,0,Oct,17,0,Mon,1,44,442,486
2011-10-31,0,Oct,18,0,Mon,1,30,392,422
2011-10-31,0,Oct,19,0,Mon,1,12,226,238
2011-10-31,0,Oct,20,0,Mon,1,18,154,172
2011-10-31,0,Oct,21,0,Mon,1,7,109,116
2011-10-31,0,Oct,22,0,Mon,1,8,77,85
2011-10-31,0,Oct,23,0,Mon,1,6,46,52
2011-11-01,0,Nov,0,0,Tue,1,3,18,21
2011-11-01,0,Nov,1,0,Tue,1,3,8,11
2011-11-01,0,Nov,2,0,Tue,1,1,3,4
2011-11-01,0,Nov,3,0,Tue,1,1,5,6
2011-11-01,0,Nov,4,0,Tue,1,1,7,8
2011-11-01,0,Nov,5,0,Tue,1,0,18,18
2011-11-01,0,Nov,6,0,Tue,1,3,90,93
2011-11-01,0,Nov,7,0,Tue,1,8,246,254
2011-11-01,0,Nov,8,0,Tue,1,17,402,419
2011-11-01,0,Nov,9,0,Tue,1,16,206,222
2011-11-01,0,Nov,10,0,Tue,1,21,114,135
2011-11-01,0,Nov,11,0,Tue,1,16,101,117
2011-11-01,0,Nov,12,0,Tue,1,23,153,176
2011-11-01,0,Nov,13,0,Tue,1,20,147,167
2011-11-01,0,Nov,14,0,Tue,1,32,118,150
2011-11-01,0,Nov,15,0,Tue,1,38,148,186
2011-11-01,0,Nov,16,0,Tue,1,46,252,298
2011-11-01,0,Nov,17,0,Tue,1,36,470,506
2011-11-01,0,Nov,18,0,Tue,1,39,421,460
2011-11-01,0,Nov,19,0,Tue,1,39,274,313
2011-11-01,0,Nov,20,0,Tue,1,18,191,209
2011-11-01,0,Nov,21,0,Tue,1,13,114,127
2011-11-01,0,Nov,22,0,Tue,1,5,91,96
2011-11-01,0,Nov,23,0,Tue,1,11,61,72
2011-11-02,0,Nov,0,0,Wed,1,0,19,19
2011-11-02,0,Nov,1,0,Wed,1,2,8,10
2011-11-02,0,Nov,2,0,Wed,1,0,2,2
2011-11-02,0,Nov,3,0,Wed,1,0,2,2
2011-11-02,0,Nov,4,0,Wed,1,0,4,4
2011-11-02,0,Nov,5,0,Wed,1,0,27,27
2011-11-02,0,Nov,6,0,Wed,1,1,91,92
2011-11-02,0,Nov,7,0,Wed,1,11,240,251
2011-11-02,0,Nov,8,0,Wed,1,20,452,472
2011-11-02,0,Nov,9,0,Wed,1,15,213,228
2011-11-02,0,Nov,10,0,Wed,1,25,108,133
2011-11-02,0,Nov,11,0,Wed,1,27,117,144
2011-11-02,0,Nov,12,0,Wed,1,32,157,189
2011-11-02,0,Nov,13,0,Wed,1,22,139,161
2011-11-02,0,Nov,14,0,Wed,1,40,132,172
2011-11-02,0,Nov,15,0,Wed,1,26,161,187
2011-11-02,0,Nov,16,0,Wed,1,35,231,266
2011-11-02,0,Nov,17,0,Wed,1,30,523,553
2011-11-02,0,Nov,18,0,Wed,1,31,448,479
2011-11-02,0,Nov,19,0,Wed,1,25,257,282
2011-11-02,0,Nov,20,0,Wed,1,5,177,182
2011-11-02,0,Nov,21,0,Wed,1,13,155,168
2011-11-02,0,Nov,22,0,Wed,1,7,99,106
2011-11-02,0,Nov,23,0,Wed,1,3,54,57
2011-11-03,0,Nov,0,0,Thur,1,3,28,31
2011-11-03,0,Nov,1,0,Thur,1,3,12,15
2011-11-03,0,Nov,2,0,Thur,1,2,5,7
2011-11-03,0,Nov,3,0,Thur,1,1,4,5
2011-11-03,0,Nov,4,0,Thur,1,1,3,4
2011-11-03,0,Nov,5,0,Thur,1,1,27,28
2011-11-03,0,Nov,6,0,Thur,1,3,96,99
2011-11-03,0,Nov,7,0,Thur,1,12,280,292
2011-11-03,0,Nov,8,0,Thur,1,8,394,402
2011-11-03,0,Nov,9,0,Thur,1,9,155,164
2011-11-03,0,Nov,10,0,Thur,1,12,98,110
2011-11-03,0,Nov,11,0,Thur,1,12,108,120
2011-11-03,0,Nov,12,0,Thur,1,17,162,179
2011-11-03,0,Nov,13,0,Thur,1,19,150,169
2011-11-03,0,Nov,14,0,Thur,1,32,120,152
2011-11-03,0,Nov,15,0,Thur,1,24,138,162
2011-11-03,0,Nov,16,0,Thur,1,33,234,267
2011-11-03,0,Nov,17,0,Thur,1,33,465,498
2011-11-03,0,Nov,18,0,Thur,1,24,409,433
2011-11-03,0,Nov,19,0,Thur,1,18,234,252
2011-11-03,0,Nov,20,0,Thur,1,11,198,209
2011-11-03,0,Nov,21,0,Thur,1,4,140,144
2011-11-03,0,Nov,22,0,Thur,1,21,116,137
2011-11-03,0,Nov,23,0,Thur,1,15,80,95
2011-11-04,0,Nov,0,0,Fri,1,11,32,43
2011-11-04,0,Nov,1,0,Fri,1,1,16,17
2011-11-04,0,Nov,2,0,Fri,1,2,8,10
2011-11-04,0,Nov,3,0,Fri,1,1,7,8
2011-11-04,0,Nov,4,0,Fri,1,1,6,7
2011-11-04,0,Nov,5,0,Fri,1,0,23,23
2011-11-04,0,Nov,6,0,Fri,1,2,64,66
2011-11-04,0,Nov,7,0,Fri,1,10,235,245
2011-11-04,0,Nov,8,0,Fri,1,8,387,395
2011-11-04,0,Nov,9,0,Fri,1,15,239,254
2011-11-04,0,Nov,10,0,Fri,1,19,115,134
2011-11-04,0,Nov,11,0,Fri,1,34,128,162
2011-11-04,0,Nov,12,0,Fri,1,44,153,197
2011-11-04,0,Nov,13,0,Fri,1,33,161,194
2011-11-04,0,Nov,14,0,Fri,1,54,147,201
2011-11-04,0,Nov,15,0,Fri,1,45,192,237
2011-11-04,0,Nov,16,0,Fri,1,53,237,290
2011-11-04,0,Nov,17,0,Fri,1,42,438,480
2011-11-04,0,Nov,18,0,Fri,1,35,339,374
2011-11-04,0,Nov,19,0,Fri,1,14,182,196
2011-11-04,0,Nov,20,0,Fri,1,15,171,186
2011-11-04,0,Nov,21,0,Fri,1,8,115,123
2011-11-04,0,Nov,22,0,Fri,1,6,109,115
2011-11-04,0,Nov,23,0,Fri,1,17,72,89
2011-11-05,0,Nov,0,0,Sat,0,4,48,52
2011-11-05,0,Nov,1,0,Sat,0,5,57,62
2011-11-05,0,Nov,2,0,Sat,0,7,24,31
2011-11-05,0,Nov,3,0,Sat,0,0,8,8
2011-11-05,0,Nov,4,0,Sat,0,3,5,8
2011-11-05,0,Nov,5,0,Sat,0,0,2,2
2011-11-05,0,Nov,6,0,Sat,0,3,20,23
2011-11-05,0,Nov,7,0,Sat,0,3,31,34
2011-11-05,0,Nov,8,0,Sat,0,4,80,84
2011-11-05,0,Nov,9,0,Sat,0,30,111,141
2011-11-05,0,Nov,10,0,Sat,0,56,171,227
2011-11-05,0,Nov,11,0,Sat,0,69,169,238
2011-11-05,0,Nov,12,0,Sat,0,137,235,372
2011-11-05,0,Nov,13,0,Sat,0,148,207,355
2011-11-05,0,Nov,14,0,Sat,0,159,227,386
2011-11-05,0,Nov,15,0,Sat,0,141,202,343
2011-11-05,0,Nov,16,0,Sat,0,128,207,335
2011-11-05,0,Nov,17,0,Sat,0,100,234,334
2011-11-05,0,Nov,18,0,Sat,0,52,185,237
2011-11-05,0,Nov,19,0,Sat,0,45,159,204
2011-11-05,0,Nov,20,0,Sat,0,29,136,165
2011-11-05,0,Nov,21,0,Sat,0,19,99,118
2011-11-05,0,Nov,22,0,Sat,0,10,72,82
2011-11-05,0,Nov,23,0,Sat,0,4,81,85
2011-11-06,0,Nov,0,0,Sun,0,10,65,75
2011-11-06,0,Nov,1,0,Sun,0,11,104,115
2011-11-06,0,Nov,2,0,Sun,0,6,23,29
2011-11-06,0,Nov,3,0,Sun,0,5,4,9
2011-11-06,0,Nov,4,0,Sun,0,0,6,6
2011-11-06,0,Nov,5,0,Sun,0,0,5,5
2011-11-06,0,Nov,6,0,Sun,0,5,11,16
2011-11-06,0,Nov,7,0,Sun,0,4,24,28
2011-11-06,0,Nov,8,0,Sun,0,19,71,90
2011-11-06,0,Nov,9,0,Sun,0,36,134,170
2011-11-06,0,Nov,10,0,Sun,0,76,186,262
2011-11-06,0,Nov,11,0,Sun,0,104,216,320
2011-11-06,0,Nov,12,0,Sun,0,120,226,346
2011-11-06,0,Nov,13,0,Sun,0,105,209,314
2011-11-06,0,Nov,14,0,Sun,0,101,219,320
2011-11-06,0,Nov,15,0,Sun,0,96,210,306
2011-11-06,0,Nov,16,0,Sun,0,84,263,347
2011-11-06,0,Nov,17,0,Sun,0,71,185,256
2011-11-06,0,Nov,18,0,Sun,0,39,146,185
2011-11-06,0,Nov,19,0,Sun,0,21,130,151
2011-11-06,0,Nov,20,0,Sun,0,16,100,116
2011-11-06,0,Nov,21,0,Sun,0,11,77,88
2011-11-06,0,Nov,22,0,Sun,0,5,40,45
2011-11-06,0,Nov,23,0,Sun,0,7,43,50
2011-11-07,0,Nov,0,0,Mon,1,1,14,15
2011-11-07,0,Nov,1,0,Mon,1,2,6,8
2011-11-07,0,Nov,2,0,Mon,1,0,2,2
2011-11-07,0,Nov,3,0,Mon,1,0,3,3
2011-11-07,0,Nov,4,0,Mon,1,2,4,6
2011-11-07,0,Nov,5,0,Mon,1,1,25,26
2011-11-07,0,Nov,6,0,Mon,1,2,97,99
2011-11-07,0,Nov,7,0,Mon,1,6,305,311
2011-11-07,0,Nov,8,0,Mon,1,13,397,410
2011-11-07,0,Nov,9,0,Mon,1,18,156,174
2011-11-07,0,Nov,10,0,Mon,1,28,95,123
2011-11-07,0,Nov,11,0,Mon,1,28,100,128
2011-11-07,0,Nov,12,0,Mon,1,21,158,179
2011-11-07,0,Nov,13,0,Mon,1,32,157,189
2011-11-07,0,Nov,14,0,Mon,1,30,115,145
2011-11-07,0,Nov,15,0,Mon,1,38,132,170
2011-11-07,0,Nov,16,0,Mon,1,40,255,295
2011-11-07,0,Nov,17,0,Mon,1,39,489,528
2011-11-07,0,Nov,18,0,Mon,1,18,407,425
2011-11-07,0,Nov,19,0,Mon,1,20,280,300
2011-11-07,0,Nov,20,0,Mon,1,17,187,204
2011-11-07,0,Nov,21,0,Mon,1,10,129,139
2011-11-07,0,Nov,22,0,Mon,1,6,102,108
2011-11-07,0,Nov,23,0,Mon,1,1,47,48
2011-11-08,0,Nov,0,0,Tue,1,0,18,18
2011-11-08,0,Nov,1,0,Tue,1,3,8,11
2011-11-08,0,Nov,2,0,Tue,1,0,1,1
2011-11-08,0,Nov,3,0,Tue,1,0,3,3
2011-11-08,0,Nov,4,0,Tue,1,0,4,4
2011-11-08,0,Nov,5,0,Tue,1,1,17,18
2011-11-08,0,Nov,6,0,Tue,1,3,96,99
2011-11-08,0,Nov,7,0,Tue,1,7,316,323
2011-11-08,0,Nov,8,0,Tue,1,11,455,466
2011-11-08,0,Nov,9,0,Tue,1,14,177,191
2011-11-08,0,Nov,10,0,Tue,1,25,104,129
2011-11-08,0,Nov,11,0,Tue,1,21,126,147
2011-11-08,0,Nov,12,0,Tue,1,28,175,203
2011-11-08,0,Nov,13,0,Tue,1,31,165,196
2011-11-08,0,Nov,14,0,Tue,1,32,129,161
2011-11-08,0,Nov,15,0,Tue,1,33,155,188
2011-11-08,0,Nov,16,0,Tue,1,39,250,289
2011-11-08,0,Nov,17,0,Tue,1,40,459,499
2011-11-08,0,Nov,18,0,Tue,1,30,432,462
2011-11-08,0,Nov,19,0,Tue,1,14,264,278
2011-11-08,0,Nov,20,0,Tue,1,12,169,181
2011-11-08,0,Nov,21,0,Tue,1,16,166,182
2011-11-08,0,Nov,22,0,Tue,1,13,95,108
2011-11-08,0,Nov,23,0,Tue,1,3,45,48
2011-11-09,0,Nov,0,0,Wed,1,0,13,13
2011-11-09,0,Nov,1,0,Wed,1,0,10,10
2011-11-09,0,Nov,2,0,Wed,1,0,5,5
2011-11-09,0,Nov,3,0,Wed,1,0,4,4
2011-11-09,0,Nov,4,0,Wed,1,0,4,4
2011-11-09,0,Nov,5,0,Wed,1,0,28,28
2011-11-09,0,Nov,6,0,Wed,1,0,98,98
2011-11-09,0,Nov,7,0,Wed,1,0,300,300
2011-11-09,0,Nov,8,0,Wed,1,19,437,456
2011-11-09,0,Nov,9,0,Wed,1,22,197,219
2011-11-09,0,Nov,10,0,Wed,1,16,89,105
2011-11-09,0,Nov,11,0,Wed,1,21,131,152
2011-11-09,0,Nov,12,0,Wed,1,24,156,180
2011-11-09,0,Nov,13,0,Wed,1,31,136,167
2011-11-09,0,Nov,14,0,Wed,1,26,153,179
2011-11-09,0,Nov,15,0,Wed,1,21,130,151
2011-11-09,0,Nov,16,0,Wed,1,24,257,281
2011-11-09,0,Nov,17,0,Wed,1,27,458,485
2011-11-09,0,Nov,18,0,Wed,1,21,387,408
2011-11-09,0,Nov,19,0,Wed,1,12,292,304
2011-11-09,0,Nov,20,0,Wed,1,18,201,219
2011-11-09,0,Nov,21,0,Wed,1,9,152,161
2011-11-09,0,Nov,22,0,Wed,1,9,105,114
2011-11-09,0,Nov,23,0,Wed,1,5,61,66
2011-11-10,0,Nov,0,0,Thur,1,0,24,24
2011-11-10,0,Nov,1,0,Thur,1,1,10,11
2011-11-10,0,Nov,2,0,Thur,1,0,5,5
2011-11-10,0,Nov,3,0,Thur,1,0,11,11
2011-11-10,0,Nov,4,0,Thur,1,1,2,3
2011-11-10,0,Nov,5,0,Thur,1,1,22,23
2011-11-10,0,Nov,6,0,Thur,1,4,110,114
2011-11-10,0,Nov,7,0,Thur,1,6,266,272
2011-11-10,0,Nov,8,0,Thur,1,18,418,436
2011-11-10,0,Nov,9,0,Thur,1,23,188,211
2011-11-10,0,Nov,10,0,Thur,1,17,100,117
2011-11-10,0,Nov,11,0,Thur,1,9,99,108
2011-11-10,0,Nov,12,0,Thur,1,18,149,167
2011-11-10,0,Nov,13,0,Thur,1,9,87,96
2011-11-10,0,Nov,14,0,Thur,1,6,58,64
2011-11-10,0,Nov,15,0,Thur,1,5,57,62
2011-11-10,0,Nov,16,0,Thur,1,6,67,73
2011-11-10,0,Nov,17,0,Thur,1,9,168,177
2011-11-10,0,Nov,18,0,Thur,1,10,263,273
2011-11-10,0,Nov,19,0,Thur,1,19,192,211
2011-11-10,0,Nov,20,0,Thur,1,8,160,168
2011-11-10,0,Nov,21,0,Thur,1,6,130,136
2011-11-10,0,Nov,22,0,Thur,1,5,84,89
2011-11-10,0,Nov,23,0,Thur,1,9,73,82
2011-11-11,0,Nov,0,1,Fri,0,10,56,66
2011-11-11,0,Nov,1,1,Fri,0,3,16,19
2011-11-11,0,Nov,2,1,Fri,0,1,10,11
2011-11-11,0,Nov,3,1,Fri,0,0,6,6
2011-11-11,0,Nov,4,1,Fri,0,0,8,8
2011-11-11,0,Nov,5,1,Fri,0,0,13,13
2011-11-11,0,Nov,6,1,Fri,0,0,46,46
2011-11-11,0,Nov,7,1,Fri,0,5,116,121
2011-11-11,0,Nov,8,1,Fri,0,9,249,258
2011-11-11,0,Nov,9,1,Fri,0,15,186,201
2011-11-11,0,Nov,10,1,Fri,0,38,162,200
2011-11-11,0,Nov,11,1,Fri,0,20,150,170
2011-11-11,0,Nov,12,1,Fri,0,41,198,239
2011-11-11,0,Nov,13,1,Fri,0,57,179,236
2011-11-11,0,Nov,14,1,Fri,0,64,183,247
2011-11-11,0,Nov,15,1,Fri,0,29,187,216
2011-11-11,0,Nov,16,1,Fri,0,49,189,238
2011-11-11,0,Nov,17,1,Fri,0,24,286,310
2011-11-11,0,Nov,18,1,Fri,0,23,185,208
2011-11-11,0,Nov,19,1,Fri,0,17,182,199
2011-11-11,0,Nov,20,1,Fri,0,12,97,109
2011-11-11,0,Nov,21,1,Fri,0,4,79,83
2011-11-11,0,Nov,22,1,Fri,0,13,78,91
2011-11-11,0,Nov,23,1,Fri,0,6,67,73
2011-11-12,0,Nov,0,0,Sat,0,12,52,64
2011-11-12,0,Nov,1,0,Sat,0,9,45,54
2011-11-12,0,Nov,2,0,Sat,0,7,39,46
2011-11-12,0,Nov,3,0,Sat,0,4,13,17
2011-11-12,0,Nov,4,0,Sat,0,0,7,7
2011-11-12,0,Nov,5,0,Sat,0,1,3,4
2011-11-12,0,Nov,6,0,Sat,0,0,7,7
2011-11-12,0,Nov,7,0,Sat,0,3,24,27
2011-11-12,0,Nov,8,0,Sat,0,14,87,101
2011-11-12,0,Nov,9,0,Sat,0,18,142,160
2011-11-12,0,Nov,10,0,Sat,0,62,170,232
2011-11-12,0,Nov,11,0,Sat,0,102,213,315
2011-11-12,0,Nov,12,0,Sat,0,142,224,366
2011-11-12,0,Nov,13,0,Sat,0,128,225,353
2011-11-12,0,Nov,14,0,Sat,0,191,244,435
2011-11-12,0,Nov,15,0,Sat,0,165,221,386
2011-11-12,0,Nov,16,0,Sat,0,137,224,361
2011-11-12,0,Nov,17,0,Sat,0,92,193,285
2011-11-12,0,Nov,18,0,Sat,0,53,150,203
2011-11-12,0,Nov,19,0,Sat,0,32,139,171
2011-11-12,0,Nov,20,0,Sat,0,31,101,132
2011-11-12,0,Nov,21,0,Sat,0,19,103,122
2011-11-12,0,Nov,22,0,Sat,0,30,88,118
2011-11-12,0,Nov,23,0,Sat,0,23,78,101
2011-11-13,0,Nov,0,0,Sun,0,12,61,73
2011-11-13,0,Nov,1,0,Sun,0,13,58,71
2011-11-13,0,Nov,2,0,Sun,0,9,48,57
2011-11-13,0,Nov,3,0,Sun,0,8,20,28
2011-11-13,0,Nov,4,0,Sun,0,1,5,6
2011-11-13,0,Nov,5,0,Sun,0,2,3,5
2011-11-13,0,Nov,6,0,Sun,0,5,18,23
2011-11-13,0,Nov,7,0,Sun,0,13,30,43
2011-11-13,0,Nov,8,0,Sun,0,24,55,79
2011-11-13,0,Nov,9,0,Sun,0,38,97,135
2011-11-13,0,Nov,10,0,Sun,0,63,178,241
2011-11-13,0,Nov,11,0,Sun,0,108,187,295
2011-11-13,0,Nov,12,0,Sun,0,112,242,354
2011-11-13,0,Nov,13,0,Sun,0,105,234,339
2011-11-13,0,Nov,14,0,Sun,0,108,263,371
2011-11-13,0,Nov,15,0,Sun,0,89,221,310
2011-11-13,0,Nov,16,0,Sun,0,93,226,319
2011-11-13,0,Nov,17,0,Sun,0,44,187,231
2011-11-13,0,Nov,18,0,Sun,0,35,155,190
2011-11-13,0,Nov,19,0,Sun,0,36,121,157
2011-11-13,0,Nov,20,0,Sun,0,24,115,139
2011-11-13,0,Nov,21,0,Sun,0,19,76,95
2011-11-13,0,Nov,22,0,Sun,0,25,64,89
2011-11-13,0,Nov,23,0,Sun,0,18,49,67
2011-11-14,0,Nov,0,0,Mon,1,8,22,30
2011-11-14,0,Nov,1,0,Mon,1,5,6,11
2011-11-14,0,Nov,2,0,Mon,1,7,10,17
2011-11-14,0,Nov,3,0,Mon,1,4,3,7
2011-11-14,0,Nov,4,0,Mon,1,0,5,5
2011-11-14,0,Nov,5,0,Mon,1,0,19,19
2011-11-14,0,Nov,6,0,Mon,1,10,104,114
2011-11-14,0,Nov,7,0,Mon,1,11,311,322
2011-11-14,0,Nov,8,0,Mon,1,27,425,452
2011-11-14,0,Nov,9,0,Mon,1,29,204,233
2011-11-14,0,Nov,10,0,Mon,1,26,85,111
2011-11-14,0,Nov,11,0,Mon,1,22,106,128
2011-11-14,0,Nov,12,0,Mon,1,36,166,202
2011-11-14,0,Nov,13,0,Mon,1,50,153,203
2011-11-14,0,Nov,14,0,Mon,1,47,138,185
2011-11-14,0,Nov,15,0,Mon,1,53,142,195
2011-11-14,0,Nov,16,0,Mon,1,51,264,315
2011-11-14,0,Nov,17,0,Mon,1,55,464,519
2011-11-14,0,Nov,18,0,Mon,1,29,460,489
2011-11-14,0,Nov,19,0,Mon,1,28,274,302
2011-11-14,0,Nov,20,0,Mon,1,30,210,240
2011-11-14,0,Nov,21,0,Mon,1,37,176,213
2011-11-14,0,Nov,22,0,Mon,1,17,96,113
2011-11-14,0,Nov,23,0,Mon,1,13,48,61
2011-11-15,0,Nov,0,0,Tue,1,7,15,22
2011-11-15,0,Nov,1,0,Tue,1,5,5,10
2011-11-15,0,Nov,2,0,Tue,1,7,8,15
2011-11-15,0,Nov,3,0,Tue,1,0,4,4
2011-11-15,0,Nov,4,0,Tue,1,1,6,7
2011-11-15,0,Nov,5,0,Tue,1,2,26,28
2011-11-15,0,Nov,6,0,Tue,1,4,104,108
2011-11-15,0,Nov,7,0,Tue,1,21,298,319
2011-11-15,0,Nov,8,0,Tue,1,27,453,480
2011-11-15,0,Nov,9,0,Tue,1,26,174,200
2011-11-15,0,Nov,10,0,Tue,1,23,115,138
2011-11-15,0,Nov,11,0,Tue,1,18,116,134
2011-11-15,0,Nov,12,0,Tue,1,28,148,176
2011-11-15,0,Nov,13,0,Tue,1,21,132,153
2011-11-15,0,Nov,14,0,Tue,1,27,120,147
2011-11-15,0,Nov,15,0,Tue,1,36,155,191
2011-11-15,0,Nov,16,0,Tue,1,31,240,271
2011-11-15,0,Nov,17,0,Tue,1,29,422,451
2011-11-15,0,Nov,18,0,Tue,1,27,414,441
2011-11-15,0,Nov,19,0,Tue,1,27,259,286
2011-11-15,0,Nov,20,0,Tue,1,26,212,238
2011-11-15,0,Nov,21,0,Tue,1,23,145,168
2011-11-15,0,Nov,22,0,Tue,1,19,109,128
2011-11-15,0,Nov,23,0,Tue,1,14,66,80
2011-11-16,0,Nov,0,0,Wed,1,5,26,31
2011-11-16,0,Nov,1,0,Wed,1,0,5,5
2011-11-16,0,Nov,2,0,Wed,1,4,6,10
2011-11-16,0,Nov,3,0,Wed,1,2,3,5
2011-11-16,0,Nov,4,0,Wed,1,1,3,4
2011-11-16,0,Nov,5,0,Wed,1,0,13,13
2011-11-16,0,Nov,6,0,Wed,1,4,52,56
2011-11-16,0,Nov,7,0,Wed,1,7,130,137
2011-11-16,0,Nov,8,0,Wed,1,9,223,232
2011-11-16,0,Nov,9,0,Wed,1,5,77,82
2011-11-16,0,Nov,10,0,Wed,1,4,32,36
2011-11-16,0,Nov,11,0,Wed,1,7,53,60
2011-11-16,0,Nov,12,0,Wed,1,5,49,54
2011-11-16,0,Nov,13,0,Wed,1,6,52,58
2011-11-16,0,Nov,14,0,Wed,1,12,49,61
2011-11-16,0,Nov,15,0,Wed,1,16,50,66
2011-11-16,0,Nov,16,0,Wed,1,13,110,123
2011-11-16,0,Nov,17,0,Wed,1,17,216,233
2011-11-16,0,Nov,18,0,Wed,1,13,176,189
2011-11-16,0,Nov,19,0,Wed,1,3,108,111
2011-11-16,0,Nov,20,0,Wed,1,5,94,99
2011-11-16,0,Nov,21,0,Wed,1,3,72,75
2011-11-16,0,Nov,22,0,Wed,1,1,45,46
2011-11-16,0,Nov,23,0,Wed,1,3,28,31
2011-11-17,0,Nov,0,0,Thur,1,2,22,24
2011-11-17,0,Nov,1,0,Thur,1,0,5,5
2011-11-17,0,Nov,2,0,Thur,1,0,5,5
2011-11-17,0,Nov,3,0,Thur,1,0,3,3
2011-11-17,0,Nov,4,0,Thur,1,1,3,4
2011-11-17,0,Nov,5,0,Thur,1,1,21,22
2011-11-17,0,Nov,6,0,Thur,1,3,72,75
2011-11-17,0,Nov,7,0,Thur,1,4,164,168
2011-11-17,0,Nov,8,0,Thur,1,12,343,355
2011-11-17,0,Nov,9,0,Thur,1,14,184,198
2011-11-17,0,Nov,10,0,Thur,1,7,74,81
2011-11-17,0,Nov,11,0,Thur,1,4,93,97
2011-11-17,0,Nov,12,0,Thur,1,6,115,121
2011-11-17,0,Nov,13,0,Thur,1,15,109,124
2011-11-17,0,Nov,14,0,Thur,1,5,105,110
2011-11-17,0,Nov,15,0,Thur,1,10,106,116
2011-11-17,0,Nov,16,0,Thur,1,8,187,195
2011-11-17,0,Nov,17,0,Thur,1,20,379,399
2011-11-17,0,Nov,18,0,Thur,1,9,298,307
2011-11-17,0,Nov,19,0,Thur,1,7,210,217
2011-11-17,0,Nov,20,0,Thur,1,7,162,169
2011-11-17,0,Nov,21,0,Thur,1,3,113,116
2011-11-17,0,Nov,22,0,Thur,1,1,83,84
2011-11-17,0,Nov,23,0,Thur,1,0,58,58
2011-11-18,0,Nov,0,0,Fri,1,2,28,30
2011-11-18,0,Nov,1,0,Fri,1,0,10,10
2011-11-18,0,Nov,2,0,Fri,1,2,8,10
2011-11-18,0,Nov,3,0,Fri,1,0,2,2
2011-11-18,0,Nov,4,0,Fri,1,0,5,5
2011-11-18,0,Nov,5,0,Fri,1,0,22,22
2011-11-18,0,Nov,6,0,Fri,1,1,70,71
2011-11-18,0,Nov,7,0,Fri,1,5,211,216
2011-11-18,0,Nov,8,0,Fri,1,6,369,375
2011-11-18,0,Nov,9,0,Fri,1,6,207,213
2011-11-18,0,Nov,10,0,Fri,1,10,105,115
2011-11-18,0,Nov,11,0,Fri,1,18,122,140
2011-11-18,0,Nov,12,0,Fri,1,22,143,165
2011-11-18,0,Nov,13,0,Fri,1,31,146,177
2011-11-18,0,Nov,14,0,Fri,1,31,123,154
2011-11-18,0,Nov,15,0,Fri,1,27,151,178
2011-11-18,0,Nov,16,0,Fri,1,19,190,209
2011-11-18,0,Nov,17,0,Fri,1,17,361,378
2011-11-18,0,Nov,18,0,Fri,1,16,312,328
2011-11-18,0,Nov,19,0,Fri,1,7,183,190
2011-11-18,0,Nov,20,0,Fri,1,8,129,137
2011-11-18,0,Nov,21,0,Fri,1,3,108,111
2011-11-18,0,Nov,22,0,Fri,1,9,88,97
2011-11-18,0,Nov,23,0,Fri,1,5,54,59
2011-11-19,0,Nov,0,0,Sat,0,4,49,53
2011-11-19,0,Nov,1,0,Sat,0,1,34,35
2011-11-19,0,Nov,2,0,Sat,0,12,34,46
2011-11-19,0,Nov,3,0,Sat,0,4,11,15
2011-11-19,0,Nov,4,0,Sat,0,4,4,8
2011-11-19,0,Nov,5,0,Sat,0,0,2,2
2011-11-19,0,Nov,6,0,Sat,0,2,10,12
2011-11-19,0,Nov,7,0,Sat,0,3,38,41
2011-11-19,0,Nov,8,0,Sat,0,12,80,92
2011-11-19,0,Nov,9,0,Sat,0,12,130,142
2011-11-19,0,Nov,10,0,Sat,0,35,165,200
2011-11-19,0,Nov,11,0,Sat,0,50,183,233
2011-11-19,0,Nov,12,0,Sat,0,93,218,311
2011-11-19,0,Nov,13,0,Sat,0,118,245,363
2011-11-19,0,Nov,14,0,Sat,0,121,228,349
2011-11-19,0,Nov,15,0,Sat,0,120,262,382
2011-11-19,0,Nov,16,0,Sat,0,99,188,287
2011-11-19,0,Nov,17,0,Sat,0,61,171,232
2011-11-19,0,Nov,18,0,Sat,0,36,172,208
2011-11-19,0,Nov,19,0,Sat,0,33,149,182
2011-11-19,0,Nov,20,0,Sat,0,48,115,163
2011-11-19,0,Nov,21,0,Sat,0,29,79,108
2011-11-19,0,Nov,22,0,Sat,0,26,80,106
2011-11-19,0,Nov,23,0,Sat,0,20,73,93
2011-11-20,0,Nov,0,0,Sun,0,14,79,93
2011-11-20,0,Nov,1,0,Sun,0,11,73,84
2011-11-20,0,Nov,2,0,Sun,0,12,44,56
2011-11-20,0,Nov,3,0,Sun,0,6,31,37
2011-11-20,0,Nov,4,0,Sun,0,2,10,12
2011-11-20,0,Nov,5,0,Sun,0,0,4,4
2011-11-20,0,Nov,6,0,Sun,0,3,6,9
2011-11-20,0,Nov,7,0,Sun,0,4,19,23
2011-11-20,0,Nov,8,0,Sun,0,13,52,65
2011-11-20,0,Nov,9,0,Sun,0,29,109,138
2011-11-20,0,Nov,10,0,Sun,0,46,183,229
2011-11-20,0,Nov,11,0,Sun,0,74,212,286
2011-11-20,0,Nov,12,0,Sun,0,70,234,304
2011-11-20,0,Nov,13,0,Sun,0,84,285,369
2011-11-20,0,Nov,14,0,Sun,0,113,250,363
2011-11-20,0,Nov,15,0,Sun,0,109,242,351
2011-11-20,0,Nov,16,0,Sun,0,81,225,306
2011-11-20,0,Nov,17,0,Sun,0,35,168,203
2011-11-20,0,Nov,18,0,Sun,0,22,123,145
2011-11-20,0,Nov,19,0,Sun,0,17,140,157
2011-11-20,0,Nov,20,0,Sun,0,23,90,113
2011-11-20,0,Nov,21,0,Sun,0,11,94,105
2011-11-20,0,Nov,22,0,Sun,0,5,35,40
2011-11-20,0,Nov,23,0,Sun,0,3,25,28
2011-11-21,0,Nov,0,0,Mon,1,4,13,17
2011-11-21,0,Nov,1,0,Mon,1,4,8,12
2011-11-21,0,Nov,2,0,Mon,1,1,2,3
2011-11-21,0,Nov,3,0,Mon,1,0,4,4
2011-11-21,0,Nov,4,0,Mon,1,0,5,5
2011-11-21,0,Nov,5,0,Mon,1,0,20,20
2011-11-21,0,Nov,6,0,Mon,1,0,76,76
2011-11-21,0,Nov,7,0,Mon,1,17,229,246
2011-11-21,0,Nov,8,0,Mon,1,13,378,391
2011-11-21,0,Nov,9,0,Mon,1,15,222,237
2011-11-21,0,Nov,10,0,Mon,1,25,110,135
2011-11-21,0,Nov,11,0,Mon,1,16,112,128
2011-11-21,0,Nov,12,0,Mon,1,24,138,162
2011-11-21,0,Nov,13,0,Mon,1,13,121,134
2011-11-21,0,Nov,14,0,Mon,1,14,121,135
2011-11-21,0,Nov,15,0,Mon,1,15,93,108
2011-11-21,0,Nov,16,0,Mon,1,13,95,108
2011-11-21,0,Nov,17,0,Mon,1,10,200,210
2011-11-21,0,Nov,18,0,Mon,1,8,184,192
2011-11-21,0,Nov,19,0,Mon,1,2,135,137
2011-11-21,0,Nov,20,0,Mon,1,5,75,80
2011-11-21,0,Nov,21,0,Mon,1,11,103,114
2011-11-21,0,Nov,22,0,Mon,1,6,72,78
2011-11-21,0,Nov,23,0,Mon,1,4,29,33
2011-11-22,0,Nov,0,0,Tue,1,0,14,14
2011-11-22,0,Nov,1,0,Tue,1,1,5,6
2011-11-22,0,Nov,2,0,Tue,1,2,4,6
2011-11-22,0,Nov,3,0,Tue,1,1,2,3
2011-11-22,0,Nov,4,0,Tue,1,0,7,7
2011-11-22,0,Nov,5,0,Tue,1,1,17,18
2011-11-22,0,Nov,6,0,Tue,1,1,63,64
2011-11-22,0,Nov,7,0,Tue,1,2,119,121
2011-11-22,0,Nov,8,0,Tue,1,5,185,190
2011-11-22,0,Nov,9,0,Tue,1,2,147,149
2011-11-22,0,Nov,10,0,Tue,1,6,46,52
2011-11-22,0,Nov,11,0,Tue,1,4,28,32
2011-11-22,0,Nov,12,0,Tue,1,3,18,21
2011-11-22,0,Nov,13,0,Tue,1,4,22,26
2011-11-22,0,Nov,14,0,Tue,1,4,31,35
2011-11-22,0,Nov,15,0,Tue,1,2,32,34
2011-11-22,0,Nov,16,0,Tue,1,3,59,62
2011-11-22,0,Nov,17,0,Tue,1,4,161,165
2011-11-22,0,Nov,18,0,Tue,1,0,148,148
2011-11-22,0,Nov,19,0,Tue,1,5,106,111
2011-11-22,0,Nov,20,0,Tue,1,6,121,127
2011-11-22,0,Nov,21,0,Tue,1,4,86,90
2011-11-22,0,Nov,22,0,Tue,1,6,81,87
2011-11-22,0,Nov,23,0,Tue,1,3,36,39
2011-11-23,0,Nov,0,0,Wed,1,2,14,16
2011-11-23,0,Nov,1,0,Wed,1,0,8,8
2011-11-23,0,Nov,2,0,Wed,1,1,5,6
2011-11-23,0,Nov,3,0,Wed,1,1,2,3
2011-11-23,0,Nov,4,0,Wed,1,0,5,5
2011-11-23,0,Nov,5,0,Wed,1,1,16,17
2011-11-23,0,Nov,6,0,Wed,1,1,68,69
2011-11-23,0,Nov,7,0,Wed,1,2,154,156
2011-11-23,0,Nov,8,0,Wed,1,7,316,323
2011-11-23,0,Nov,9,0,Wed,1,3,164,167
2011-11-23,0,Nov,10,0,Wed,1,6,70,76
2011-11-23,0,Nov,11,0,Wed,1,9,107,116
2011-11-23,0,Nov,12,0,Wed,1,9,151,160
2011-11-23,0,Nov,13,0,Wed,1,12,162,174
2011-11-23,0,Nov,14,0,Wed,1,13,200,213
2011-11-23,0,Nov,15,0,Wed,1,13,194,207
2011-11-23,0,Nov,16,0,Wed,1,4,169,173
2011-11-23,0,Nov,17,0,Wed,1,7,156,163
2011-11-23,0,Nov,18,0,Wed,1,7,138,145
2011-11-23,0,Nov,19,0,Wed,1,6,116,122
2011-11-23,0,Nov,20,0,Wed,1,1,67,68
2011-11-23,0,Nov,21,0,Wed,1,0,66,66
2011-11-23,0,Nov,22,0,Wed,1,3,59,62
2011-11-23,0,Nov,23,0,Wed,1,4,47,51
2011-11-24,0,Nov,0,1,Thur,0,1,22,23
2011-11-24,0,Nov,1,1,Thur,0,1,23,24
2011-11-24,0,Nov,2,1,Thur,0,3,19,22
2011-11-24,0,Nov,3,1,Thur,0,1,4,5
2011-11-24,0,Nov,4,1,Thur,0,1,1,2
2011-11-24,0,Nov,5,1,Thur,0,1,10,11
2011-11-24,0,Nov,6,1,Thur,0,1,5,6
2011-11-24,0,Nov,7,1,Thur,0,9,31,40
2011-11-24,0,Nov,8,1,Thur,0,4,42,46
2011-11-24,0,Nov,9,1,Thur,0,13,68,81
2011-11-24,0,Nov,10,1,Thur,0,34,64,98
2011-11-24,0,Nov,11,1,Thur,0,52,90,142
2011-11-24,0,Nov,12,1,Thur,0,62,88,150
2011-11-24,0,Nov,13,1,Thur,0,84,91,175
2011-11-24,0,Nov,14,1,Thur,0,74,94,168
2011-11-24,0,Nov,15,1,Thur,0,78,71,149
2011-11-24,0,Nov,16,1,Thur,0,48,66,114
2011-11-24,0,Nov,17,1,Thur,0,34,40,74
2011-11-24,0,Nov,18,1,Thur,0,13,24,37
2011-11-24,0,Nov,19,1,Thur,0,15,13,28
2011-11-24,0,Nov,20,1,Thur,0,14,17,31
2011-11-24,0,Nov,21,1,Thur,0,7,19,26
2011-11-24,0,Nov,22,1,Thur,0,8,14,22
2011-11-24,0,Nov,23,1,Thur,0,2,19,21
2011-11-25,0,Nov,0,0,Fri,1,7,22,29
2011-11-25,0,Nov,1,0,Fri,1,2,12,14
2011-11-25,0,Nov,2,0,Fri,1,4,6,10
2011-11-25,0,Nov,3,0,Fri,1,0,2,2
2011-11-25,0,Nov,4,0,Fri,1,4,3,7
2011-11-25,0,Nov,5,0,Fri,1,2,3,5
2011-11-25,0,Nov,6,0,Fri,1,4,9,13
2011-11-25,0,Nov,7,0,Fri,1,4,31,35
2011-11-25,0,Nov,8,0,Fri,1,6,68,74
2011-11-25,0,Nov,9,0,Fri,1,25,70,95
2011-11-25,0,Nov,10,0,Fri,1,60,82,142
2011-11-25,0,Nov,11,0,Fri,1,99,127,226
2011-11-25,0,Nov,12,0,Fri,1,126,146,272
2011-11-25,0,Nov,13,0,Fri,1,143,140,283
2011-11-25,0,Nov,14,0,Fri,1,122,150,272
2011-11-25,0,Nov,15,0,Fri,1,165,145,310
2011-11-25,0,Nov,16,0,Fri,1,122,139,261
2011-11-25,0,Nov,17,0,Fri,1,57,127,184
2011-11-25,0,Nov,18,0,Fri,1,45,108,153
2011-11-25,0,Nov,19,0,Fri,1,38,96,134
2011-11-25,0,Nov,20,0,Fri,1,19,76,95
2011-11-25,0,Nov,21,0,Fri,1,24,61,85
2011-11-25,0,Nov,22,0,Fri,1,12,46,58
2011-11-25,0,Nov,23,0,Fri,1,5,28,33
2011-11-26,0,Nov,0,0,Sat,0,9,38,47
2011-11-26,0,Nov,1,0,Sat,0,5,24,29
2011-11-26,0,Nov,2,0,Sat,0,3,20,23
2011-11-26,0,Nov,3,0,Sat,0,8,9,17
2011-11-26,0,Nov,4,0,Sat,0,0,4,4
2011-11-26,0,Nov,5,0,Sat,0,0,3,3
2011-11-26,0,Nov,6,0,Sat,0,2,8,10
2011-11-26,0,Nov,7,0,Sat,0,4,13,17
2011-11-26,0,Nov,8,0,Sat,0,10,50,60
2011-11-26,0,Nov,9,0,Sat,0,16,67,83
2011-11-26,0,Nov,10,0,Sat,0,57,84,141
2011-11-26,0,Nov,11,0,Sat,0,107,123,230
2011-11-26,0,Nov,12,0,Sat,0,137,172,309
2011-11-26,0,Nov,13,0,Sat,0,177,148,325
2011-11-26,0,Nov,14,0,Sat,0,141,158,299
2011-11-26,0,Nov,15,0,Sat,0,154,160,314
2011-11-26,0,Nov,16,0,Sat,0,137,138,275
2011-11-26,0,Nov,17,0,Sat,0,62,122,184
2011-11-26,0,Nov,18,0,Sat,0,67,118,185
2011-11-26,0,Nov,19,0,Sat,0,46,100,146
2011-11-26,0,Nov,20,0,Sat,0,55,86,141
2011-11-26,0,Nov,21,0,Sat,0,20,72,92
2011-11-26,0,Nov,22,0,Sat,0,14,51,65
2011-11-26,0,Nov,23,0,Sat,0,18,51,69
2011-11-27,0,Nov,0,0,Sun,0,7,39,46
2011-11-27,0,Nov,1,0,Sun,0,9,35,44
2011-11-27,0,Nov,2,0,Sun,0,9,22,31
2011-11-27,0,Nov,3,0,Sun,0,9,8,17
2011-11-27,0,Nov,4,0,Sun,0,0,4,4
2011-11-27,0,Nov,5,0,Sun,0,0,5,5
2011-11-27,0,Nov,6,0,Sun,0,0,9,9
2011-11-27,0,Nov,7,0,Sun,0,12,11,23
2011-11-27,0,Nov,8,0,Sun,0,6,36,42
2011-11-27,0,Nov,9,0,Sun,0,21,90,111
2011-11-27,0,Nov,10,0,Sun,0,58,131,189
2011-11-27,0,Nov,11,0,Sun,0,83,157,240
2011-11-27,0,Nov,12,0,Sun,0,63,193,256
2011-11-27,0,Nov,13,0,Sun,0,97,216,313
2011-11-27,0,Nov,14,0,Sun,0,113,200,313
2011-11-27,0,Nov,15,0,Sun,0,96,221,317
2011-11-27,0,Nov,16,0,Sun,0,94,229,323
2011-11-27,0,Nov,17,0,Sun,0,37,167,204
2011-11-27,0,Nov,18,0,Sun,0,25,130,155
2011-11-27,0,Nov,19,0,Sun,0,30,109,139
2011-11-27,0,Nov,20,0,Sun,0,10,94,104
2011-11-27,0,Nov,21,0,Sun,0,13,75,88
2011-11-27,0,Nov,22,0,Sun,0,13,53,66
2011-11-27,0,Nov,23,0,Sun,0,5,27,32
2011-11-28,0,Nov,0,0,Mon,1,6,10,16
2011-11-28,0,Nov,1,0,Mon,1,1,12,13
2011-11-28,0,Nov,3,0,Mon,1,1,4,5
2011-11-28,0,Nov,4,0,Mon,1,0,4,4
2011-11-28,0,Nov,5,0,Mon,1,0,34,34
2011-11-28,0,Nov,6,0,Mon,1,6,98,104
2011-11-28,0,Nov,7,0,Mon,1,7,270,277
2011-11-28,0,Nov,8,0,Mon,1,13,394,407
2011-11-28,0,Nov,9,0,Mon,1,17,191,208
2011-11-28,0,Nov,10,0,Mon,1,21,86,107
2011-11-28,0,Nov,11,0,Mon,1,11,107,118
2011-11-28,0,Nov,12,0,Mon,1,13,165,178
2011-11-28,0,Nov,13,0,Mon,1,25,137,162
2011-11-28,0,Nov,14,0,Mon,1,14,129,143
2011-11-28,0,Nov,15,0,Mon,1,18,132,150
2011-11-28,0,Nov,16,0,Mon,1,24,240,264
2011-11-28,0,Nov,17,0,Mon,1,24,444,468
2011-11-28,0,Nov,18,0,Mon,1,20,396,416
2011-11-28,0,Nov,19,0,Mon,1,4,260,264
2011-11-28,0,Nov,20,0,Mon,1,12,206,218
2011-11-28,0,Nov,21,0,Mon,1,4,152,156
2011-11-28,0,Nov,22,0,Mon,1,7,102,109
2011-11-28,0,Nov,23,0,Mon,1,5,41,46
2011-11-29,0,Nov,0,0,Tue,1,4,18,22
2011-11-29,0,Nov,1,0,Tue,1,1,16,17
2011-11-29,0,Nov,2,0,Tue,1,0,5,5
2011-11-29,0,Nov,3,0,Tue,1,0,2,2
2011-11-29,0,Nov,4,0,Tue,1,1,5,6
2011-11-29,0,Nov,5,0,Tue,1,1,21,22
2011-11-29,0,Nov,6,0,Tue,1,1,88,89
2011-11-29,0,Nov,7,0,Tue,1,12,330,342
2011-11-29,0,Nov,8,0,Tue,1,9,440,449
2011-11-29,0,Nov,9,0,Tue,1,5,197,202
2011-11-29,0,Nov,10,0,Tue,1,2,34,36
2011-11-29,0,Nov,11,0,Tue,1,1,10,11
2011-11-29,0,Nov,12,0,Tue,1,1,17,18
2011-11-29,0,Nov,13,0,Tue,1,0,22,22
2011-11-29,0,Nov,14,0,Tue,1,1,35,36
2011-11-29,0,Nov,15,0,Tue,1,5,60,65
2011-11-29,0,Nov,16,0,Tue,1,5,146,151
2011-11-29,0,Nov,17,0,Tue,1,8,346,354
2011-11-29,0,Nov,18,0,Tue,1,11,347,358
2011-11-29,0,Nov,19,0,Tue,1,6,244,250
2011-11-29,0,Nov,20,0,Tue,1,8,176,184
2011-11-29,0,Nov,21,0,Tue,1,9,116,125
2011-11-29,0,Nov,22,0,Tue,1,5,90,95
2011-11-29,0,Nov,23,0,Tue,1,0,53,53
2011-11-30,0,Nov,0,0,Wed,1,1,23,24
2011-11-30,0,Nov,1,0,Wed,1,0,8,8
2011-11-30,0,Nov,2,0,Wed,1,0,5,5
2011-11-30,0,Nov,3,0,Wed,1,0,1,1
2011-11-30,0,Nov,4,0,Wed,1,0,5,5
2011-11-30,0,Nov,5,0,Wed,1,1,21,22
2011-11-30,0,Nov,6,0,Wed,1,3,100,103
2011-11-30,0,Nov,7,0,Wed,1,9,276,285
2011-11-30,0,Nov,8,0,Wed,1,13,465,478
2011-11-30,0,Nov,9,0,Wed,1,7,186,193
2011-11-30,0,Nov,10,0,Wed,1,15,95,110
2011-11-30,0,Nov,11,0,Wed,1,10,112,122
2011-11-30,0,Nov,12,0,Wed,1,12,148,160
2011-11-30,0,Nov,13,0,Wed,1,16,131,147
2011-11-30,0,Nov,14,0,Wed,1,13,99,112
2011-11-30,0,Nov,15,0,Wed,1,11,104,115
2011-11-30,0,Nov,16,0,Wed,1,27,199,226
2011-11-30,0,Nov,17,0,Wed,1,15,365,380
2011-11-30,0,Nov,18,0,Wed,1,7,369,376
2011-11-30,0,Nov,19,0,Wed,1,6,273,279
2011-11-30,0,Nov,20,0,Wed,1,6,184,190
2011-11-30,0,Nov,21,0,Wed,1,7,128,135
2011-11-30,0,Nov,22,0,Wed,1,5,82,87
2011-11-30,0,Nov,23,0,Wed,1,4,46,50
2011-12-01,0,Dec,0,0,Thur,1,1,19,20
2011-12-01,0,Dec,1,0,Thur,1,1,9,10
2011-12-01,0,Dec,2,0,Thur,1,1,8,9
2011-12-01,0,Dec,3,0,Thur,1,1,6,7
2011-12-01,0,Dec,4,0,Thur,1,0,1,1
2011-12-01,0,Dec,5,0,Thur,1,1,23,24
2011-12-01,0,Dec,6,0,Thur,1,5,92,97
2011-12-01,0,Dec,7,0,Thur,1,11,265,276
2011-12-01,0,Dec,8,0,Thur,1,15,462,477
2011-12-01,0,Dec,9,0,Thur,1,9,215,224
2011-12-01,0,Dec,10,0,Thur,1,7,86,93
2011-12-01,0,Dec,11,0,Thur,1,7,95,102
2011-12-01,0,Dec,12,0,Thur,1,9,139,148
2011-12-01,0,Dec,13,0,Thur,1,17,137,154
2011-12-01,0,Dec,14,0,Thur,1,20,130,150
2011-12-01,0,Dec,15,0,Thur,1,10,144,154
2011-12-01,0,Dec,16,0,Thur,1,9,192,201
2011-12-01,0,Dec,17,0,Thur,1,9,409,418
2011-12-01,0,Dec,18,0,Thur,1,12,393,405
2011-12-01,0,Dec,19,0,Thur,1,9,219,228
2011-12-01,0,Dec,20,0,Thur,1,12,178,190
2011-12-01,0,Dec,21,0,Thur,1,8,154,162
2011-12-01,0,Dec,22,0,Thur,1,5,99,104
2011-12-01,0,Dec,23,0,Thur,1,3,70,73
2011-12-02,0,Dec,0,0,Fri,1,6,32,38
2011-12-02,0,Dec,1,0,Fri,1,1,14,15
2011-12-02,0,Dec,2,0,Fri,1,0,10,10
2011-12-02,0,Dec,3,0,Fri,1,0,1,1
2011-12-02,0,Dec,4,0,Fri,1,0,3,3
2011-12-02,0,Dec,5,0,Fri,1,0,23,23
2011-12-02,0,Dec,6,0,Fri,1,3,84,87
2011-12-02,0,Dec,7,0,Fri,1,6,199,205
2011-12-02,0,Dec,8,0,Fri,1,13,432,445
2011-12-02,0,Dec,9,0,Fri,1,12,234,246
2011-12-02,0,Dec,10,0,Fri,1,16,89,105
2011-12-02,0,Dec,11,0,Fri,1,18,142,160
2011-12-02,0,Dec,12,0,Fri,1,18,186,204
2011-12-02,0,Dec,13,0,Fri,1,19,188,207
2011-12-02,0,Dec,14,0,Fri,1,25,145,170
2011-12-02,0,Dec,15,0,Fri,1,24,175,199
2011-12-02,0,Dec,16,0,Fri,1,22,254,276
2011-12-02,0,Dec,17,0,Fri,1,20,391,411
2011-12-02,0,Dec,18,0,Fri,1,10,362,372
2011-12-02,0,Dec,19,0,Fri,1,13,252,265
2011-12-02,0,Dec,20,0,Fri,1,12,178,190
2011-12-02,0,Dec,21,0,Fri,1,9,102,111
2011-12-02,0,Dec,22,0,Fri,1,7,95,102
2011-12-02,0,Dec,23,0,Fri,1,14,81,95
2011-12-03,0,Dec,0,0,Sat,0,10,65,75
2011-12-03,0,Dec,1,0,Sat,0,9,62,71
2011-12-03,0,Dec,2,0,Sat,0,9,41,50
2011-12-03,0,Dec,3,0,Sat,0,4,5,9
2011-12-03,0,Dec,4,0,Sat,0,1,7,8
2011-12-03,0,Dec,5,0,Sat,0,0,6,6
2011-12-03,0,Dec,6,0,Sat,0,1,10,11
2011-12-03,0,Dec,7,0,Sat,0,2,24,26
2011-12-03,0,Dec,8,0,Sat,0,1,62,63
2011-12-03,0,Dec,9,0,Sat,0,25,99,124
2011-12-03,0,Dec,10,0,Sat,0,22,173,195
2011-12-03,0,Dec,11,0,Sat,0,48,227,275
2011-12-03,0,Dec,12,0,Sat,0,78,280,358
2011-12-03,0,Dec,13,0,Sat,0,70,222,292
2011-12-03,0,Dec,14,0,Sat,0,92,251,343
2011-12-03,0,Dec,15,0,Sat,0,100,237,337
2011-12-03,0,Dec,16,0,Sat,0,75,230,305
2011-12-03,0,Dec,17,0,Sat,0,46,186,232
2011-12-03,0,Dec,18,0,Sat,0,31,193,224
2011-12-03,0,Dec,19,0,Sat,0,31,144,175
2011-12-03,0,Dec,20,0,Sat,0,17,110,127
2011-12-03,0,Dec,21,0,Sat,0,5,104,109
2011-12-03,0,Dec,22,0,Sat,0,17,97,114
2011-12-03,0,Dec,23,0,Sat,0,12,73,85
2011-12-04,0,Dec,0,0,Sun,0,19,64,83
2011-12-04,0,Dec,1,0,Sun,0,20,54,74
2011-12-04,0,Dec,2,0,Sun,0,11,51,62
2011-12-04,0,Dec,3,0,Sun,0,7,34,41
2011-12-04,0,Dec,4,0,Sun,0,2,9,11
2011-12-04,0,Dec,5,0,Sun,0,2,2,4
2011-12-04,0,Dec,6,0,Sun,0,1,3,4
2011-12-04,0,Dec,7,0,Sun,0,3,23,26
2011-12-04,0,Dec,8,0,Sun,0,7,48,55
2011-12-04,0,Dec,9,0,Sun,0,12,114,126
2011-12-04,0,Dec,10,0,Sun,0,36,180,216
2011-12-04,0,Dec,11,0,Sun,0,48,206,254
2011-12-04,0,Dec,12,0,Sun,0,82,247,329
2011-12-04,0,Dec,13,0,Sun,0,88,269,357
2011-12-04,0,Dec,14,0,Sun,0,77,246,323
2011-12-04,0,Dec,15,0,Sun,0,69,227,296
2011-12-04,0,Dec,16,0,Sun,0,64,266,330
2011-12-04,0,Dec,17,0,Sun,0,38,207,245
2011-12-04,0,Dec,18,0,Sun,0,10,161,171
2011-12-04,0,Dec,19,0,Sun,0,15,158,173
2011-12-04,0,Dec,20,0,Sun,0,8,116,124
2011-12-04,0,Dec,21,0,Sun,0,7,65,72
2011-12-04,0,Dec,22,0,Sun,0,5,59,64
2011-12-04,0,Dec,23,0,Sun,0,3,42,45
2011-12-05,0,Dec,0,0,Mon,1,3,21,24
2011-12-05,0,Dec,1,0,Mon,1,2,10,12
2011-12-05,0,Dec,2,0,Mon,1,0,8,8
2011-12-05,0,Dec,3,0,Mon,1,0,2,2
2011-12-05,0,Dec,4,0,Mon,1,0,7,7
2011-12-05,0,Dec,5,0,Mon,1,1,24,25
2011-12-05,0,Dec,6,0,Mon,1,1,89,90
2011-12-05,0,Dec,7,0,Mon,1,9,274,283
2011-12-05,0,Dec,8,0,Mon,1,12,392,404
2011-12-05,0,Dec,9,0,Mon,1,12,178,190
2011-12-05,0,Dec,10,0,Mon,1,9,78,87
2011-12-05,0,Dec,11,0,Mon,1,17,106,123
2011-12-05,0,Dec,12,0,Mon,1,29,125,154
2011-12-05,0,Dec,13,0,Mon,1,18,153,171
2011-12-05,0,Dec,14,0,Mon,1,7,126,133
2011-12-05,0,Dec,15,0,Mon,1,16,132,148
2011-12-05,0,Dec,16,0,Mon,1,10,238,248
2011-12-05,0,Dec,17,0,Mon,1,16,430,446
2011-12-05,0,Dec,18,0,Mon,1,13,386,399
2011-12-05,0,Dec,19,0,Mon,1,13,295,308
2011-12-05,0,Dec,20,0,Mon,1,15,190,205
2011-12-05,0,Dec,21,0,Mon,1,10,166,176
2011-12-05,0,Dec,22,0,Mon,1,12,94,106
2011-12-05,0,Dec,23,0,Mon,1,8,54,62
2011-12-06,0,Dec,0,0,Tue,1,3,25,28
2011-12-06,0,Dec,1,0,Tue,1,2,14,16
2011-12-06,0,Dec,2,0,Tue,1,0,3,3
2011-12-06,0,Dec,3,0,Tue,1,0,3,3
2011-12-06,0,Dec,4,0,Tue,1,0,7,7
2011-12-06,0,Dec,5,0,Tue,1,0,20,20
2011-12-06,0,Dec,6,0,Tue,1,5,81,86
2011-12-06,0,Dec,7,0,Tue,1,7,227,234
2011-12-06,0,Dec,8,0,Tue,1,13,401,414
2011-12-06,0,Dec,9,0,Tue,1,4,200,204
2011-12-06,0,Dec,10,0,Tue,1,6,44,50
2011-12-06,0,Dec,11,0,Tue,1,4,28,32
2011-12-06,0,Dec,12,0,Tue,1,5,50,55
2011-12-06,0,Dec,13,0,Tue,1,6,65,71
2011-12-06,0,Dec,14,0,Tue,1,6,69,75
2011-12-06,0,Dec,15,0,Tue,1,2,43,45
2011-12-06,0,Dec,16,0,Tue,1,4,84,88
2011-12-06,0,Dec,17,0,Tue,1,13,249,262
2011-12-06,0,Dec,18,0,Tue,1,17,287,304
2011-12-06,0,Dec,19,0,Tue,1,10,223,233
2011-12-06,0,Dec,20,0,Tue,1,3,107,110
2011-12-06,0,Dec,21,0,Tue,1,6,108,114
2011-12-06,0,Dec,22,0,Tue,1,5,82,87
2011-12-06,0,Dec,23,0,Tue,1,5,48,53
2011-12-07,0,Dec,0,0,Wed,1,3,30,33
2011-12-07,0,Dec,1,0,Wed,1,4,9,13
2011-12-07,0,Dec,2,0,Wed,1,2,4,6
2011-12-07,0,Dec,3,0,Wed,1,0,3,3
2011-12-07,0,Dec,4,0,Wed,1,0,1,1
2011-12-07,0,Dec,5,0,Wed,1,0,3,3
2011-12-07,0,Dec,6,0,Wed,1,0,18,18
2011-12-07,0,Dec,7,0,Wed,1,3,43,46
2011-12-07,0,Dec,8,0,Wed,1,6,80,86
2011-12-07,0,Dec,9,0,Wed,1,0,64,64
2011-12-07,0,Dec,10,0,Wed,1,1,32,33
2011-12-07,0,Dec,11,0,Wed,1,3,47,50
2011-12-07,0,Dec,12,0,Wed,1,4,29,33
2011-12-07,0,Dec,13,0,Wed,1,5,28,33
2011-12-07,0,Dec,14,0,Wed,1,1,24,25
2011-12-07,0,Dec,15,0,Wed,1,5,25,30
2011-12-07,0,Dec,16,0,Wed,1,3,28,31
2011-12-07,0,Dec,17,0,Wed,1,4,48,52
2011-12-07,0,Dec,18,0,Wed,1,3,48,51
2011-12-07,0,Dec,19,0,Wed,1,2,31,33
2011-12-07,0,Dec,20,0,Wed,1,1,25,26
2011-12-07,0,Dec,21,0,Wed,1,0,6,6
2011-12-07,0,Dec,22,0,Wed,1,0,13,13
2011-12-07,0,Dec,23,0,Wed,1,0,16,16
2011-12-08,0,Dec,0,0,Thur,1,0,21,21
2011-12-08,0,Dec,1,0,Thur,1,1,6,7
2011-12-08,0,Dec,2,0,Thur,1,0,4,4
2011-12-08,0,Dec,3,0,Thur,1,0,1,1
2011-12-08,0,Dec,4,0,Thur,1,0,2,2
2011-12-08,0,Dec,5,0,Thur,1,0,12,12
2011-12-08,0,Dec,6,0,Thur,1,0,71,71
2011-12-08,0,Dec,7,0,Thur,1,11,233,244
2011-12-08,0,Dec,8,0,Thur,1,11,418,429
2011-12-08,0,Dec,9,0,Thur,1,7,218,225
2011-12-08,0,Dec,10,0,Thur,1,1,109,110
2011-12-08,0,Dec,11,0,Thur,1,6,100,106
2011-12-08,0,Dec,12,0,Thur,1,8,148,156
2011-12-08,0,Dec,13,0,Thur,1,9,115,124
2011-12-08,0,Dec,14,0,Thur,1,16,121,137
2011-12-08,0,Dec,15,0,Thur,1,19,98,117
2011-12-08,0,Dec,16,0,Thur,1,7,201,208
2011-12-08,0,Dec,17,0,Thur,1,10,321,331
2011-12-08,0,Dec,18,0,Thur,1,12,306,318
2011-12-08,0,Dec,19,0,Thur,1,12,220,232
2011-12-08,0,Dec,20,0,Thur,1,5,170,175
2011-12-08,0,Dec,21,0,Thur,1,4,135,139
2011-12-08,0,Dec,22,0,Thur,1,8,84,92
2011-12-08,0,Dec,23,0,Thur,1,3,58,61
2011-12-09,0,Dec,0,0,Fri,1,8,26,34
2011-12-09,0,Dec,1,0,Fri,1,2,12,14
2011-12-09,0,Dec,2,0,Fri,1,2,10,12
2011-12-09,0,Dec,3,0,Fri,1,1,5,6
2011-12-09,0,Dec,4,0,Fri,1,1,1,2
2011-12-09,0,Dec,5,0,Fri,1,0,20,20
2011-12-09,0,Dec,6,0,Fri,1,1,62,63
2011-12-09,0,Dec,7,0,Fri,1,4,195,199
2011-12-09,0,Dec,8,0,Fri,1,7,378,385
2011-12-09,0,Dec,9,0,Fri,1,8,256,264
2011-12-09,0,Dec,10,0,Fri,1,11,115,126
2011-12-09,0,Dec,11,0,Fri,1,15,121,136
2011-12-09,0,Dec,12,0,Fri,1,27,146,173
2011-12-09,0,Dec,13,0,Fri,1,27,141,168
2011-12-09,0,Dec,14,0,Fri,1,24,163,187
2011-12-09,0,Dec,15,0,Fri,1,29,160,189
2011-12-09,0,Dec,16,0,Fri,1,24,226,250
2011-12-09,0,Dec,17,0,Fri,1,10,352,362
2011-12-09,0,Dec,18,0,Fri,1,10,308,318
2011-12-09,0,Dec,19,0,Fri,1,10,189,199
2011-12-09,0,Dec,20,0,Fri,1,10,140,150
2011-12-09,0,Dec,21,0,Fri,1,9,131,140
2011-12-09,0,Dec,22,0,Fri,1,15,114,129
2011-12-09,0,Dec,23,0,Fri,1,6,88,94
2011-12-10,0,Dec,0,0,Sat,0,11,66,77
2011-12-10,0,Dec,1,0,Sat,0,11,55,66
2011-12-10,0,Dec,2,0,Sat,0,12,48,60
2011-12-10,0,Dec,3,0,Sat,0,5,20,25
2011-12-10,0,Dec,4,0,Sat,0,0,3,3
2011-12-10,0,Dec,5,0,Sat,0,0,6,6
2011-12-10,0,Dec,6,0,Sat,0,1,10,11
2011-12-10,0,Dec,7,0,Sat,0,0,11,11
2011-12-10,0,Dec,8,0,Sat,0,5,68,73
2011-12-10,0,Dec,9,0,Sat,0,15,134,149
2011-12-10,0,Dec,10,0,Sat,0,31,161,192
2011-12-10,0,Dec,11,0,Sat,0,44,192,236
2011-12-10,0,Dec,12,0,Sat,0,48,235,283
2011-12-10,0,Dec,13,0,Sat,0,47,239,286
2011-12-10,0,Dec,14,0,Sat,0,51,242,293
2011-12-10,0,Dec,15,0,Sat,0,60,239,299
2011-12-10,0,Dec,16,0,Sat,0,58,183,241
2011-12-10,0,Dec,17,0,Sat,0,34,151,185
2011-12-10,0,Dec,18,0,Sat,0,28,144,172
2011-12-10,0,Dec,19,0,Sat,0,15,139,154
2011-12-10,0,Dec,20,0,Sat,0,10,114,124
2011-12-10,0,Dec,21,0,Sat,0,4,79,83
2011-12-10,0,Dec,22,0,Sat,0,7,88,95
2011-12-10,0,Dec,23,0,Sat,0,5,61,66
2011-12-11,0,Dec,0,0,Sun,0,5,69,74
2011-12-11,0,Dec,1,0,Sun,0,8,54,62
2011-12-11,0,Dec,2,0,Sun,0,5,47,52
2011-12-11,0,Dec,3,0,Sun,0,2,17,19
2011-12-11,0,Dec,4,0,Sun,0,0,5,5
2011-12-11,0,Dec,5,0,Sun,0,0,6,6
2011-12-11,0,Dec,6,0,Sun,0,0,10,10
2011-12-11,0,Dec,7,0,Sun,0,1,30,31
2011-12-11,0,Dec,8,0,Sun,0,4,68,72
2011-12-11,0,Dec,9,0,Sun,0,19,88,107
2011-12-11,0,Dec,10,0,Sun,0,30,164,194
2011-12-11,0,Dec,11,0,Sun,0,31,166,197
2011-12-11,0,Dec,12,0,Sun,0,42,246,288
2011-12-11,0,Dec,13,0,Sun,0,44,224,268
2011-12-11,0,Dec,14,0,Sun,0,44,198,242
2011-12-11,0,Dec,15,0,Sun,0,47,219,266
2011-12-11,0,Dec,16,0,Sun,0,32,174,206
2011-12-11,0,Dec,17,0,Sun,0,13,150,163
2011-12-11,0,Dec,18,0,Sun,0,12,151,163
2011-12-11,0,Dec,19,0,Sun,0,7,98,105
2011-12-11,0,Dec,20,0,Sun,0,10,62,72
2011-12-11,0,Dec,21,0,Sun,0,10,53,63
2011-12-11,0,Dec,22,0,Sun,0,7,36,43
2011-12-11,0,Dec,23,0,Sun,0,4,31,35
2011-12-12,0,Dec,0,0,Mon,1,4,16,20
2011-12-12,0,Dec,1,0,Mon,1,0,9,9
2011-12-12,0,Dec,2,0,Mon,1,0,4,4
2011-12-12,0,Dec,3,0,Mon,1,0,2,2
2011-12-12,0,Dec,4,0,Mon,1,0,3,3
2011-12-12,0,Dec,5,0,Mon,1,0,21,21
2011-12-12,0,Dec,6,0,Mon,1,1,63,64
2011-12-12,0,Dec,7,0,Mon,1,4,231,235
2011-12-12,0,Dec,8,0,Mon,1,7,378,385
2011-12-12,0,Dec,9,0,Mon,1,12,208,220
2011-12-12,0,Dec,10,0,Mon,1,14,91,105
2011-12-12,0,Dec,11,0,Mon,1,15,100,115
2011-12-12,0,Dec,12,0,Mon,1,7,138,145
2011-12-12,0,Dec,13,0,Mon,1,13,153,166
2011-12-12,0,Dec,14,0,Mon,1,16,95,111
2011-12-12,0,Dec,15,0,Mon,1,8,124,132
2011-12-12,0,Dec,16,0,Mon,1,5,209,214
2011-12-12,0,Dec,17,0,Mon,1,7,352,359
2011-12-12,0,Dec,18,0,Mon,1,8,349,357
2011-12-12,0,Dec,19,0,Mon,1,9,232,241
2011-12-12,0,Dec,20,0,Mon,1,8,157,165
2011-12-12,0,Dec,21,0,Mon,1,2,119,121
2011-12-12,0,Dec,22,0,Mon,1,0,71,71
2011-12-12,0,Dec,23,0,Mon,1,3,42,45
2011-12-13,0,Dec,0,0,Tue,1,1,16,17
2011-12-13,0,Dec,1,0,Tue,1,0,4,4
2011-12-13,0,Dec,2,0,Tue,1,1,1,2
2011-12-13,0,Dec,3,0,Tue,1,0,3,3
2011-12-13,0,Dec,4,0,Tue,1,0,4,4
2011-12-13,0,Dec,5,0,Tue,1,0,20,20
2011-12-13,0,Dec,6,0,Tue,1,0,92,92
2011-12-13,0,Dec,7,0,Tue,1,2,221,223
2011-12-13,0,Dec,8,0,Tue,1,9,391,400
2011-12-13,0,Dec,9,0,Tue,1,10,223,233
2011-12-13,0,Dec,10,0,Tue,1,3,99,102
2011-12-13,0,Dec,11,0,Tue,1,9,115,124
2011-12-13,0,Dec,12,0,Tue,1,20,147,167
2011-12-13,0,Dec,13,0,Tue,1,7,120,127
2011-12-13,0,Dec,14,0,Tue,1,18,116,134
2011-12-13,0,Dec,15,0,Tue,1,7,144,151
2011-12-13,0,Dec,16,0,Tue,1,13,194,207
2011-12-13,0,Dec,17,0,Tue,1,17,381,398
2011-12-13,0,Dec,18,0,Tue,1,12,370,382
2011-12-13,0,Dec,19,0,Tue,1,5,262,267
2011-12-13,0,Dec,20,0,Tue,1,7,154,161
2011-12-13,0,Dec,21,0,Tue,1,5,134,139
2011-12-13,0,Dec,22,0,Tue,1,5,102,107
2011-12-13,0,Dec,23,0,Tue,1,4,55,59
2011-12-14,0,Dec,0,0,Wed,1,0,22,22
2011-12-14,0,Dec,1,0,Wed,1,0,8,8
2011-12-14,0,Dec,2,0,Wed,1,0,2,2
2011-12-14,0,Dec,3,0,Wed,1,0,3,3
2011-12-14,0,Dec,4,0,Wed,1,0,4,4
2011-12-14,0,Dec,5,0,Wed,1,0,26,26
2011-12-14,0,Dec,6,0,Wed,1,0,87,87
2011-12-14,0,Dec,7,0,Wed,1,4,243,247
2011-12-14,0,Dec,8,0,Wed,1,9,458,467
2011-12-14,0,Dec,9,0,Wed,1,9,230,239
2011-12-14,0,Dec,10,0,Wed,1,9,133,142
2011-12-14,0,Dec,11,0,Wed,1,12,103,115
2011-12-14,0,Dec,12,0,Wed,1,6,138,144
2011-12-14,0,Dec,13,0,Wed,1,14,119,133
2011-12-14,0,Dec,14,0,Wed,1,17,134,151
2011-12-14,0,Dec,15,0,Wed,1,24,143,167
2011-12-14,0,Dec,16,0,Wed,1,12,233,245
2011-12-14,0,Dec,17,0,Wed,1,19,377,396
2011-12-14,0,Dec,18,0,Wed,1,11,379,390
2011-12-14,0,Dec,19,0,Wed,1,9,259,268
2011-12-14,0,Dec,20,0,Wed,1,6,169,175
2011-12-14,0,Dec,21,0,Wed,1,9,145,154
2011-12-14,0,Dec,22,0,Wed,1,5,99,104
2011-12-14,0,Dec,23,0,Wed,1,3,48,51
2011-12-15,0,Dec,0,0,Thur,1,5,45,50
2011-12-15,0,Dec,1,0,Thur,1,5,15,20
2011-12-15,0,Dec,2,0,Thur,1,2,5,7
2011-12-15,0,Dec,3,0,Thur,1,1,2,3
2011-12-15,0,Dec,4,0,Thur,1,0,6,6
2011-12-15,0,Dec,5,0,Thur,1,0,24,24
2011-12-15,0,Dec,6,0,Thur,1,2,90,92
2011-12-15,0,Dec,7,0,Thur,1,6,252,258
2011-12-15,0,Dec,8,0,Thur,1,8,449,457
2011-12-15,0,Dec,9,0,Thur,1,6,274,280
2011-12-15,0,Dec,10,0,Thur,1,4,105,109
2011-12-15,0,Dec,11,0,Thur,1,9,126,135
2011-12-15,0,Dec,12,0,Thur,1,17,140,157
2011-12-15,0,Dec,13,0,Thur,1,14,150,164
2011-12-15,0,Dec,14,0,Thur,1,8,124,132
2011-12-15,0,Dec,15,0,Thur,1,6,76,82
2011-12-15,0,Dec,16,0,Thur,1,7,124,131
2011-12-15,0,Dec,17,0,Thur,1,14,310,324
2011-12-15,0,Dec,18,0,Thur,1,14,363,377
2011-12-15,0,Dec,19,0,Thur,1,13,274,287
2011-12-15,0,Dec,20,0,Thur,1,12,209,221
2011-12-15,0,Dec,21,0,Thur,1,10,145,155
2011-12-15,0,Dec,22,0,Thur,1,8,116,124
2011-12-15,0,Dec,23,0,Thur,1,10,104,114
2011-12-16,0,Dec,0,0,Fri,1,12,60,72
2011-12-16,0,Dec,1,0,Fri,1,3,28,31
2011-12-16,0,Dec,2,0,Fri,1,0,23,23
2011-12-16,0,Dec,3,0,Fri,1,2,3,5
2011-12-16,0,Dec,4,0,Fri,1,1,4,5
2011-12-16,0,Dec,5,0,Fri,1,0,26,26
2011-12-16,0,Dec,6,0,Fri,1,2,80,82
2011-12-16,0,Dec,7,0,Fri,1,5,226,231
2011-12-16,0,Dec,8,0,Fri,1,10,449,459
2011-12-16,0,Dec,9,0,Fri,1,8,235,243
2011-12-16,0,Dec,10,0,Fri,1,10,122,132
2011-12-16,0,Dec,11,0,Fri,1,9,135,144
2011-12-16,0,Dec,12,0,Fri,1,10,163,173
2011-12-16,0,Dec,13,0,Fri,1,12,125,137
2011-12-16,0,Dec,14,0,Fri,1,13,115,128
2011-12-16,0,Dec,15,0,Fri,1,12,141,153
2011-12-16,0,Dec,16,0,Fri,1,12,212,224
2011-12-16,0,Dec,17,0,Fri,1,13,352,365
2011-12-16,0,Dec,18,0,Fri,1,10,285,295
2011-12-16,0,Dec,19,0,Fri,1,11,203,214
2011-12-16,0,Dec,20,0,Fri,1,6,146,152
2011-12-16,0,Dec,21,0,Fri,1,7,95,102
2011-12-16,0,Dec,22,0,Fri,1,6,100,106
2011-12-16,0,Dec,23,0,Fri,1,4,71,75
2011-12-17,0,Dec,0,0,Sat,0,3,59,62
2011-12-17,0,Dec,1,0,Sat,0,4,39,43
2011-12-17,0,Dec,2,0,Sat,0,11,47,58
2011-12-17,0,Dec,3,0,Sat,0,4,22,26
2011-12-17,0,Dec,4,0,Sat,0,0,9,9
2011-12-17,0,Dec,5,0,Sat,0,2,7,9
2011-12-17,0,Dec,6,0,Sat,0,0,17,17
2011-12-17,0,Dec,7,0,Sat,0,0,20,20
2011-12-17,0,Dec,8,0,Sat,0,4,55,59
2011-12-17,0,Dec,9,0,Sat,0,5,95,100
2011-12-17,0,Dec,10,0,Sat,0,10,171,181
2011-12-17,0,Dec,11,0,Sat,0,21,188,209
2011-12-17,0,Dec,12,0,Sat,0,28,216,244
2011-12-17,0,Dec,13,0,Sat,0,32,204,236
2011-12-17,0,Dec,14,0,Sat,0,30,207,237
2011-12-17,0,Dec,15,0,Sat,0,33,195,228
2011-12-17,0,Dec,16,0,Sat,0,30,192,222
2011-12-17,0,Dec,17,0,Sat,0,12,153,165
2011-12-17,0,Dec,18,0,Sat,0,7,150,157
2011-12-17,0,Dec,19,0,Sat,0,11,95,106
2011-12-17,0,Dec,20,0,Sat,0,7,99,106
2011-12-17,0,Dec,21,0,Sat,0,8,88,96
2011-12-17,0,Dec,22,0,Sat,0,7,73,80
2011-12-17,0,Dec,23,0,Sat,0,6,63,69
2011-12-18,0,Dec,0,0,Sun,0,7,64,71
2011-12-18,0,Dec,1,0,Sun,0,3,43,46
2011-12-18,0,Dec,2,0,Sun,0,2,39,41
2011-12-18,0,Dec,3,0,Sun,0,2,16,18
2011-12-18,0,Dec,4,0,Sun,0,0,1,1
2011-12-18,0,Dec,5,0,Sun,0,1,4,5
2011-12-18,0,Dec,6,0,Sun,0,0,3,3
2011-12-18,0,Dec,7,0,Sun,0,1,11,12
2011-12-18,0,Dec,8,0,Sun,0,1,31,32
2011-12-18,0,Dec,9,0,Sun,0,6,75,81
2011-12-18,0,Dec,10,0,Sun,0,7,122,129
2011-12-18,0,Dec,11,0,Sun,0,20,168,188
2011-12-18,0,Dec,12,0,Sun,0,26,202,228
2011-12-18,0,Dec,13,0,Sun,0,18,210,228
2011-12-18,0,Dec,14,0,Sun,0,19,200,219
2011-12-18,0,Dec,15,0,Sun,0,23,184,207
2011-12-18,0,Dec,16,0,Sun,0,27,207,234
2011-12-18,0,Dec,17,0,Sun,0,10,126,136
2011-12-18,0,Dec,18,0,Sun,0,15,123,138
2011-12-18,0,Dec,19,0,Sun,0,5,130,135
2011-12-18,0,Dec,20,0,Sun,0,10,94,104
2011-12-18,0,Dec,21,0,Sun,0,9,80,89
2011-12-18,0,Dec,22,0,Sun,0,2,47,49
2011-12-18,0,Dec,23,0,Sun,0,6,31,37
2011-12-19,0,Dec,0,0,Mon,1,3,14,17
2011-12-19,0,Dec,1,0,Mon,1,3,8,11
2011-12-19,0,Dec,2,0,Mon,1,0,3,3
2011-12-19,0,Dec,3,0,Mon,1,0,3,3
2011-12-19,0,Dec,4,0,Mon,1,0,4,4
2011-12-19,0,Dec,5,0,Mon,1,0,21,21
2011-12-19,0,Dec,6,0,Mon,1,0,68,68
2011-12-19,0,Dec,7,0,Mon,1,4,187,191
2011-12-19,0,Dec,8,0,Mon,1,8,389,397
2011-12-19,0,Dec,9,0,Mon,1,17,166,183
2011-12-19,0,Dec,10,0,Mon,1,12,96,108
2011-12-19,0,Dec,11,0,Mon,1,22,105,127
2011-12-19,0,Dec,12,0,Mon,1,13,128,141
2011-12-19,0,Dec,13,0,Mon,1,15,127,142
2011-12-19,0,Dec,14,0,Mon,1,30,107,137
2011-12-19,0,Dec,15,0,Mon,1,24,135,159
2011-12-19,0,Dec,16,0,Mon,1,19,189,208
2011-12-19,0,Dec,17,0,Mon,1,16,362,378
2011-12-19,0,Dec,18,0,Mon,1,11,343,354
2011-12-19,0,Dec,19,0,Mon,1,17,234,251
2011-12-19,0,Dec,20,0,Mon,1,9,197,206
2011-12-19,0,Dec,21,0,Mon,1,15,112,127
2011-12-19,0,Dec,22,0,Mon,1,12,95,107
2011-12-19,0,Dec,23,0,Mon,1,10,50,60
2011-12-20,0,Dec,0,0,Tue,1,0,21,21
2011-12-20,0,Dec,1,0,Tue,1,0,6,6
2011-12-20,0,Dec,2,0,Tue,1,1,10,11
2011-12-20,0,Dec,3,0,Tue,1,1,1,2
2011-12-20,0,Dec,4,0,Tue,1,0,4,4
2011-12-20,0,Dec,5,0,Tue,1,0,15,15
2011-12-20,0,Dec,6,0,Tue,1,1,71,72
2011-12-20,0,Dec,7,0,Tue,1,7,261,268
2011-12-20,0,Dec,8,0,Tue,1,10,422,432
2011-12-20,0,Dec,9,0,Tue,1,14,245,259
2011-12-20,0,Dec,10,0,Tue,1,20,109,129
2011-12-20,0,Dec,11,0,Tue,1,13,116,129
2011-12-20,0,Dec,12,0,Tue,1,16,159,175
2011-12-20,0,Dec,13,0,Tue,1,18,163,181
2011-12-20,0,Dec,14,0,Tue,1,11,127,138
2011-12-20,0,Dec,15,0,Tue,1,15,139,154
2011-12-20,0,Dec,16,0,Tue,1,20,218,238
2011-12-20,0,Dec,17,0,Tue,1,14,417,431
2011-12-20,0,Dec,18,0,Tue,1,26,385,411
2011-12-20,0,Dec,19,0,Tue,1,6,218,224
2011-12-20,0,Dec,20,0,Tue,1,3,144,147
2011-12-20,0,Dec,21,0,Tue,1,4,139,143
2011-12-20,0,Dec,22,0,Tue,1,3,104,107
2011-12-20,0,Dec,23,0,Tue,1,13,40,53
2011-12-21,0,Dec,0,0,Wed,1,7,18,25
2011-12-21,0,Dec,1,0,Wed,1,1,10,11
2011-12-21,0,Dec,2,0,Wed,1,0,4,4
2011-12-21,0,Dec,3,0,Wed,1,0,2,2
2011-12-21,0,Dec,4,0,Wed,1,0,2,2
2011-12-21,0,Dec,5,0,Wed,1,0,28,28
2011-12-21,0,Dec,6,0,Wed,1,1,75,76
2011-12-21,0,Dec,7,0,Wed,1,5,224,229
2011-12-21,0,Dec,8,0,Wed,1,12,393,405
2011-12-21,0,Dec,9,0,Wed,1,14,220,234
2011-12-21,0,Dec,10,0,Wed,1,6,83,89
2011-12-21,0,Dec,11,0,Wed,1,3,53,56
2011-12-21,0,Dec,12,0,Wed,1,3,58,61
2011-12-21,0,Dec,13,0,Wed,1,3,55,58
2011-12-21,0,Dec,14,0,Wed,1,11,40,51
2011-12-21,0,Dec,15,0,Wed,1,4,57,61
2011-12-21,0,Dec,16,0,Wed,1,6,95,101
2011-12-21,0,Dec,17,0,Wed,1,3,226,229
2011-12-21,0,Dec,18,0,Wed,1,2,278,280
2011-12-21,0,Dec,19,0,Wed,1,9,200,209
2011-12-21,0,Dec,20,0,Wed,1,5,162,167
2011-12-21,0,Dec,21,0,Wed,1,9,114,123
2011-12-21,0,Dec,22,0,Wed,1,3,102,105
2011-12-21,0,Dec,23,0,Wed,1,0,54,54
2011-12-22,0,Dec,0,0,Thur,1,3,24,27
2011-12-22,0,Dec,1,0,Thur,1,0,15,15
2011-12-22,0,Dec,2,0,Thur,1,1,10,11
2011-12-22,0,Dec,3,0,Thur,1,0,6,6
2011-12-22,0,Dec,4,0,Thur,1,0,3,3
2011-12-22,0,Dec,5,0,Thur,1,1,15,16
2011-12-22,0,Dec,6,0,Thur,1,1,63,64
2011-12-22,0,Dec,7,0,Thur,1,4,182,186
2011-12-22,0,Dec,8,0,Thur,1,10,333,343
2011-12-22,0,Dec,9,0,Thur,1,10,218,228
2011-12-22,0,Dec,10,0,Thur,1,13,128,141
2011-12-22,0,Dec,11,0,Thur,1,10,135,145
2011-12-22,0,Dec,12,0,Thur,1,22,180,202
2011-12-22,0,Dec,13,0,Thur,1,21,167,188
2011-12-22,0,Dec,14,0,Thur,1,23,136,159
2011-12-22,0,Dec,15,0,Thur,1,28,186,214
2011-12-22,0,Dec,16,0,Thur,1,30,226,256
2011-12-22,0,Dec,17,0,Thur,1,24,332,356
2011-12-22,0,Dec,18,0,Thur,1,11,277,288
2011-12-22,0,Dec,19,0,Thur,1,12,130,142
2011-12-22,0,Dec,20,0,Thur,1,0,33,33
2011-12-22,0,Dec,21,0,Thur,1,2,15,17
2011-12-22,0,Dec,22,0,Thur,1,0,17,17
2011-12-22,0,Dec,23,0,Thur,1,1,10,11
2011-12-23,0,Dec,0,0,Fri,1,2,7,9
2011-12-23,0,Dec,1,0,Fri,1,1,11,12
2011-12-23,0,Dec,2,0,Fri,1,1,12,13
2011-12-23,0,Dec,3,0,Fri,1,0,4,4
2011-12-23,0,Dec,4,0,Fri,1,0,2,2
2011-12-23,0,Dec,5,0,Fri,1,0,8,8
2011-12-23,0,Dec,6,0,Fri,1,0,40,40
2011-12-23,0,Dec,7,0,Fri,1,4,88,92
2011-12-23,0,Dec,8,0,Fri,1,9,173,182
2011-12-23,0,Dec,9,0,Fri,1,4,152,156
2011-12-23,0,Dec,10,0,Fri,1,8,96,104
2011-12-23,0,Dec,11,0,Fri,1,26,148,174
2011-12-23,0,Dec,12,0,Fri,1,14,156,170
2011-12-23,0,Dec,13,0,Fri,1,17,177,194
2011-12-23,0,Dec,14,0,Fri,1,23,177,200
2011-12-23,0,Dec,15,0,Fri,1,12,191,203
2011-12-23,0,Dec,16,0,Fri,1,15,166,181
2011-12-23,0,Dec,17,0,Fri,1,11,129,140
2011-12-23,0,Dec,18,0,Fri,1,4,91,95
2011-12-23,0,Dec,19,0,Fri,1,1,75,76
2011-12-23,0,Dec,20,0,Fri,1,3,47,50
2011-12-23,0,Dec,21,0,Fri,1,0,32,32
2011-12-23,0,Dec,22,0,Fri,1,4,43,47
2011-12-23,0,Dec,23,0,Fri,1,4,21,25
2011-12-24,0,Dec,0,0,Sat,0,3,20,23
2011-12-24,0,Dec,1,0,Sat,0,1,15,16
2011-12-24,0,Dec,2,0,Sat,0,4,22,26
2011-12-24,0,Dec,3,0,Sat,0,0,5,5
2011-12-24,0,Dec,4,0,Sat,0,0,3,3
2011-12-24,0,Dec,5,0,Sat,0,1,3,4
2011-12-24,0,Dec,6,0,Sat,0,0,10,10
2011-12-24,0,Dec,7,0,Sat,0,0,10,10
2011-12-24,0,Dec,8,0,Sat,0,0,27,27
2011-12-24,0,Dec,9,0,Sat,0,3,53,56
2011-12-24,0,Dec,10,0,Sat,0,4,52,56
2011-12-24,0,Dec,11,0,Sat,0,9,62,71
2011-12-24,0,Dec,12,0,Sat,0,15,79,94
2011-12-24,0,Dec,13,0,Sat,0,24,97,121
2011-12-24,0,Dec,14,0,Sat,0,15,70,85
2011-12-24,0,Dec,15,0,Sat,0,15,82,97
2011-12-24,0,Dec,16,0,Sat,0,25,74,99
2011-12-24,0,Dec,17,0,Sat,0,15,53,68
2011-12-24,0,Dec,18,0,Sat,0,2,33,35
2011-12-24,0,Dec,19,0,Sat,0,1,24,25
2011-12-24,0,Dec,20,0,Sat,0,5,19,24
2011-12-24,0,Dec,21,0,Sat,0,4,15,19
2011-12-24,0,Dec,22,0,Sat,0,8,12,20
2011-12-24,0,Dec,23,0,Sat,0,1,16,17
2011-12-25,0,Dec,0,0,Sun,0,2,4,6
2011-12-25,0,Dec,1,0,Sun,0,2,2,4
2011-12-25,0,Dec,2,0,Sun,0,0,2,2
2011-12-25,0,Dec,3,0,Sun,0,1,3,4
2011-12-25,0,Dec,5,0,Sun,0,0,1,1
2011-12-25,0,Dec,6,0,Sun,0,0,1,1
2011-12-25,0,Dec,7,0,Sun,0,0,4,4
2011-12-25,0,Dec,8,0,Sun,0,1,4,5
2011-12-25,0,Dec,9,0,Sun,0,3,20,23
2011-12-25,0,Dec,10,0,Sun,0,31,12,43
2011-12-25,0,Dec,11,0,Sun,0,43,42,85
2011-12-25,0,Dec,12,0,Sun,0,25,41,66
2011-12-25,0,Dec,13,0,Sun,0,40,39,79
2011-12-25,0,Dec,14,0,Sun,0,41,45,86
2011-12-25,0,Dec,15,0,Sun,0,43,48,91
2011-12-25,0,Dec,16,0,Sun,0,35,51,86
2011-12-25,0,Dec,17,0,Sun,0,11,33,44
2011-12-25,0,Dec,18,0,Sun,0,7,23,30
2011-12-25,0,Dec,19,0,Sun,0,2,14,16
2011-12-25,0,Dec,20,0,Sun,0,8,18,26
2011-12-25,0,Dec,21,0,Sun,0,4,15,19
2011-12-25,0,Dec,22,0,Sun,0,2,15,17
2011-12-25,0,Dec,23,0,Sun,0,2,14,16
2011-12-26,0,Dec,0,1,Mon,0,5,6,11
2011-12-26,0,Dec,1,1,Mon,0,3,7,10
2011-12-26,0,Dec,2,1,Mon,0,2,5,7
2011-12-26,0,Dec,4,1,Mon,0,0,2,2
2011-12-26,0,Dec,5,1,Mon,0,0,4,4
2011-12-26,0,Dec,6,1,Mon,0,0,4,4
2011-12-26,0,Dec,7,1,Mon,0,2,17,19
2011-12-26,0,Dec,8,1,Mon,0,5,13,18
2011-12-26,0,Dec,9,1,Mon,0,24,38,62
2011-12-26,0,Dec,10,1,Mon,0,31,39,70
2011-12-26,0,Dec,11,1,Mon,0,40,51,91
2011-12-26,0,Dec,12,1,Mon,0,34,66,100
2011-12-26,0,Dec,13,1,Mon,0,57,83,140
2011-12-26,0,Dec,14,1,Mon,0,73,80,153
2011-12-26,0,Dec,15,1,Mon,0,26,105,131
2011-12-26,0,Dec,16,1,Mon,0,28,69,97
2011-12-26,0,Dec,17,1,Mon,0,30,67,97
2011-12-26,0,Dec,18,1,Mon,0,21,54,75
2011-12-26,0,Dec,19,1,Mon,0,16,49,65
2011-12-26,0,Dec,20,1,Mon,0,14,42,56
2011-12-26,0,Dec,21,1,Mon,0,10,39,49
2011-12-26,0,Dec,22,1,Mon,0,5,22,27
2011-12-26,0,Dec,23,1,Mon,0,4,25,29
2011-12-27,0,Dec,0,0,Tue,1,3,9,12
2011-12-27,0,Dec,1,0,Tue,1,0,6,6
2011-12-27,0,Dec,2,0,Tue,1,2,2,4
2011-12-27,0,Dec,3,0,Tue,1,0,3,3
2011-12-27,0,Dec,4,0,Tue,1,0,3,3
2011-12-27,0,Dec,5,0,Tue,1,0,8,8
2011-12-27,0,Dec,6,0,Tue,1,0,35,35
2011-12-27,0,Dec,7,0,Tue,1,1,79,80
2011-12-27,0,Dec,8,0,Tue,1,9,155,164
2011-12-27,0,Dec,9,0,Tue,1,19,85,104
2011-12-27,0,Dec,10,0,Tue,1,13,47,60
2011-12-27,0,Dec,11,0,Tue,1,6,24,30
2011-12-27,0,Dec,12,0,Tue,1,8,16,24
2011-12-27,0,Dec,13,0,Tue,1,1,19,20
2011-12-27,0,Dec,14,0,Tue,1,0,14,14
2011-12-27,0,Dec,15,0,Tue,1,2,17,19
2011-12-27,0,Dec,16,0,Tue,1,2,44,46
2011-12-27,0,Dec,17,0,Tue,1,6,109,115
2011-12-27,0,Dec,18,0,Tue,1,9,126,135
2011-12-27,0,Dec,19,0,Tue,1,3,87,90
2011-12-27,0,Dec,20,0,Tue,1,3,66,69
2011-12-27,0,Dec,21,0,Tue,1,11,52,63
2011-12-27,0,Dec,22,0,Tue,1,3,29,32
2011-12-27,0,Dec,23,0,Tue,1,2,24,26
2011-12-28,0,Dec,0,0,Wed,1,0,10,10
2011-12-28,0,Dec,1,0,Wed,1,0,12,12
2011-12-28,0,Dec,2,0,Wed,1,0,7,7
2011-12-28,0,Dec,3,0,Wed,1,0,4,4
2011-12-28,0,Dec,5,0,Wed,1,0,9,9
2011-12-28,0,Dec,6,0,Wed,1,1,42,43
2011-12-28,0,Dec,7,0,Wed,1,4,106,110
2011-12-28,0,Dec,8,0,Wed,1,11,206,217
2011-12-28,0,Dec,9,0,Wed,1,18,171,189
2011-12-28,0,Dec,10,0,Wed,1,12,84,96
2011-12-28,0,Dec,11,0,Wed,1,18,93,111
2011-12-28,0,Dec,12,0,Wed,1,32,108,140
2011-12-28,0,Dec,13,0,Wed,1,24,135,159
2011-12-28,0,Dec,14,0,Wed,1,24,96,120
2011-12-28,0,Dec,15,0,Wed,1,16,101,117
2011-12-28,0,Dec,16,0,Wed,1,23,144,167
2011-12-28,0,Dec,17,0,Wed,1,25,225,250
2011-12-28,0,Dec,18,0,Wed,1,10,159,169
2011-12-28,0,Dec,19,0,Wed,1,16,135,151
2011-12-28,0,Dec,20,0,Wed,1,9,70,79
2011-12-28,0,Dec,21,0,Wed,1,7,63,70
2011-12-28,0,Dec,22,0,Wed,1,2,31,33
2011-12-28,0,Dec,23,0,Wed,1,3,36,39
2011-12-29,0,Dec,0,0,Thur,1,4,24,28
2011-12-29,0,Dec,1,0,Thur,1,0,15,15
2011-12-29,0,Dec,2,0,Thur,1,0,3,3
2011-12-29,0,Dec,3,0,Thur,1,0,2,2
2011-12-29,0,Dec,4,0,Thur,1,1,2,3
2011-12-29,0,Dec,5,0,Thur,1,0,10,10
2011-12-29,0,Dec,6,0,Thur,1,2,39,41
2011-12-29,0,Dec,7,0,Thur,1,2,104,106
2011-12-29,0,Dec,8,0,Thur,1,3,207,210
2011-12-29,0,Dec,9,0,Thur,1,15,155,170
2011-12-29,0,Dec,10,0,Thur,1,13,97,110
2011-12-29,0,Dec,11,0,Thur,1,23,99,122
2011-12-29,0,Dec,12,0,Thur,1,12,118,130
2011-12-29,0,Dec,13,0,Thur,1,36,95,131
2011-12-29,0,Dec,14,0,Thur,1,30,112,142
2011-12-29,0,Dec,15,0,Thur,1,27,150,177
2011-12-29,0,Dec,16,0,Thur,1,22,155,177
2011-12-29,0,Dec,17,0,Thur,1,14,226,240
2011-12-29,0,Dec,18,0,Thur,1,15,192,207
2011-12-29,0,Dec,19,0,Thur,1,11,124,135
2011-12-29,0,Dec,20,0,Thur,1,8,88,96
2011-12-29,0,Dec,21,0,Thur,1,8,60,68
2011-12-29,0,Dec,22,0,Thur,1,7,48,55
2011-12-29,0,Dec,23,0,Thur,1,1,44,45
2011-12-30,0,Dec,0,0,Fri,1,4,26,30
2011-12-30,0,Dec,1,0,Fri,1,9,11,20
2011-12-30,0,Dec,2,0,Fri,1,2,10,12
2011-12-30,0,Dec,3,0,Fri,1,0,6,6
2011-12-30,0,Dec,4,0,Fri,1,0,2,2
2011-12-30,0,Dec,5,0,Fri,1,0,10,10
2011-12-30,0,Dec,6,0,Fri,1,1,31,32
2011-12-30,0,Dec,7,0,Fri,1,3,92,95
2011-12-30,0,Dec,8,0,Fri,1,12,193,205
2011-12-30,0,Dec,9,0,Fri,1,19,175,194
2011-12-30,0,Dec,10,0,Fri,1,10,108,118
2011-12-30,0,Dec,11,0,Fri,1,45,126,171
2011-12-30,0,Dec,12,0,Fri,1,38,159,197
2011-12-30,0,Dec,13,0,Fri,1,53,154,207
2011-12-30,0,Dec,14,0,Fri,1,67,178,245
2011-12-30,0,Dec,15,0,Fri,1,56,236,292
2011-12-30,0,Dec,16,0,Fri,1,36,247,283
2011-12-30,0,Dec,17,0,Fri,1,54,188,242
2011-12-30,0,Dec,18,0,Fri,1,19,163,182
2011-12-30,0,Dec,19,0,Fri,1,16,96,112
2011-12-30,0,Dec,20,0,Fri,1,16,75,91
2011-12-30,0,Dec,21,0,Fri,1,11,84,95
2011-12-30,0,Dec,22,0,Fri,1,7,78,85
2011-12-30,0,Dec,23,0,Fri,1,13,60,73
2011-12-31,0,Dec,0,0,Sat,0,7,37,44
2011-12-31,0,Dec,1,0,Sat,0,4,31,35
2011-12-31,0,Dec,2,0,Sat,0,1,27,28
2011-12-31,0,Dec,3,0,Sat,0,1,17,18
2011-12-31,0,Dec,4,0,Sat,0,1,9,10
2011-12-31,0,Dec,5,0,Sat,0,1,0,1
2011-12-31,0,Dec,6,0,Sat,0,1,5,6
2011-12-31,0,Dec,7,0,Sat,0,6,13,19
2011-12-31,0,Dec,8,0,Sat,0,7,42,49
2011-12-31,0,Dec,9,0,Sat,0,18,72,90
2011-12-31,0,Dec,10,0,Sat,0,20,108,128
2011-12-31,0,Dec,11,0,Sat,0,65,152,217
2011-12-31,0,Dec,12,0,Sat,0,93,180,273
2011-12-31,0,Dec,13,0,Sat,0,108,205,313
2011-12-31,0,Dec,14,0,Sat,0,115,185,300
2011-12-31,0,Dec,15,0,Sat,0,89,164,253
2011-12-31,0,Dec,16,0,Sat,0,52,143,195
2011-12-31,0,Dec,17,0,Sat,0,28,101,129
2011-12-31,0,Dec,18,0,Sat,0,13,80,93
2011-12-31,0,Dec,19,0,Sat,0,19,73,92
2011-12-31,0,Dec,20,0,Sat,0,8,63,71
2011-12-31,0,Dec,21,0,Sat,0,2,50,52
2011-12-31,0,Dec,22,0,Sat,0,2,36,38
2011-12-31,0,Dec,23,0,Sat,0,4,27,31
2012-01-01,1,Jan,0,0,Sun,0,5,43,48
2012-01-01,1,Jan,1,0,Sun,0,15,78,93
2012-01-01,1,Jan,2,0,Sun,0,16,59,75
2012-01-01,1,Jan,3,0,Sun,0,11,41,52
2012-01-01,1,Jan,4,0,Sun,0,0,8,8
2012-01-01,1,Jan,5,0,Sun,0,0,5,5
2012-01-01,1,Jan,6,0,Sun,0,1,1,2
2012-01-01,1,Jan,7,0,Sun,0,1,6,7
2012-01-01,1,Jan,8,0,Sun,0,4,10,14
2012-01-01,1,Jan,9,0,Sun,0,13,27,40
2012-01-01,1,Jan,10,0,Sun,0,18,52,70
2012-01-01,1,Jan,11,0,Sun,0,40,98,138
2012-01-01,1,Jan,12,0,Sun,0,58,143,201
2012-01-01,1,Jan,13,0,Sun,0,82,141,223
2012-01-01,1,Jan,14,0,Sun,0,120,147,267
2012-01-01,1,Jan,15,0,Sun,0,101,164,265
2012-01-01,1,Jan,16,0,Sun,0,68,147,215
2012-01-01,1,Jan,17,0,Sun,0,36,75,111
2012-01-01,1,Jan,18,0,Sun,0,25,81,106
2012-01-01,1,Jan,19,0,Sun,0,20,85,105
2012-01-01,1,Jan,20,0,Sun,0,25,58,83
2012-01-01,1,Jan,21,0,Sun,0,10,61,71
2012-01-01,1,Jan,22,0,Sun,0,13,53,66
2012-01-01,1,Jan,23,0,Sun,0,4,25,29
2012-01-02,1,Jan,0,1,Mon,0,8,31,39
2012-01-02,1,Jan,1,1,Mon,0,1,11,12
2012-01-02,1,Jan,2,1,Mon,0,1,6,7
2012-01-02,1,Jan,4,1,Mon,0,0,4,4
2012-01-02,1,Jan,5,1,Mon,0,1,3,4
2012-01-02,1,Jan,6,1,Mon,0,0,14,14
2012-01-02,1,Jan,7,1,Mon,0,0,16,16
2012-01-02,1,Jan,8,1,Mon,0,2,51,53
2012-01-02,1,Jan,9,1,Mon,0,15,53,68
2012-01-02,1,Jan,10,1,Mon,0,20,89,109
2012-01-02,1,Jan,11,1,Mon,0,33,142,175
2012-01-02,1,Jan,12,1,Mon,0,41,161,202
2012-01-02,1,Jan,13,1,Mon,0,26,150,176
2012-01-02,1,Jan,14,1,Mon,0,10,141,151
2012-01-02,1,Jan,15,1,Mon,0,29,139,168
2012-01-02,1,Jan,16,1,Mon,0,10,144,154
2012-01-02,1,Jan,17,1,Mon,0,17,136,153
2012-01-02,1,Jan,18,1,Mon,0,13,113,126
2012-01-02,1,Jan,19,1,Mon,0,4,89,93
2012-01-02,1,Jan,20,1,Mon,0,5,83,88
2012-01-02,1,Jan,21,1,Mon,0,3,63,66
2012-01-02,1,Jan,22,1,Mon,0,3,36,39
2012-01-02,1,Jan,23,1,Mon,0,2,32,34
2012-01-03,1,Jan,0,0,Tue,1,0,13,13
2012-01-03,1,Jan,1,0,Tue,1,1,5,6
2012-01-03,1,Jan,2,0,Tue,1,0,3,3
2012-01-03,1,Jan,3,0,Tue,1,0,2,2
2012-01-03,1,Jan,4,0,Tue,1,0,5,5
2012-01-03,1,Jan,5,0,Tue,1,0,12,12
2012-01-03,1,Jan,6,0,Tue,1,4,81,85
2012-01-03,1,Jan,7,0,Tue,1,2,168,170
2012-01-03,1,Jan,8,0,Tue,1,5,349,354
2012-01-03,1,Jan,9,0,Tue,1,8,145,153
2012-01-03,1,Jan,10,0,Tue,1,5,55,60
2012-01-03,1,Jan,11,0,Tue,1,12,63,75
2012-01-03,1,Jan,12,0,Tue,1,4,70,74
2012-01-03,1,Jan,13,0,Tue,1,5,68,73
2012-01-03,1,Jan,14,0,Tue,1,7,72,79
2012-01-03,1,Jan,15,0,Tue,1,9,68,77
2012-01-03,1,Jan,16,0,Tue,1,7,129,136
2012-01-03,1,Jan,17,0,Tue,1,4,241,245
2012-01-03,1,Jan,18,0,Tue,1,10,214,224
2012-01-03,1,Jan,19,0,Tue,1,4,152,156
2012-01-03,1,Jan,20,0,Tue,1,0,115,115
2012-01-03,1,Jan,21,0,Tue,1,2,66,68
2012-01-03,1,Jan,22,0,Tue,1,0,33,33
2012-01-03,1,Jan,23,0,Tue,1,0,18,18
2012-01-04,1,Jan,0,0,Wed,1,0,9,9
2012-01-04,1,Jan,1,0,Wed,1,0,3,3
2012-01-04,1,Jan,2,0,Wed,1,0,1,1
2012-01-04,1,Jan,3,0,Wed,1,0,1,1
2012-01-04,1,Jan,4,0,Wed,1,0,2,2
2012-01-04,1,Jan,5,0,Wed,1,0,14,14
2012-01-04,1,Jan,6,0,Wed,1,0,59,59
2012-01-04,1,Jan,7,0,Wed,1,1,151,152
2012-01-04,1,Jan,8,0,Wed,1,5,310,315
2012-01-04,1,Jan,9,0,Wed,1,7,173,180
2012-01-04,1,Jan,10,0,Wed,1,7,57,64
2012-01-04,1,Jan,11,0,Wed,1,6,40,46
2012-01-04,1,Jan,12,0,Wed,1,9,75,84
2012-01-04,1,Jan,13,0,Wed,1,9,82,91
2012-01-04,1,Jan,14,0,Wed,1,6,69,75
2012-01-04,1,Jan,15,0,Wed,1,9,81,90
2012-01-04,1,Jan,16,0,Wed,1,8,123,131
2012-01-04,1,Jan,17,0,Wed,1,9,272,281
2012-01-04,1,Jan,18,0,Wed,1,9,280,289
2012-01-04,1,Jan,19,0,Wed,1,2,182,184
2012-01-04,1,Jan,20,0,Wed,1,2,121,123
2012-01-04,1,Jan,21,0,Wed,1,2,88,90
2012-01-04,1,Jan,22,0,Wed,1,4,48,52
2012-01-04,1,Jan,23,0,Wed,1,0,32,32
2012-01-05,1,Jan,0,0,Thur,1,1,13,14
2012-01-05,1,Jan,1,0,Thur,1,0,5,5
2012-01-05,1,Jan,2,0,Thur,1,0,4,4
2012-01-05,1,Jan,3,0,Thur,1,0,4,4
2012-01-05,1,Jan,4,0,Thur,1,0,5,5
2012-01-05,1,Jan,5,0,Thur,1,0,26,26
2012-01-05,1,Jan,6,0,Thur,1,0,78,78
2012-01-05,1,Jan,7,0,Thur,1,3,212,215
2012-01-05,1,Jan,8,0,Thur,1,11,377,388
2012-01-05,1,Jan,9,0,Thur,1,7,220,227
2012-01-05,1,Jan,10,0,Thur,1,5,81,86
2012-01-05,1,Jan,11,0,Thur,1,6,78,84
2012-01-05,1,Jan,12,0,Thur,1,6,114,120
2012-01-05,1,Jan,13,0,Thur,1,6,112,118
2012-01-05,1,Jan,14,0,Thur,1,13,104,117
2012-01-05,1,Jan,15,0,Thur,1,6,113,119
2012-01-05,1,Jan,16,0,Thur,1,19,178,197
2012-01-05,1,Jan,17,0,Thur,1,19,393,412
2012-01-05,1,Jan,18,0,Thur,1,9,374,383
2012-01-05,1,Jan,19,0,Thur,1,10,255,265
2012-01-05,1,Jan,20,0,Thur,1,5,172,177
2012-01-05,1,Jan,21,0,Thur,1,9,88,97
2012-01-05,1,Jan,22,0,Thur,1,1,70,71
2012-01-05,1,Jan,23,0,Thur,1,4,56,60
2012-01-06,1,Jan,0,0,Fri,1,1,24,25
2012-01-06,1,Jan,1,0,Fri,1,2,6,8
2012-01-06,1,Jan,2,0,Fri,1,2,3,5
2012-01-06,1,Jan,3,0,Fri,1,1,3,4
2012-01-06,1,Jan,4,0,Fri,1,0,3,3
2012-01-06,1,Jan,5,0,Fri,1,0,13,13
2012-01-06,1,Jan,6,0,Fri,1,1,69,70
2012-01-06,1,Jan,7,0,Fri,1,4,201,205
2012-01-06,1,Jan,8,0,Fri,1,11,436,447
2012-01-06,1,Jan,9,0,Fri,1,4,237,241
2012-01-06,1,Jan,10,0,Fri,1,14,102,116
2012-01-06,1,Jan,11,0,Fri,1,8,130,138
2012-01-06,1,Jan,12,0,Fri,1,23,168,191
2012-01-06,1,Jan,13,0,Fri,1,16,188,204
2012-01-06,1,Jan,14,0,Fri,1,26,152,178
2012-01-06,1,Jan,15,0,Fri,1,44,178,222
2012-01-06,1,Jan,16,0,Fri,1,35,259,294
2012-01-06,1,Jan,17,0,Fri,1,20,456,476
2012-01-06,1,Jan,18,0,Fri,1,28,391,419
2012-01-06,1,Jan,19,0,Fri,1,11,261,272
2012-01-06,1,Jan,20,0,Fri,1,14,163,177
2012-01-06,1,Jan,21,0,Fri,1,17,137,154
2012-01-06,1,Jan,22,0,Fri,1,12,123,135
2012-01-06,1,Jan,23,0,Fri,1,13,88,101
2012-01-07,1,Jan,0,0,Sat,0,2,77,79
2012-01-07,1,Jan,1,0,Sat,0,6,56,62
2012-01-07,1,Jan,2,0,Sat,0,2,36,38
2012-01-07,1,Jan,3,0,Sat,0,1,19,20
2012-01-07,1,Jan,4,0,Sat,0,1,9,10
2012-01-07,1,Jan,5,0,Sat,0,2,7,9
2012-01-07,1,Jan,6,0,Sat,0,0,7,7
2012-01-07,1,Jan,7,0,Sat,0,0,20,20
2012-01-07,1,Jan,8,0,Sat,0,0,64,64
2012-01-07,1,Jan,9,0,Sat,0,14,116,130
2012-01-07,1,Jan,10,0,Sat,0,43,160,203
2012-01-07,1,Jan,11,0,Sat,0,74,250,324
2012-01-07,1,Jan,12,0,Sat,0,100,276,376
2012-01-07,1,Jan,13,0,Sat,0,149,296,445
2012-01-07,1,Jan,14,0,Sat,0,156,356,512
2012-01-07,1,Jan,15,0,Sat,0,132,317,449
2012-01-07,1,Jan,16,0,Sat,0,133,268,401
2012-01-07,1,Jan,17,0,Sat,0,87,235,322
2012-01-07,1,Jan,18,0,Sat,0,49,248,297
2012-01-07,1,Jan,19,0,Sat,0,44,171,215
2012-01-07,1,Jan,20,0,Sat,0,21,149,170
2012-01-07,1,Jan,21,0,Sat,0,22,118,140
2012-01-07,1,Jan,22,0,Sat,0,16,93,109
2012-01-07,1,Jan,23,0,Sat,0,16,103,119
2012-01-08,1,Jan,0,0,Sun,0,14,77,91
2012-01-08,1,Jan,1,0,Sun,0,10,62,72
2012-01-08,1,Jan,2,0,Sun,0,10,57,67
2012-01-08,1,Jan,3,0,Sun,0,6,26,32
2012-01-08,1,Jan,4,0,Sun,0,2,4,6
2012-01-08,1,Jan,5,0,Sun,0,0,2,2
2012-01-08,1,Jan,6,0,Sun,0,0,2,2
2012-01-08,1,Jan,7,0,Sun,0,1,23,24
2012-01-08,1,Jan,8,0,Sun,0,4,53,57
2012-01-08,1,Jan,9,0,Sun,0,23,102,125
2012-01-08,1,Jan,10,0,Sun,0,27,181,208
2012-01-08,1,Jan,11,0,Sun,0,55,201,256
2012-01-08,1,Jan,12,0,Sun,0,78,273,351
2012-01-08,1,Jan,13,0,Sun,0,77,266,343
2012-01-08,1,Jan,14,0,Sun,0,75,253,328
2012-01-08,1,Jan,15,0,Sun,0,89,241,330
2012-01-08,1,Jan,16,0,Sun,0,58,256,314
2012-01-08,1,Jan,17,0,Sun,0,22,197,219
2012-01-08,1,Jan,18,0,Sun,0,19,162,181
2012-01-08,1,Jan,19,0,Sun,0,8,104,112
2012-01-08,1,Jan,20,0,Sun,0,7,119,126
2012-01-08,1,Jan,21,0,Sun,0,10,81,91
2012-01-08,1,Jan,22,0,Sun,0,4,54,58
2012-01-08,1,Jan,23,0,Sun,0,0,30,30
2012-01-09,1,Jan,0,0,Mon,1,3,12,15
2012-01-09,1,Jan,1,0,Mon,1,1,4,5
2012-01-09,1,Jan,2,0,Mon,1,2,3,5
2012-01-09,1,Jan,3,0,Mon,1,0,3,3
2012-01-09,1,Jan,4,0,Mon,1,0,4,4
2012-01-09,1,Jan,5,0,Mon,1,0,21,21
2012-01-09,1,Jan,6,0,Mon,1,3,85,88
2012-01-09,1,Jan,7,0,Mon,1,1,239,240
2012-01-09,1,Jan,8,0,Mon,1,13,407,420
2012-01-09,1,Jan,9,0,Mon,1,9,188,197
2012-01-09,1,Jan,10,0,Mon,1,13,95,108
2012-01-09,1,Jan,11,0,Mon,1,6,82,88
2012-01-09,1,Jan,12,0,Mon,1,10,93,103
2012-01-09,1,Jan,13,0,Mon,1,3,77,80
2012-01-09,1,Jan,14,0,Mon,1,5,45,50
2012-01-09,1,Jan,15,0,Mon,1,5,64,69
2012-01-09,1,Jan,16,0,Mon,1,3,46,49
2012-01-09,1,Jan,17,0,Mon,1,5,147,152
2012-01-09,1,Jan,18,0,Mon,1,6,158,164
2012-01-09,1,Jan,19,0,Mon,1,3,187,190
2012-01-09,1,Jan,20,0,Mon,1,5,127,132
2012-01-09,1,Jan,21,0,Mon,1,1,78,79
2012-01-09,1,Jan,22,0,Mon,1,8,54,62
2012-01-09,1,Jan,23,0,Mon,1,1,51,52
2012-01-10,1,Jan,0,0,Tue,1,0,14,14
2012-01-10,1,Jan,1,0,Tue,1,2,3,5
2012-01-10,1,Jan,2,0,Tue,1,2,2,4
2012-01-10,1,Jan,4,0,Tue,1,0,4,4
2012-01-10,1,Jan,5,0,Tue,1,0,23,23
2012-01-10,1,Jan,6,0,Tue,1,0,79,79
2012-01-10,1,Jan,7,0,Tue,1,3,219,222
2012-01-10,1,Jan,8,0,Tue,1,6,465,471
2012-01-10,1,Jan,9,0,Tue,1,11,184,195
2012-01-10,1,Jan,10,0,Tue,1,3,80,83
2012-01-10,1,Jan,11,0,Tue,1,8,93,101
2012-01-10,1,Jan,12,0,Tue,1,13,127,140
2012-01-10,1,Jan,13,0,Tue,1,15,163,178
2012-01-10,1,Jan,14,0,Tue,1,10,96,106
2012-01-10,1,Jan,15,0,Tue,1,17,119,136
2012-01-10,1,Jan,16,0,Tue,1,15,225,240
2012-01-10,1,Jan,17,0,Tue,1,14,446,460
2012-01-10,1,Jan,18,0,Tue,1,13,372,385
2012-01-10,1,Jan,19,0,Tue,1,11,270,281
2012-01-10,1,Jan,20,0,Tue,1,10,190,200
2012-01-10,1,Jan,21,0,Tue,1,7,109,116
2012-01-10,1,Jan,22,0,Tue,1,10,104,114
2012-01-10,1,Jan,23,0,Tue,1,3,38,41
2012-01-11,1,Jan,0,0,Wed,1,2,26,28
2012-01-11,1,Jan,1,0,Wed,1,1,6,7
2012-01-11,1,Jan,2,0,Wed,1,0,5,5
2012-01-11,1,Jan,3,0,Wed,1,0,4,4
2012-01-11,1,Jan,4,0,Wed,1,0,2,2
2012-01-11,1,Jan,5,0,Wed,1,0,22,22
2012-01-11,1,Jan,6,0,Wed,1,2,72,74
2012-01-11,1,Jan,7,0,Wed,1,9,247,256
2012-01-11,1,Jan,8,0,Wed,1,11,488,499
2012-01-11,1,Jan,9,0,Wed,1,7,218,225
2012-01-11,1,Jan,10,0,Wed,1,13,84,97
2012-01-11,1,Jan,11,0,Wed,1,9,90,99
2012-01-11,1,Jan,12,0,Wed,1,4,51,55
2012-01-11,1,Jan,13,0,Wed,1,8,57,65
2012-01-11,1,Jan,14,0,Wed,1,3,70,73
2012-01-11,1,Jan,15,0,Wed,1,6,73,79
2012-01-11,1,Jan,16,0,Wed,1,6,112,118
2012-01-11,1,Jan,17,0,Wed,1,6,128,134
2012-01-11,1,Jan,18,0,Wed,1,2,96,98
2012-01-11,1,Jan,19,0,Wed,1,1,92,93
2012-01-11,1,Jan,20,0,Wed,1,2,55,57
2012-01-11,1,Jan,21,0,Wed,1,0,29,29
2012-01-11,1,Jan,22,0,Wed,1,0,49,49
2012-01-11,1,Jan,23,0,Wed,1,0,9,9
2012-01-12,1,Jan,0,0,Thur,1,0,3,3
2012-01-12,1,Jan,1,0,Thur,1,0,3,3
2012-01-12,1,Jan,2,0,Thur,1,1,1,2
2012-01-12,1,Jan,3,0,Thur,1,0,3,3
2012-01-12,1,Jan,4,0,Thur,1,0,2,2
2012-01-12,1,Jan,5,0,Thur,1,0,16,16
2012-01-12,1,Jan,6,0,Thur,1,1,88,89
2012-01-12,1,Jan,7,0,Thur,1,2,218,220
2012-01-12,1,Jan,8,0,Thur,1,11,497,508
2012-01-12,1,Jan,9,0,Thur,1,10,220,230
2012-01-12,1,Jan,10,0,Thur,1,6,84,90
2012-01-12,1,Jan,11,0,Thur,1,18,101,119
2012-01-12,1,Jan,12,0,Thur,1,14,130,144
2012-01-12,1,Jan,13,0,Thur,1,13,170,183
2012-01-12,1,Jan,14,0,Thur,1,24,132,156
2012-01-12,1,Jan,15,0,Thur,1,32,156,188
2012-01-12,1,Jan,16,0,Thur,1,33,248,281
2012-01-12,1,Jan,17,0,Thur,1,23,472,495
2012-01-12,1,Jan,18,0,Thur,1,22,399,421
2012-01-12,1,Jan,19,0,Thur,1,17,313,330
2012-01-12,1,Jan,20,0,Thur,1,11,229,240
2012-01-12,1,Jan,21,0,Thur,1,12,162,174
2012-01-12,1,Jan,22,0,Thur,1,12,121,133
2012-01-12,1,Jan,23,0,Thur,1,7,60,67
2012-01-13,1,Jan,0,0,Fri,1,4,38,42
2012-01-13,1,Jan,1,0,Fri,1,0,12,12
2012-01-13,1,Jan,2,0,Fri,1,1,13,14
2012-01-13,1,Jan,3,0,Fri,1,3,4,7
2012-01-13,1,Jan,4,0,Fri,1,1,2,3
2012-01-13,1,Jan,5,0,Fri,1,0,21,21
2012-01-13,1,Jan,6,0,Fri,1,2,71,73
2012-01-13,1,Jan,7,0,Fri,1,3,174,177
2012-01-13,1,Jan,8,0,Fri,1,11,408,419
2012-01-13,1,Jan,9,0,Fri,1,10,204,214
2012-01-13,1,Jan,10,0,Fri,1,2,101,103
2012-01-13,1,Jan,11,0,Fri,1,12,102,114
2012-01-13,1,Jan,12,0,Fri,1,14,140,154
2012-01-13,1,Jan,13,0,Fri,1,14,140,154
2012-01-13,1,Jan,14,0,Fri,1,10,119,129
2012-01-13,1,Jan,15,0,Fri,1,15,123,138
2012-01-13,1,Jan,16,0,Fri,1,18,215,233
2012-01-13,1,Jan,17,0,Fri,1,15,317,332
2012-01-13,1,Jan,18,0,Fri,1,7,294,301
2012-01-13,1,Jan,19,0,Fri,1,7,199,206
2012-01-13,1,Jan,20,0,Fri,1,6,130,136
2012-01-13,1,Jan,21,0,Fri,1,7,95,102
2012-01-13,1,Jan,22,0,Fri,1,7,58,65
2012-01-13,1,Jan,23,0,Fri,1,5,60,65
2012-01-14,1,Jan,0,0,Sat,0,2,42,44
2012-01-14,1,Jan,1,0,Sat,0,6,44,50
2012-01-14,1,Jan,2,0,Sat,0,6,32,38
2012-01-14,1,Jan,3,0,Sat,0,6,14,20
2012-01-14,1,Jan,4,0,Sat,0,0,3,3
2012-01-14,1,Jan,5,0,Sat,0,0,4,4
2012-01-14,1,Jan,6,0,Sat,0,0,5,5
2012-01-14,1,Jan,7,0,Sat,0,0,24,24
2012-01-14,1,Jan,8,0,Sat,0,3,89,92
2012-01-14,1,Jan,9,0,Sat,0,3,78,81
2012-01-14,1,Jan,10,0,Sat,0,14,135,149
2012-01-14,1,Jan,11,0,Sat,0,28,150,178
2012-01-14,1,Jan,12,0,Sat,0,30,189,219
2012-01-14,1,Jan,13,0,Sat,0,38,182,220
2012-01-14,1,Jan,14,0,Sat,0,52,179,231
2012-01-14,1,Jan,15,0,Sat,0,49,177,226
2012-01-14,1,Jan,16,0,Sat,0,28,178,206
2012-01-14,1,Jan,17,0,Sat,0,15,129,144
2012-01-14,1,Jan,18,0,Sat,0,21,122,143
2012-01-14,1,Jan,19,0,Sat,0,12,90,102
2012-01-14,1,Jan,20,0,Sat,0,8,95,103
2012-01-14,1,Jan,21,0,Sat,0,3,66,69
2012-01-14,1,Jan,22,0,Sat,0,4,62,66
2012-01-14,1,Jan,23,0,Sat,0,5,71,76
2012-01-15,1,Jan,0,0,Sun,0,9,50,59
2012-01-15,1,Jan,1,0,Sun,0,2,40,42
2012-01-15,1,Jan,2,0,Sun,0,5,38,43
2012-01-15,1,Jan,3,0,Sun,0,1,24,25
2012-01-15,1,Jan,4,0,Sun,0,1,5,6
2012-01-15,1,Jan,5,0,Sun,0,0,5,5
2012-01-15,1,Jan,6,0,Sun,0,1,7,8
2012-01-15,1,Jan,7,0,Sun,0,3,14,17
2012-01-15,1,Jan,8,0,Sun,0,2,34,36
2012-01-15,1,Jan,9,0,Sun,0,10,80,90
2012-01-15,1,Jan,10,0,Sun,0,11,115,126
2012-01-15,1,Jan,11,0,Sun,0,21,144,165
2012-01-15,1,Jan,12,0,Sun,0,42,192,234
2012-01-15,1,Jan,13,0,Sun,0,40,184,224
2012-01-15,1,Jan,14,0,Sun,0,25,163,188
2012-01-15,1,Jan,15,0,Sun,0,33,173,206
2012-01-15,1,Jan,16,0,Sun,0,31,174,205
2012-01-15,1,Jan,17,0,Sun,0,15,131,146
2012-01-15,1,Jan,18,0,Sun,0,7,113,120
2012-01-15,1,Jan,19,0,Sun,0,9,101,110
2012-01-15,1,Jan,20,0,Sun,0,10,85,95
2012-01-15,1,Jan,21,0,Sun,0,1,71,72
2012-01-15,1,Jan,22,0,Sun,0,2,58,60
2012-01-15,1,Jan,23,0,Sun,0,3,26,29
2012-01-16,1,Jan,0,1,Mon,0,2,23,25
2012-01-16,1,Jan,1,1,Mon,0,2,18,20
2012-01-16,1,Jan,2,1,Mon,0,3,14,17
2012-01-16,1,Jan,3,1,Mon,0,0,3,3
2012-01-16,1,Jan,4,1,Mon,0,2,6,8
2012-01-16,1,Jan,5,1,Mon,0,1,5,6
2012-01-16,1,Jan,6,1,Mon,0,0,13,13
2012-01-16,1,Jan,7,1,Mon,0,5,28,33
2012-01-16,1,Jan,8,1,Mon,0,3,75,78
2012-01-16,1,Jan,9,1,Mon,0,7,89,96
2012-01-16,1,Jan,10,1,Mon,0,19,107,126
2012-01-16,1,Jan,11,1,Mon,0,21,158,179
2012-01-16,1,Jan,12,1,Mon,0,20,165,185
2012-01-16,1,Jan,13,1,Mon,0,26,202,228
2012-01-16,1,Jan,14,1,Mon,0,23,158,181
2012-01-16,1,Jan,15,1,Mon,0,17,175,192
2012-01-16,1,Jan,16,1,Mon,0,22,158,180
2012-01-16,1,Jan,17,1,Mon,0,19,174,193
2012-01-16,1,Jan,18,1,Mon,0,6,175,181
2012-01-16,1,Jan,19,1,Mon,0,10,134,144
2012-01-16,1,Jan,20,1,Mon,0,2,88,90
2012-01-16,1,Jan,21,1,Mon,0,3,46,49
2012-01-16,1,Jan,22,1,Mon,0,4,39,43
2012-01-16,1,Jan,23,1,Mon,0,0,28,28
2012-01-17,1,Jan,0,0,Tue,1,0,12,12
2012-01-17,1,Jan,1,0,Tue,1,0,2,2
2012-01-17,1,Jan,2,0,Tue,1,0,12,12
2012-01-17,1,Jan,4,0,Tue,1,0,2,2
2012-01-17,1,Jan,5,0,Tue,1,0,13,13
2012-01-17,1,Jan,6,0,Tue,1,0,57,57
2012-01-17,1,Jan,7,0,Tue,1,5,121,126
2012-01-17,1,Jan,8,0,Tue,1,3,90,93
2012-01-17,1,Jan,9,0,Tue,1,7,61,68
2012-01-17,1,Jan,10,0,Tue,1,1,61,62
2012-01-17,1,Jan,11,0,Tue,1,2,73,75
2012-01-17,1,Jan,12,0,Tue,1,3,83,86
2012-01-17,1,Jan,13,0,Tue,1,8,95,103
2012-01-17,1,Jan,14,0,Tue,1,12,120,132
2012-01-17,1,Jan,15,0,Tue,1,6,123,129
2012-01-17,1,Jan,16,0,Tue,1,14,205,219
2012-01-17,1,Jan,17,0,Tue,1,20,442,462
2012-01-17,1,Jan,18,0,Tue,1,12,451,463
2012-01-17,1,Jan,19,0,Tue,1,11,297,308
2012-01-17,1,Jan,20,0,Tue,1,11,169,180
2012-01-17,1,Jan,21,0,Tue,1,6,174,180
2012-01-17,1,Jan,22,0,Tue,1,5,85,90
2012-01-17,1,Jan,23,0,Tue,1,1,60,61
2012-01-18,1,Jan,0,0,Wed,1,3,14,17
2012-01-18,1,Jan,1,0,Wed,1,0,10,10
2012-01-18,1,Jan,2,0,Wed,1,1,1,2
2012-01-18,1,Jan,3,0,Wed,1,1,3,4
2012-01-18,1,Jan,4,0,Wed,1,0,1,1
2012-01-18,1,Jan,5,0,Wed,1,0,29,29
2012-01-18,1,Jan,6,0,Wed,1,0,88,88
2012-01-18,1,Jan,7,0,Wed,1,1,262,263
2012-01-18,1,Jan,8,0,Wed,1,15,474,489
2012-01-18,1,Jan,9,0,Wed,1,6,196,202
2012-01-18,1,Jan,10,0,Wed,1,5,88,93
2012-01-18,1,Jan,11,0,Wed,1,4,110,114
2012-01-18,1,Jan,12,0,Wed,1,6,155,161
2012-01-18,1,Jan,13,0,Wed,1,6,124,130
2012-01-18,1,Jan,14,0,Wed,1,7,98,105
2012-01-18,1,Jan,15,0,Wed,1,8,122,130
2012-01-18,1,Jan,16,0,Wed,1,13,163,176
2012-01-18,1,Jan,17,0,Wed,1,8,338,346
2012-01-18,1,Jan,18,0,Wed,1,8,347,355
2012-01-18,1,Jan,19,0,Wed,1,5,251,256
2012-01-18,1,Jan,20,0,Wed,1,1,164,165
2012-01-18,1,Jan,21,0,Wed,1,5,119,124
2012-01-18,1,Jan,22,0,Wed,1,4,74,78
2012-01-18,1,Jan,23,0,Wed,1,2,36,38
2012-01-19,1,Jan,0,0,Thur,1,0,16,16
2012-01-19,1,Jan,1,0,Thur,1,0,5,5
2012-01-19,1,Jan,2,0,Thur,1,0,3,3
2012-01-19,1,Jan,3,0,Thur,1,0,4,4
2012-01-19,1,Jan,4,0,Thur,1,0,1,1
2012-01-19,1,Jan,5,0,Thur,1,0,19,19
2012-01-19,1,Jan,6,0,Thur,1,0,86,86
2012-01-19,1,Jan,7,0,Thur,1,2,204,206
2012-01-19,1,Jan,8,0,Thur,1,9,414,423
2012-01-19,1,Jan,9,0,Thur,1,6,204,210
2012-01-19,1,Jan,10,0,Thur,1,10,98,108
2012-01-19,1,Jan,11,0,Thur,1,6,93,99
2012-01-19,1,Jan,12,0,Thur,1,5,106,111
2012-01-19,1,Jan,13,0,Thur,1,6,118,124
2012-01-19,1,Jan,14,0,Thur,1,15,104,119
2012-01-19,1,Jan,15,0,Thur,1,9,118,127
2012-01-19,1,Jan,16,0,Thur,1,8,185,193
2012-01-19,1,Jan,17,0,Thur,1,21,364,385
2012-01-19,1,Jan,18,0,Thur,1,16,345,361
2012-01-19,1,Jan,19,0,Thur,1,5,229,234
2012-01-19,1,Jan,20,0,Thur,1,7,184,191
2012-01-19,1,Jan,21,0,Thur,1,4,117,121
2012-01-19,1,Jan,22,0,Thur,1,0,90,90
2012-01-19,1,Jan,23,0,Thur,1,1,55,56
2012-01-20,1,Jan,0,0,Fri,1,3,24,27
2012-01-20,1,Jan,1,0,Fri,1,0,15,15
2012-01-20,1,Jan,2,0,Fri,1,0,11,11
2012-01-20,1,Jan,3,0,Fri,1,0,4,4
2012-01-20,1,Jan,4,0,Fri,1,0,3,3
2012-01-20,1,Jan,5,0,Fri,1,0,19,19
2012-01-20,1,Jan,6,0,Fri,1,0,68,68
2012-01-20,1,Jan,7,0,Fri,1,2,183,185
2012-01-20,1,Jan,8,0,Fri,1,4,421,425
2012-01-20,1,Jan,9,0,Fri,1,21,242,263
2012-01-20,1,Jan,10,0,Fri,1,1,96,97
2012-01-20,1,Jan,11,0,Fri,1,6,117,123
2012-01-20,1,Jan,12,0,Fri,1,5,119,124
2012-01-20,1,Jan,13,0,Fri,1,12,144,156
2012-01-20,1,Jan,14,0,Fri,1,8,107,115
2012-01-20,1,Jan,15,0,Fri,1,12,144,156
2012-01-20,1,Jan,16,0,Fri,1,11,163,174
2012-01-20,1,Jan,17,0,Fri,1,9,340,349
2012-01-20,1,Jan,18,0,Fri,1,5,296,301
2012-01-20,1,Jan,19,0,Fri,1,6,186,192
2012-01-20,1,Jan,20,0,Fri,1,1,141,142
2012-01-20,1,Jan,21,0,Fri,1,5,99,104
2012-01-20,1,Jan,22,0,Fri,1,1,71,72
2012-01-20,1,Jan,23,0,Fri,1,3,35,38
2012-01-21,1,Jan,0,0,Sat,0,0,24,24
2012-01-21,1,Jan,1,0,Sat,0,1,22,23
2012-01-21,1,Jan,2,0,Sat,0,1,25,26
2012-01-21,1,Jan,3,0,Sat,0,0,13,13
2012-01-21,1,Jan,4,0,Sat,0,0,1,1
2012-01-21,1,Jan,5,0,Sat,0,0,2,2
2012-01-21,1,Jan,6,0,Sat,0,0,1,1
2012-01-21,1,Jan,7,0,Sat,0,3,10,13
2012-01-21,1,Jan,8,0,Sat,0,3,22,25
2012-01-21,1,Jan,9,0,Sat,0,2,40,42
2012-01-21,1,Jan,10,0,Sat,0,0,45,45
2012-01-21,1,Jan,11,0,Sat,0,1,62,63
2012-01-21,1,Jan,12,0,Sat,0,5,62,67
2012-01-21,1,Jan,13,0,Sat,0,10,66,76
2012-01-21,1,Jan,14,0,Sat,0,6,89,95
2012-01-21,1,Jan,15,0,Sat,0,6,113,119
2012-01-21,1,Jan,16,0,Sat,0,5,113,118
2012-01-21,1,Jan,17,0,Sat,0,7,99,106
2012-01-21,1,Jan,18,0,Sat,0,3,107,110
2012-01-21,1,Jan,19,0,Sat,0,0,85,85
2012-01-21,1,Jan,20,0,Sat,0,5,62,67
2012-01-21,1,Jan,21,0,Sat,0,5,64,69
2012-01-21,1,Jan,22,0,Sat,0,3,56,59
2012-01-21,1,Jan,23,0,Sat,0,1,51,52
2012-01-22,1,Jan,0,0,Sun,0,1,51,52
2012-01-22,1,Jan,1,0,Sun,0,1,49,50
2012-01-22,1,Jan,2,0,Sun,0,1,46,47
2012-01-22,1,Jan,3,0,Sun,0,1,20,21
2012-01-22,1,Jan,4,0,Sun,0,1,1,2
2012-01-22,1,Jan,5,0,Sun,0,1,2,3
2012-01-22,1,Jan,6,0,Sun,0,0,4,4
2012-01-22,1,Jan,7,0,Sun,0,2,11,13
2012-01-22,1,Jan,8,0,Sun,0,3,29,32
2012-01-22,1,Jan,9,0,Sun,0,9,54,63
2012-01-22,1,Jan,10,0,Sun,0,9,120,129
2012-01-22,1,Jan,11,0,Sun,0,18,115,133
2012-01-22,1,Jan,12,0,Sun,0,24,161,185
2012-01-22,1,Jan,13,0,Sun,0,24,175,199
2012-01-22,1,Jan,14,0,Sun,0,19,163,182
2012-01-22,1,Jan,15,0,Sun,0,27,149,176
2012-01-22,1,Jan,16,0,Sun,0,12,143,155
2012-01-22,1,Jan,17,0,Sun,0,8,100,108
2012-01-22,1,Jan,18,0,Sun,0,11,110,121
2012-01-22,1,Jan,19,0,Sun,0,9,80,89
2012-01-22,1,Jan,20,0,Sun,0,5,69,74
2012-01-22,1,Jan,21,0,Sun,0,8,36,44
2012-01-22,1,Jan,22,0,Sun,0,0,58,58
2012-01-22,1,Jan,23,0,Sun,0,2,35,37
2012-01-23,1,Jan,0,0,Mon,1,2,17,19
2012-01-23,1,Jan,1,0,Mon,1,0,4,4
2012-01-23,1,Jan,2,0,Mon,1,0,2,2
2012-01-23,1,Jan,3,0,Mon,1,0,1,1
2012-01-23,1,Jan,4,0,Mon,1,0,1,1
2012-01-23,1,Jan,5,0,Mon,1,0,19,19
2012-01-23,1,Jan,6,0,Mon,1,6,36,42
2012-01-23,1,Jan,7,0,Mon,1,8,114,122
2012-01-23,1,Jan,8,0,Mon,1,5,267,272
2012-01-23,1,Jan,9,0,Mon,1,13,198,211
2012-01-23,1,Jan,10,0,Mon,1,10,139,149
2012-01-23,1,Jan,11,0,Mon,1,5,57,62
2012-01-23,1,Jan,12,0,Mon,1,10,52,62
2012-01-23,1,Jan,13,0,Mon,1,5,32,37
2012-01-23,1,Jan,14,0,Mon,1,13,48,61
2012-01-23,1,Jan,15,0,Mon,1,10,64,74
2012-01-23,1,Jan,16,0,Mon,1,14,108,122
2012-01-23,1,Jan,17,0,Mon,1,6,270,276
2012-01-23,1,Jan,18,0,Mon,1,7,275,282
2012-01-23,1,Jan,19,0,Mon,1,9,211,220
2012-01-23,1,Jan,20,0,Mon,1,8,161,169
2012-01-23,1,Jan,21,0,Mon,1,8,112,120
2012-01-23,1,Jan,22,0,Mon,1,4,64,68
2012-01-23,1,Jan,23,0,Mon,1,2,35,37
2012-01-24,1,Jan,0,0,Tue,1,6,19,25
2012-01-24,1,Jan,1,0,Tue,1,2,7,9
2012-01-24,1,Jan,2,0,Tue,1,2,6,8
2012-01-24,1,Jan,3,0,Tue,1,0,3,3
2012-01-24,1,Jan,4,0,Tue,1,0,2,2
2012-01-24,1,Jan,5,0,Tue,1,0,26,26
2012-01-24,1,Jan,6,0,Tue,1,1,88,89
2012-01-24,1,Jan,7,0,Tue,1,11,221,232
2012-01-24,1,Jan,8,0,Tue,1,11,479,490
2012-01-24,1,Jan,9,0,Tue,1,11,244,255
2012-01-24,1,Jan,10,0,Tue,1,23,93,116
2012-01-24,1,Jan,11,0,Tue,1,30,123,153
2012-01-24,1,Jan,12,0,Tue,1,25,150,175
2012-01-24,1,Jan,13,0,Tue,1,33,170,203
2012-01-24,1,Jan,14,0,Tue,1,35,138,173
2012-01-24,1,Jan,15,0,Tue,1,52,156,208
2012-01-24,1,Jan,16,0,Tue,1,35,243,278
2012-01-24,1,Jan,17,0,Tue,1,41,474,515
2012-01-24,1,Jan,18,0,Tue,1,32,391,423
2012-01-24,1,Jan,19,0,Tue,1,20,311,331
2012-01-24,1,Jan,20,0,Tue,1,18,211,229
2012-01-24,1,Jan,21,0,Tue,1,18,154,172
2012-01-24,1,Jan,22,0,Tue,1,14,111,125
2012-01-24,1,Jan,23,0,Tue,1,19,80,99
2012-01-25,1,Jan,0,0,Wed,1,6,25,31
2012-01-25,1,Jan,1,0,Wed,1,4,9,13
2012-01-25,1,Jan,2,0,Wed,1,3,3,6
2012-01-25,1,Jan,3,0,Wed,1,0,1,1
2012-01-25,1,Jan,4,0,Wed,1,0,4,4
2012-01-25,1,Jan,5,0,Wed,1,0,33,33
2012-01-25,1,Jan,6,0,Wed,1,1,87,88
2012-01-25,1,Jan,7,0,Wed,1,14,243,257
2012-01-25,1,Jan,8,0,Wed,1,18,495,513
2012-01-25,1,Jan,9,0,Wed,1,18,218,236
2012-01-25,1,Jan,10,0,Wed,1,30,111,141
2012-01-25,1,Jan,11,0,Wed,1,52,105,157
2012-01-25,1,Jan,12,0,Wed,1,46,147,193
2012-01-25,1,Jan,13,0,Wed,1,63,149,212
2012-01-25,1,Jan,14,0,Wed,1,53,107,160
2012-01-25,1,Jan,15,0,Wed,1,30,125,155
2012-01-25,1,Jan,16,0,Wed,1,29,217,246
2012-01-25,1,Jan,17,0,Wed,1,27,443,470
2012-01-25,1,Jan,18,0,Wed,1,24,415,439
2012-01-25,1,Jan,19,0,Wed,1,5,311,316
2012-01-25,1,Jan,20,0,Wed,1,10,225,235
2012-01-25,1,Jan,21,0,Wed,1,19,166,185
2012-01-25,1,Jan,22,0,Wed,1,12,101,113
2012-01-25,1,Jan,23,0,Wed,1,3,63,66
2012-01-26,1,Jan,0,0,Thur,1,3,22,25
2012-01-26,1,Jan,1,0,Thur,1,5,16,21
2012-01-26,1,Jan,2,0,Thur,1,1,6,7
2012-01-26,1,Jan,3,0,Thur,1,1,5,6
2012-01-26,1,Jan,4,0,Thur,1,0,3,3
2012-01-26,1,Jan,5,0,Thur,1,0,28,28
2012-01-26,1,Jan,6,0,Thur,1,0,88,88
2012-01-26,1,Jan,7,0,Thur,1,11,228,239
2012-01-26,1,Jan,8,0,Thur,1,16,514,530
2012-01-26,1,Jan,9,0,Thur,1,18,256,274
2012-01-26,1,Jan,10,0,Thur,1,16,92,108
2012-01-26,1,Jan,11,0,Thur,1,11,100,111
2012-01-26,1,Jan,12,0,Thur,1,29,136,165
2012-01-26,1,Jan,13,0,Thur,1,17,156,173
2012-01-26,1,Jan,14,0,Thur,1,16,112,128
2012-01-26,1,Jan,15,0,Thur,1,22,142,164
2012-01-26,1,Jan,16,0,Thur,1,15,209,224
2012-01-26,1,Jan,17,0,Thur,1,16,397,413
2012-01-26,1,Jan,18,0,Thur,1,12,394,406
2012-01-26,1,Jan,19,0,Thur,1,11,302,313
2012-01-26,1,Jan,20,0,Thur,1,8,216,224
2012-01-26,1,Jan,21,0,Thur,1,8,184,192
2012-01-26,1,Jan,22,0,Thur,1,3,139,142
2012-01-26,1,Jan,23,0,Thur,1,5,86,91
2012-01-27,1,Jan,0,0,Fri,1,6,32,38
2012-01-27,1,Jan,1,0,Fri,1,6,23,29
2012-01-27,1,Jan,2,0,Fri,1,2,11,13
2012-01-27,1,Jan,3,0,Fri,1,3,5,8
2012-01-27,1,Jan,4,0,Fri,1,1,3,4
2012-01-27,1,Jan,5,0,Fri,1,0,24,24
2012-01-27,1,Jan,6,0,Fri,1,0,72,72
2012-01-27,1,Jan,7,0,Fri,1,6,128,134
2012-01-27,1,Jan,8,0,Fri,1,14,206,220
2012-01-27,1,Jan,9,0,Fri,1,6,101,107
2012-01-27,1,Jan,10,0,Fri,1,9,117,126
2012-01-27,1,Jan,11,0,Fri,1,10,95,105
2012-01-27,1,Jan,12,0,Fri,1,25,155,180
2012-01-27,1,Jan,13,0,Fri,1,26,175,201
2012-01-27,1,Jan,14,0,Fri,1,23,153,176
2012-01-27,1,Jan,15,0,Fri,1,27,170,197
2012-01-27,1,Jan,16,0,Fri,1,26,241,267
2012-01-27,1,Jan,17,0,Fri,1,16,406,422
2012-01-27,1,Jan,18,0,Fri,1,20,363,383
2012-01-27,1,Jan,19,0,Fri,1,10,241,251
2012-01-27,1,Jan,20,0,Fri,1,6,153,159
2012-01-27,1,Jan,21,0,Fri,1,8,127,135
2012-01-27,1,Jan,22,0,Fri,1,11,108,119
2012-01-27,1,Jan,23,0,Fri,1,8,78,86
2012-01-28,1,Jan,0,0,Sat,0,1,68,69
2012-01-28,1,Jan,1,0,Sat,0,1,57,58
2012-01-28,1,Jan,2,0,Sat,0,3,38,41
2012-01-28,1,Jan,3,0,Sat,0,1,16,17
2012-01-28,1,Jan,4,0,Sat,0,0,8,8
2012-01-28,1,Jan,5,0,Sat,0,0,10,10
2012-01-28,1,Jan,6,0,Sat,0,3,12,15
2012-01-28,1,Jan,7,0,Sat,0,3,28,31
2012-01-28,1,Jan,8,0,Sat,0,9,82,91
2012-01-28,1,Jan,9,0,Sat,0,13,145,158
2012-01-28,1,Jan,10,0,Sat,0,27,164,191
2012-01-28,1,Jan,11,0,Sat,0,55,241,296
2012-01-28,1,Jan,12,0,Sat,0,70,244,314
2012-01-28,1,Jan,13,0,Sat,0,80,293,373
2012-01-28,1,Jan,14,0,Sat,0,123,239,362
2012-01-28,1,Jan,15,0,Sat,0,90,320,410
2012-01-28,1,Jan,16,0,Sat,0,131,276,407
2012-01-28,1,Jan,17,0,Sat,0,57,233,290
2012-01-28,1,Jan,18,0,Sat,0,40,201,241
2012-01-28,1,Jan,19,0,Sat,0,33,173,206
2012-01-28,1,Jan,20,0,Sat,0,5,115,120
2012-01-28,1,Jan,21,0,Sat,0,18,109,127
2012-01-28,1,Jan,22,0,Sat,0,6,97,103
2012-01-28,1,Jan,23,0,Sat,0,6,79,85
2012-01-29,1,Jan,0,0,Sun,0,15,81,96
2012-01-29,1,Jan,1,0,Sun,0,5,68,73
2012-01-29,1,Jan,2,0,Sun,0,3,48,51
2012-01-29,1,Jan,3,0,Sun,0,4,17,21
2012-01-29,1,Jan,4,0,Sun,0,0,5,5
2012-01-29,1,Jan,5,0,Sun,0,1,6,7
2012-01-29,1,Jan,6,0,Sun,0,1,4,5
2012-01-29,1,Jan,7,0,Sun,0,0,12,12
2012-01-29,1,Jan,8,0,Sun,0,9,61,70
2012-01-29,1,Jan,9,0,Sun,0,13,98,111
2012-01-29,1,Jan,10,0,Sun,0,38,153,191
2012-01-29,1,Jan,11,0,Sun,0,57,198,255
2012-01-29,1,Jan,12,0,Sun,0,73,215,288
2012-01-29,1,Jan,13,0,Sun,0,78,238,316
2012-01-29,1,Jan,14,0,Sun,0,51,229,280
2012-01-29,1,Jan,15,0,Sun,0,68,242,310
2012-01-29,1,Jan,16,0,Sun,0,54,268,322
2012-01-29,1,Jan,17,0,Sun,0,33,201,234
2012-01-29,1,Jan,18,0,Sun,0,17,151,168
2012-01-29,1,Jan,19,0,Sun,0,14,145,159
2012-01-29,1,Jan,20,0,Sun,0,13,98,111
2012-01-29,1,Jan,21,0,Sun,0,0,69,69
2012-01-29,1,Jan,22,0,Sun,0,7,57,64
2012-01-29,1,Jan,23,0,Sun,0,4,21,25
2012-01-30,1,Jan,0,0,Mon,1,0,10,10
2012-01-30,1,Jan,1,0,Mon,1,0,9,9
2012-01-30,1,Jan,2,0,Mon,1,1,6,7
2012-01-30,1,Jan,3,0,Mon,1,0,4,4
2012-01-30,1,Jan,4,0,Mon,1,0,5,5
2012-01-30,1,Jan,5,0,Mon,1,0,26,26
2012-01-30,1,Jan,6,0,Mon,1,0,80,80
2012-01-30,1,Jan,7,0,Mon,1,4,221,225
2012-01-30,1,Jan,8,0,Mon,1,12,481,493
2012-01-30,1,Jan,9,0,Mon,1,5,193,198
2012-01-30,1,Jan,10,0,Mon,1,3,82,85
2012-01-30,1,Jan,11,0,Mon,1,6,93,99
2012-01-30,1,Jan,12,0,Mon,1,5,129,134
2012-01-30,1,Jan,13,0,Mon,1,15,117,132
2012-01-30,1,Jan,14,0,Mon,1,15,100,115
2012-01-30,1,Jan,15,0,Mon,1,7,131,138
2012-01-30,1,Jan,16,0,Mon,1,11,210,221
2012-01-30,1,Jan,17,0,Mon,1,16,422,438
2012-01-30,1,Jan,18,0,Mon,1,11,399,410
2012-01-30,1,Jan,19,0,Mon,1,8,298,306
2012-01-30,1,Jan,20,0,Mon,1,2,179,181
2012-01-30,1,Jan,21,0,Mon,1,3,159,162
2012-01-30,1,Jan,22,0,Mon,1,2,92,94
2012-01-30,1,Jan,23,0,Mon,1,0,52,52
2012-01-31,1,Jan,0,0,Tue,1,0,15,15
2012-01-31,1,Jan,1,0,Tue,1,1,7,8
2012-01-31,1,Jan,2,0,Tue,1,0,2,2
2012-01-31,1,Jan,3,0,Tue,1,0,2,2
2012-01-31,1,Jan,4,0,Tue,1,0,1,1
2012-01-31,1,Jan,5,0,Tue,1,0,22,22
2012-01-31,1,Jan,6,0,Tue,1,0,104,104
2012-01-31,1,Jan,7,0,Tue,1,6,273,279
2012-01-31,1,Jan,8,0,Tue,1,14,498,512
2012-01-31,1,Jan,9,0,Tue,1,30,231,261
2012-01-31,1,Jan,10,0,Tue,1,34,110,144
2012-01-31,1,Jan,11,0,Tue,1,14,125,139
2012-01-31,1,Jan,12,0,Tue,1,13,181,194
2012-01-31,1,Jan,13,0,Tue,1,27,171,198
2012-01-31,1,Jan,14,0,Tue,1,18,142,160
2012-01-31,1,Jan,15,0,Tue,1,27,150,177
2012-01-31,1,Jan,16,0,Tue,1,30,277,307
2012-01-31,1,Jan,17,0,Tue,1,41,518,559
2012-01-31,1,Jan,18,0,Tue,1,16,486,502
2012-01-31,1,Jan,19,0,Tue,1,22,306,328
2012-01-31,1,Jan,20,0,Tue,1,15,223,238
2012-01-31,1,Jan,21,0,Tue,1,3,162,165
2012-01-31,1,Jan,22,0,Tue,1,11,118,129
2012-01-31,1,Jan,23,0,Tue,1,2,61,63
2012-02-01,1,Feb,0,0,Wed,1,0,31,31
2012-02-01,1,Feb,1,0,Wed,1,0,4,4
2012-02-01,1,Feb,2,0,Wed,1,1,6,7
2012-02-01,1,Feb,3,0,Wed,1,0,3,3
2012-02-01,1,Feb,4,0,Wed,1,0,1,1
2012-02-01,1,Feb,5,0,Wed,1,0,18,18
2012-02-01,1,Feb,6,0,Wed,1,0,67,67
2012-02-01,1,Feb,7,0,Wed,1,7,201,208
2012-02-01,1,Feb,8,0,Wed,1,15,505,520
2012-02-01,1,Feb,9,0,Wed,1,9,267,276
2012-02-01,1,Feb,10,0,Wed,1,9,124,133
2012-02-01,1,Feb,11,0,Wed,1,27,116,143
2012-02-01,1,Feb,12,0,Wed,1,26,153,179
2012-02-01,1,Feb,13,0,Wed,1,12,174,186
2012-02-01,1,Feb,14,0,Wed,1,33,159,192
2012-02-01,1,Feb,15,0,Wed,1,25,169,194
2012-02-01,1,Feb,16,0,Wed,1,22,261,283
2012-02-01,1,Feb,17,0,Wed,1,31,508,539
2012-02-01,1,Feb,18,0,Wed,1,12,514,526
2012-02-01,1,Feb,19,0,Wed,1,20,315,335
2012-02-01,1,Feb,20,0,Wed,1,10,254,264
2012-02-01,1,Feb,21,0,Wed,1,16,217,233
2012-02-01,1,Feb,22,0,Wed,1,7,133,140
2012-02-01,1,Feb,23,0,Wed,1,22,75,97
2012-02-02,1,Feb,0,0,Thur,1,7,24,31
2012-02-02,1,Feb,1,0,Thur,1,3,14,17
2012-02-02,1,Feb,2,0,Thur,1,2,7,9
2012-02-02,1,Feb,3,0,Thur,1,0,2,2
2012-02-02,1,Feb,4,0,Thur,1,0,1,1
2012-02-02,1,Feb,5,0,Thur,1,0,19,19
2012-02-02,1,Feb,6,0,Thur,1,1,73,74
2012-02-02,1,Feb,7,0,Thur,1,4,201,205
2012-02-02,1,Feb,8,0,Thur,1,9,436,445
2012-02-02,1,Feb,9,0,Thur,1,15,213,228
2012-02-02,1,Feb,10,0,Thur,1,6,72,78
2012-02-02,1,Feb,11,0,Thur,1,6,99,105
2012-02-02,1,Feb,12,0,Thur,1,8,140,148
2012-02-02,1,Feb,13,0,Thur,1,13,124,137
2012-02-02,1,Feb,14,0,Thur,1,12,129,141
2012-02-02,1,Feb,15,0,Thur,1,24,150,174
2012-02-02,1,Feb,16,0,Thur,1,18,211,229
2012-02-02,1,Feb,17,0,Thur,1,13,437,450
2012-02-02,1,Feb,18,0,Thur,1,17,393,410
2012-02-02,1,Feb,19,0,Thur,1,16,311,327
2012-02-02,1,Feb,20,0,Thur,1,9,204,213
2012-02-02,1,Feb,21,0,Thur,1,4,144,148
2012-02-02,1,Feb,22,0,Thur,1,3,106,109
2012-02-02,1,Feb,23,0,Thur,1,0,61,61
2012-02-03,1,Feb,0,0,Fri,1,1,37,38
2012-02-03,1,Feb,1,0,Fri,1,3,19,22
2012-02-03,1,Feb,2,0,Fri,1,0,6,6
2012-02-03,1,Feb,3,0,Fri,1,0,4,4
2012-02-03,1,Feb,4,0,Fri,1,0,2,2
2012-02-03,1,Feb,5,0,Fri,1,0,17,17
2012-02-03,1,Feb,6,0,Fri,1,0,88,88
2012-02-03,1,Feb,7,0,Fri,1,10,216,226
2012-02-03,1,Feb,8,0,Fri,1,12,429,441
2012-02-03,1,Feb,9,0,Fri,1,18,252,270
2012-02-03,1,Feb,10,0,Fri,1,15,114,129
2012-02-03,1,Feb,11,0,Fri,1,15,149,164
2012-02-03,1,Feb,12,0,Fri,1,25,191,216
2012-02-03,1,Feb,13,0,Fri,1,25,173,198
2012-02-03,1,Feb,14,0,Fri,1,22,148,170
2012-02-03,1,Feb,15,0,Fri,1,48,168,216
2012-02-03,1,Feb,16,0,Fri,1,36,275,311
2012-02-03,1,Feb,17,0,Fri,1,30,458,488
2012-02-03,1,Feb,18,0,Fri,1,17,368,385
2012-02-03,1,Feb,19,0,Fri,1,11,256,267
2012-02-03,1,Feb,20,0,Fri,1,8,155,163
2012-02-03,1,Feb,21,0,Fri,1,8,126,134
2012-02-03,1,Feb,22,0,Fri,1,3,116,119
2012-02-03,1,Feb,23,0,Fri,1,3,74,77
2012-02-04,1,Feb,0,0,Sat,0,10,76,86
2012-02-04,1,Feb,1,0,Sat,0,0,43,43
2012-02-04,1,Feb,2,0,Sat,0,6,38,44
2012-02-04,1,Feb,3,0,Sat,0,1,17,18
2012-02-04,1,Feb,4,0,Sat,0,1,5,6
2012-02-04,1,Feb,5,0,Sat,0,1,3,4
2012-02-04,1,Feb,6,0,Sat,0,1,4,5
2012-02-04,1,Feb,7,0,Sat,0,1,27,28
2012-02-04,1,Feb,8,0,Sat,0,4,86,90
2012-02-04,1,Feb,9,0,Sat,0,16,141,157
2012-02-04,1,Feb,10,0,Sat,0,31,193,224
2012-02-04,1,Feb,11,0,Sat,0,46,224,270
2012-02-04,1,Feb,12,0,Sat,0,40,260,300
2012-02-04,1,Feb,13,0,Sat,0,58,244,302
2012-02-04,1,Feb,14,0,Sat,0,47,229,276
2012-02-04,1,Feb,15,0,Sat,0,61,244,305
2012-02-04,1,Feb,16,0,Sat,0,20,123,143
2012-02-04,1,Feb,17,0,Sat,0,13,54,67
2012-02-04,1,Feb,18,0,Sat,0,6,58,64
2012-02-04,1,Feb,19,0,Sat,0,5,75,80
2012-02-04,1,Feb,20,0,Sat,0,4,73,77
2012-02-04,1,Feb,21,0,Sat,0,4,74,78
2012-02-04,1,Feb,22,0,Sat,0,4,91,95
2012-02-04,1,Feb,23,0,Sat,0,4,66,70
2012-02-05,1,Feb,0,0,Sun,0,3,58,61
2012-02-05,1,Feb,1,0,Sun,0,5,46,51
2012-02-05,1,Feb,2,0,Sun,0,4,59,63
2012-02-05,1,Feb,3,0,Sun,0,4,13,17
2012-02-05,1,Feb,4,0,Sun,0,0,9,9
2012-02-05,1,Feb,5,0,Sun,0,0,4,4
2012-02-05,1,Feb,6,0,Sun,0,0,4,4
2012-02-05,1,Feb,7,0,Sun,0,0,16,16
2012-02-05,1,Feb,8,0,Sun,0,4,58,62
2012-02-05,1,Feb,9,0,Sun,0,9,83,92
2012-02-05,1,Feb,10,0,Sun,0,10,138,148
2012-02-05,1,Feb,11,0,Sun,0,22,160,182
2012-02-05,1,Feb,12,0,Sun,0,25,223,248
2012-02-05,1,Feb,13,0,Sun,0,33,241,274
2012-02-05,1,Feb,14,0,Sun,0,40,203,243
2012-02-05,1,Feb,15,0,Sun,0,55,217,272
2012-02-05,1,Feb,16,0,Sun,0,35,261,296
2012-02-05,1,Feb,17,0,Sun,0,31,275,306
2012-02-05,1,Feb,18,0,Sun,0,10,171,181
2012-02-05,1,Feb,19,0,Sun,0,6,63,69
2012-02-05,1,Feb,20,0,Sun,0,3,47,50
2012-02-05,1,Feb,21,0,Sun,0,6,60,66
2012-02-05,1,Feb,22,0,Sun,0,9,182,191
2012-02-05,1,Feb,23,0,Sun,0,4,38,42
2012-02-06,1,Feb,0,0,Mon,1,7,14,21
2012-02-06,1,Feb,1,0,Mon,1,0,6,6
2012-02-06,1,Feb,2,0,Mon,1,0,3,3
2012-02-06,1,Feb,4,0,Mon,1,0,2,2
2012-02-06,1,Feb,5,0,Mon,1,0,17,17
2012-02-06,1,Feb,6,0,Mon,1,0,72,72
2012-02-06,1,Feb,7,0,Mon,1,5,229,234
2012-02-06,1,Feb,8,0,Mon,1,10,434,444
2012-02-06,1,Feb,9,0,Mon,1,8,269,277
2012-02-06,1,Feb,10,0,Mon,1,20,96,116
2012-02-06,1,Feb,11,0,Mon,1,12,104,116
2012-02-06,1,Feb,12,0,Mon,1,19,131,150
2012-02-06,1,Feb,13,0,Mon,1,17,124,141
2012-02-06,1,Feb,14,0,Mon,1,14,126,140
2012-02-06,1,Feb,15,0,Mon,1,25,146,171
2012-02-06,1,Feb,16,0,Mon,1,13,215,228
2012-02-06,1,Feb,17,0,Mon,1,13,417,430
2012-02-06,1,Feb,18,0,Mon,1,11,426,437
2012-02-06,1,Feb,19,0,Mon,1,7,284,291
2012-02-06,1,Feb,20,0,Mon,1,7,194,201
2012-02-06,1,Feb,21,0,Mon,1,11,143,154
2012-02-06,1,Feb,22,0,Mon,1,4,83,87
2012-02-06,1,Feb,23,0,Mon,1,3,43,46
2012-02-07,1,Feb,0,0,Tue,1,1,22,23
2012-02-07,1,Feb,1,0,Tue,1,8,6,14
2012-02-07,1,Feb,2,0,Tue,1,0,4,4
2012-02-07,1,Feb,3,0,Tue,1,1,1,2
2012-02-07,1,Feb,4,0,Tue,1,0,3,3
2012-02-07,1,Feb,5,0,Tue,1,0,15,15
2012-02-07,1,Feb,6,0,Tue,1,2,98,100
2012-02-07,1,Feb,7,0,Tue,1,6,293,299
2012-02-07,1,Feb,8,0,Tue,1,7,522,529
2012-02-07,1,Feb,9,0,Tue,1,11,278,289
2012-02-07,1,Feb,10,0,Tue,1,12,104,116
2012-02-07,1,Feb,11,0,Tue,1,9,120,129
2012-02-07,1,Feb,12,0,Tue,1,9,163,172
2012-02-07,1,Feb,13,0,Tue,1,15,169,184
2012-02-07,1,Feb,14,0,Tue,1,11,127,138
2012-02-07,1,Feb,15,0,Tue,1,13,133,146
2012-02-07,1,Feb,16,0,Tue,1,19,257,276
2012-02-07,1,Feb,17,0,Tue,1,15,494,509
2012-02-07,1,Feb,18,0,Tue,1,10,508,518
2012-02-07,1,Feb,19,0,Tue,1,11,327,338
2012-02-07,1,Feb,20,0,Tue,1,6,206,212
2012-02-07,1,Feb,21,0,Tue,1,20,170,190
2012-02-07,1,Feb,22,0,Tue,1,11,107,118
2012-02-07,1,Feb,23,0,Tue,1,2,49,51
2012-02-08,1,Feb,0,0,Wed,1,2,21,23
2012-02-08,1,Feb,1,0,Wed,1,1,9,10
2012-02-08,1,Feb,2,0,Wed,1,0,1,1
2012-02-08,1,Feb,3,0,Wed,1,0,1,1
2012-02-08,1,Feb,4,0,Wed,1,0,1,1
2012-02-08,1,Feb,5,0,Wed,1,0,20,20
2012-02-08,1,Feb,6,0,Wed,1,3,95,98
2012-02-08,1,Feb,7,0,Wed,1,5,276,281
2012-02-08,1,Feb,8,0,Wed,1,13,495,508
2012-02-08,1,Feb,9,0,Wed,1,8,245,253
2012-02-08,1,Feb,10,0,Wed,1,1,107,108
2012-02-08,1,Feb,11,0,Wed,1,5,97,102
2012-02-08,1,Feb,12,0,Wed,1,14,124,138
2012-02-08,1,Feb,13,0,Wed,1,15,111,126
2012-02-08,1,Feb,14,0,Wed,1,8,100,108
2012-02-08,1,Feb,15,0,Wed,1,5,49,54
2012-02-08,1,Feb,16,0,Wed,1,2,73,75
2012-02-08,1,Feb,17,0,Wed,1,8,147,155
2012-02-08,1,Feb,18,0,Wed,1,4,163,167
2012-02-08,1,Feb,19,0,Wed,1,3,158,161
2012-02-08,1,Feb,20,0,Wed,1,3,122,125
2012-02-08,1,Feb,21,0,Wed,1,3,126,129
2012-02-08,1,Feb,22,0,Wed,1,3,95,98
2012-02-08,1,Feb,23,0,Wed,1,3,57,60
2012-02-09,1,Feb,0,0,Thur,1,3,23,26
2012-02-09,1,Feb,1,0,Thur,1,2,10,12
2012-02-09,1,Feb,2,0,Thur,1,0,2,2
2012-02-09,1,Feb,3,0,Thur,1,0,4,4
2012-02-09,1,Feb,4,0,Thur,1,0,1,1
2012-02-09,1,Feb,5,0,Thur,1,0,18,18
2012-02-09,1,Feb,6,0,Thur,1,1,75,76
2012-02-09,1,Feb,7,0,Thur,1,4,263,267
2012-02-09,1,Feb,8,0,Thur,1,11,473,484
2012-02-09,1,Feb,9,0,Thur,1,9,229,238
2012-02-09,1,Feb,10,0,Thur,1,7,90,97
2012-02-09,1,Feb,11,0,Thur,1,4,95,99
2012-02-09,1,Feb,12,0,Thur,1,10,148,158
2012-02-09,1,Feb,13,0,Thur,1,10,144,154
2012-02-09,1,Feb,14,0,Thur,1,18,126,144
2012-02-09,1,Feb,15,0,Thur,1,14,120,134
2012-02-09,1,Feb,16,0,Thur,1,15,223,238
2012-02-09,1,Feb,17,0,Thur,1,12,387,399
2012-02-09,1,Feb,18,0,Thur,1,13,404,417
2012-02-09,1,Feb,19,0,Thur,1,8,287,295
2012-02-09,1,Feb,20,0,Thur,1,2,197,199
2012-02-09,1,Feb,21,0,Thur,1,8,169,177
2012-02-09,1,Feb,22,0,Thur,1,3,104,107
2012-02-09,1,Feb,23,0,Thur,1,9,75,84
2012-02-10,1,Feb,0,0,Fri,1,4,39,43
2012-02-10,1,Feb,1,0,Fri,1,2,11,13
2012-02-10,1,Feb,2,0,Fri,1,7,9,16
2012-02-10,1,Feb,3,0,Fri,1,0,5,5
2012-02-10,1,Feb,4,0,Fri,1,0,2,2
2012-02-10,1,Feb,5,0,Fri,1,0,17,17
2012-02-10,1,Feb,6,0,Fri,1,3,61,64
2012-02-10,1,Feb,7,0,Fri,1,5,225,230
2012-02-10,1,Feb,8,0,Fri,1,1,447,448
2012-02-10,1,Feb,9,0,Fri,1,10,265,275
2012-02-10,1,Feb,10,0,Fri,1,5,119,124
2012-02-10,1,Feb,11,0,Fri,1,19,134,153
2012-02-10,1,Feb,12,0,Fri,1,8,168,176
2012-02-10,1,Feb,13,0,Fri,1,22,170,192
2012-02-10,1,Feb,14,0,Fri,1,8,138,146
2012-02-10,1,Feb,15,0,Fri,1,27,164,191
2012-02-10,1,Feb,16,0,Fri,1,28,240,268
2012-02-10,1,Feb,17,0,Fri,1,15,381,396
2012-02-10,1,Feb,18,0,Fri,1,14,345,359
2012-02-10,1,Feb,19,0,Fri,1,16,246,262
2012-02-10,1,Feb,20,0,Fri,1,7,144,151
2012-02-10,1,Feb,21,0,Fri,1,14,108,122
2012-02-10,1,Feb,22,0,Fri,1,11,102,113
2012-02-10,1,Feb,23,0,Fri,1,1,64,65
2012-02-11,1,Feb,0,0,Sat,0,3,50,53
2012-02-11,1,Feb,1,0,Sat,0,2,43,45
2012-02-11,1,Feb,2,0,Sat,0,2,24,26
2012-02-11,1,Feb,3,0,Sat,0,0,9,9
2012-02-11,1,Feb,4,0,Sat,0,0,4,4
2012-02-11,1,Feb,5,0,Sat,0,0,2,2
2012-02-11,1,Feb,6,0,Sat,0,1,8,9
2012-02-11,1,Feb,7,0,Sat,0,0,19,19
2012-02-11,1,Feb,8,0,Sat,0,1,77,78
2012-02-11,1,Feb,9,0,Sat,0,5,85,90
2012-02-11,1,Feb,10,0,Sat,0,23,143,166
2012-02-11,1,Feb,11,0,Sat,0,26,157,183
2012-02-11,1,Feb,12,0,Sat,0,25,196,221
2012-02-11,1,Feb,13,0,Sat,0,18,217,235
2012-02-11,1,Feb,14,0,Sat,0,38,205,243
2012-02-11,1,Feb,15,0,Sat,0,12,112,124
2012-02-11,1,Feb,16,0,Sat,0,12,134,146
2012-02-11,1,Feb,17,0,Sat,0,13,131,144
2012-02-11,1,Feb,18,0,Sat,0,3,105,108
2012-02-11,1,Feb,19,0,Sat,0,2,85,87
2012-02-11,1,Feb,20,0,Sat,0,1,62,63
2012-02-11,1,Feb,21,0,Sat,0,5,43,48
2012-02-11,1,Feb,22,0,Sat,0,0,46,46
2012-02-11,1,Feb,23,0,Sat,0,0,20,20
2012-02-12,1,Feb,0,0,Sun,0,0,21,21
2012-02-12,1,Feb,1,0,Sun,0,0,24,24
2012-02-12,1,Feb,2,0,Sun,0,1,26,27
2012-02-12,1,Feb,3,0,Sun,0,0,14,14
2012-02-12,1,Feb,4,0,Sun,0,0,1,1
2012-02-12,1,Feb,5,0,Sun,0,0,3,3
2012-02-12,1,Feb,6,0,Sun,0,0,2,2
2012-02-12,1,Feb,7,0,Sun,0,0,18,18
2012-02-12,1,Feb,8,0,Sun,0,0,26,26
2012-02-12,1,Feb,9,0,Sun,0,3,60,63
2012-02-12,1,Feb,10,0,Sun,0,8,83,91
2012-02-12,1,Feb,11,0,Sun,0,3,121,124
2012-02-12,1,Feb,12,0,Sun,0,7,133,140
2012-02-12,1,Feb,13,0,Sun,0,10,128,138
2012-02-12,1,Feb,14,0,Sun,0,9,102,111
2012-02-12,1,Feb,15,0,Sun,0,5,150,155
2012-02-12,1,Feb,16,0,Sun,0,16,148,164
2012-02-12,1,Feb,17,0,Sun,0,4,83,87
2012-02-12,1,Feb,18,0,Sun,0,4,92,96
2012-02-12,1,Feb,19,0,Sun,0,2,78,80
2012-02-12,1,Feb,20,0,Sun,0,1,56,57
2012-02-12,1,Feb,21,0,Sun,0,0,36,36
2012-02-12,1,Feb,22,0,Sun,0,0,28,28
2012-02-12,1,Feb,23,0,Sun,0,0,23,23
2012-02-13,1,Feb,0,0,Mon,1,0,9,9
2012-02-13,1,Feb,1,0,Mon,1,0,6,6
2012-02-13,1,Feb,2,0,Mon,1,0,4,4
2012-02-13,1,Feb,3,0,Mon,1,0,1,1
2012-02-13,1,Feb,4,0,Mon,1,0,2,2
2012-02-13,1,Feb,5,0,Mon,1,0,17,17
2012-02-13,1,Feb,6,0,Mon,1,1,71,72
2012-02-13,1,Feb,7,0,Mon,1,1,194,195
2012-02-13,1,Feb,8,0,Mon,1,4,413,417
2012-02-13,1,Feb,9,0,Mon,1,7,198,205
2012-02-13,1,Feb,10,0,Mon,1,1,70,71
2012-02-13,1,Feb,11,0,Mon,1,5,85,90
2012-02-13,1,Feb,12,0,Mon,1,7,111,118
2012-02-13,1,Feb,13,0,Mon,1,11,129,140
2012-02-13,1,Feb,14,0,Mon,1,10,125,135
2012-02-13,1,Feb,15,0,Mon,1,10,145,155
2012-02-13,1,Feb,16,0,Mon,1,5,206,211
2012-02-13,1,Feb,17,0,Mon,1,8,399,407
2012-02-13,1,Feb,18,0,Mon,1,6,399,405
2012-02-13,1,Feb,19,0,Mon,1,7,256,263
2012-02-13,1,Feb,20,0,Mon,1,4,210,214
2012-02-13,1,Feb,21,0,Mon,1,2,145,147
2012-02-13,1,Feb,22,0,Mon,1,3,99,102
2012-02-13,1,Feb,23,0,Mon,1,2,34,36
2012-02-14,1,Feb,0,0,Tue,1,0,14,14
2012-02-14,1,Feb,1,0,Tue,1,0,6,6
2012-02-14,1,Feb,2,0,Tue,1,0,3,3
2012-02-14,1,Feb,3,0,Tue,1,0,3,3
2012-02-14,1,Feb,4,0,Tue,1,0,2,2
2012-02-14,1,Feb,5,0,Tue,1,2,20,22
2012-02-14,1,Feb,6,0,Tue,1,1,89,90
2012-02-14,1,Feb,7,0,Tue,1,4,276,280
2012-02-14,1,Feb,8,0,Tue,1,3,510,513
2012-02-14,1,Feb,9,0,Tue,1,6,256,262
2012-02-14,1,Feb,10,0,Tue,1,8,90,98
2012-02-14,1,Feb,11,0,Tue,1,5,107,112
2012-02-14,1,Feb,12,0,Tue,1,10,162,172
2012-02-14,1,Feb,13,0,Tue,1,6,167,173
2012-02-14,1,Feb,14,0,Tue,1,13,111,124
2012-02-14,1,Feb,15,0,Tue,1,7,138,145
2012-02-14,1,Feb,16,0,Tue,1,15,251,266
2012-02-14,1,Feb,17,0,Tue,1,19,504,523
2012-02-14,1,Feb,18,0,Tue,1,8,398,406
2012-02-14,1,Feb,19,0,Tue,1,11,270,281
2012-02-14,1,Feb,20,0,Tue,1,6,178,184
2012-02-14,1,Feb,21,0,Tue,1,4,105,109
2012-02-14,1,Feb,22,0,Tue,1,5,72,77
2012-02-14,1,Feb,23,0,Tue,1,2,55,57
2012-02-15,1,Feb,0,0,Wed,1,0,22,22
2012-02-15,1,Feb,1,0,Wed,1,0,5,5
2012-02-15,1,Feb,2,0,Wed,1,0,4,4
2012-02-15,1,Feb,3,0,Wed,1,0,3,3
2012-02-15,1,Feb,4,0,Wed,1,0,1,1
2012-02-15,1,Feb,5,0,Wed,1,0,25,25
2012-02-15,1,Feb,6,0,Wed,1,3,92,95
2012-02-15,1,Feb,7,0,Wed,1,3,318,321
2012-02-15,1,Feb,8,0,Wed,1,7,508,515
2012-02-15,1,Feb,9,0,Wed,1,5,226,231
2012-02-15,1,Feb,10,0,Wed,1,12,108,120
2012-02-15,1,Feb,11,0,Wed,1,13,125,138
2012-02-15,1,Feb,12,0,Wed,1,11,152,163
2012-02-15,1,Feb,13,0,Wed,1,11,159,170
2012-02-15,1,Feb,14,0,Wed,1,6,128,134
2012-02-15,1,Feb,15,0,Wed,1,7,164,171
2012-02-15,1,Feb,16,0,Wed,1,9,222,231
2012-02-15,1,Feb,17,0,Wed,1,17,470,487
2012-02-15,1,Feb,18,0,Wed,1,9,459,468
2012-02-15,1,Feb,19,0,Wed,1,9,302,311
2012-02-15,1,Feb,20,0,Wed,1,4,207,211
2012-02-15,1,Feb,21,0,Wed,1,8,170,178
2012-02-15,1,Feb,22,0,Wed,1,3,104,107
2012-02-15,1,Feb,23,0,Wed,1,4,54,58
2012-02-16,1,Feb,0,0,Thur,1,1,22,23
2012-02-16,1,Feb,1,0,Thur,1,0,5,5
2012-02-16,1,Feb,2,0,Thur,1,1,6,7
2012-02-16,1,Feb,3,0,Thur,1,0,1,1
2012-02-16,1,Feb,4,0,Thur,1,0,3,3
2012-02-16,1,Feb,5,0,Thur,1,0,20,20
2012-02-16,1,Feb,6,0,Thur,1,4,83,87
2012-02-16,1,Feb,7,0,Thur,1,3,285,288
2012-02-16,1,Feb,8,0,Thur,1,9,489,498
2012-02-16,1,Feb,9,0,Thur,1,3,199,202
2012-02-16,1,Feb,10,0,Thur,1,2,42,44
2012-02-16,1,Feb,11,0,Thur,1,2,69,71
2012-02-16,1,Feb,12,0,Thur,1,1,44,45
2012-02-16,1,Feb,13,0,Thur,1,2,62,64
2012-02-16,1,Feb,14,0,Thur,1,1,30,31
2012-02-16,1,Feb,15,0,Thur,1,3,50,53
2012-02-16,1,Feb,16,0,Thur,1,8,110,118
2012-02-16,1,Feb,17,0,Thur,1,8,281,289
2012-02-16,1,Feb,18,0,Thur,1,8,345,353
2012-02-16,1,Feb,19,0,Thur,1,4,254,258
2012-02-16,1,Feb,20,0,Thur,1,5,211,216
2012-02-16,1,Feb,21,0,Thur,1,3,142,145
2012-02-16,1,Feb,22,0,Thur,1,3,108,111
2012-02-16,1,Feb,23,0,Thur,1,3,70,73
2012-02-17,1,Feb,0,0,Fri,1,2,32,34
2012-02-17,1,Feb,1,0,Fri,1,2,16,18
2012-02-17,1,Feb,2,0,Fri,1,1,11,12
2012-02-17,1,Feb,3,0,Fri,1,0,1,1
2012-02-17,1,Feb,4,0,Fri,1,0,1,1
2012-02-17,1,Feb,5,0,Fri,1,0,16,16
2012-02-17,1,Feb,6,0,Fri,1,1,70,71
2012-02-17,1,Feb,7,0,Fri,1,4,222,226
2012-02-17,1,Feb,8,0,Fri,1,4,516,520
2012-02-17,1,Feb,9,0,Fri,1,8,275,283
2012-02-17,1,Feb,10,0,Fri,1,13,103,116
2012-02-17,1,Feb,11,0,Fri,1,9,133,142
2012-02-17,1,Feb,12,0,Fri,1,21,177,198
2012-02-17,1,Feb,13,0,Fri,1,34,171,205
2012-02-17,1,Feb,14,0,Fri,1,33,137,170
2012-02-17,1,Feb,15,0,Fri,1,41,180,221
2012-02-17,1,Feb,16,0,Fri,1,56,251,307
2012-02-17,1,Feb,17,0,Fri,1,36,429,465
2012-02-17,1,Feb,18,0,Fri,1,15,362,377
2012-02-17,1,Feb,19,0,Fri,1,16,266,282
2012-02-17,1,Feb,20,0,Fri,1,13,158,171
2012-02-17,1,Feb,21,0,Fri,1,15,114,129
2012-02-17,1,Feb,22,0,Fri,1,15,92,107
2012-02-17,1,Feb,23,0,Fri,1,10,72,82
2012-02-18,1,Feb,0,0,Sat,0,5,81,86
2012-02-18,1,Feb,1,0,Sat,0,7,38,45
2012-02-18,1,Feb,2,0,Sat,0,6,39,45
2012-02-18,1,Feb,3,0,Sat,0,3,15,18
2012-02-18,1,Feb,4,0,Sat,0,3,4,7
2012-02-18,1,Feb,5,0,Sat,0,0,1,1
2012-02-18,1,Feb,6,0,Sat,0,1,8,9
2012-02-18,1,Feb,7,0,Sat,0,8,33,41
2012-02-18,1,Feb,8,0,Sat,0,10,92,102
2012-02-18,1,Feb,9,0,Sat,0,22,116,138
2012-02-18,1,Feb,10,0,Sat,0,48,157,205
2012-02-18,1,Feb,11,0,Sat,0,102,184,286
2012-02-18,1,Feb,12,0,Sat,0,128,241,369
2012-02-18,1,Feb,13,0,Sat,0,165,219,384
2012-02-18,1,Feb,14,0,Sat,0,183,244,427
2012-02-18,1,Feb,15,0,Sat,0,229,270,499
2012-02-18,1,Feb,16,0,Sat,0,186,218,404
2012-02-18,1,Feb,17,0,Sat,0,142,222,364
2012-02-18,1,Feb,18,0,Sat,0,70,176,246
2012-02-18,1,Feb,19,0,Sat,0,38,150,188
2012-02-18,1,Feb,20,0,Sat,0,25,123,148
2012-02-18,1,Feb,21,0,Sat,0,25,89,114
2012-02-18,1,Feb,22,0,Sat,0,17,101,118
2012-02-18,1,Feb,23,0,Sat,0,12,62,74
2012-02-19,1,Feb,0,0,Sun,0,9,65,74
2012-02-19,1,Feb,1,0,Sun,0,10,62,72
2012-02-19,1,Feb,2,0,Sun,0,3,45,48
2012-02-19,1,Feb,3,0,Sun,0,3,12,15
2012-02-19,1,Feb,4,0,Sun,0,0,3,3
2012-02-19,1,Feb,5,0,Sun,0,1,1,2
2012-02-19,1,Feb,6,0,Sun,0,0,5,5
2012-02-19,1,Feb,7,0,Sun,0,2,12,14
2012-02-19,1,Feb,8,0,Sun,0,8,48,56
2012-02-19,1,Feb,9,0,Sun,0,20,73,93
2012-02-19,1,Feb,10,0,Sun,0,49,142,191
2012-02-19,1,Feb,11,0,Sun,0,82,144,226
2012-02-19,1,Feb,12,0,Sun,0,71,184,255
2012-02-19,1,Feb,13,0,Sun,0,64,197,261
2012-02-19,1,Feb,14,0,Sun,0,48,189,237
2012-02-19,1,Feb,15,0,Sun,0,85,168,253
2012-02-19,1,Feb,16,0,Sun,0,62,150,212
2012-02-19,1,Feb,17,0,Sun,0,22,135,157
2012-02-19,1,Feb,18,0,Sun,0,23,144,167
2012-02-19,1,Feb,19,0,Sun,0,18,101,119
2012-02-19,1,Feb,20,0,Sun,0,22,81,103
2012-02-19,1,Feb,21,0,Sun,0,3,33,36
2012-02-19,1,Feb,22,0,Sun,0,8,47,55
2012-02-19,1,Feb,23,0,Sun,0,5,30,35
2012-02-20,1,Feb,0,1,Mon,0,5,36,41
2012-02-20,1,Feb,1,1,Mon,0,3,12,15
2012-02-20,1,Feb,2,1,Mon,0,1,19,20
2012-02-20,1,Feb,3,1,Mon,0,0,8,8
2012-02-20,1,Feb,5,1,Mon,0,0,6,6
2012-02-20,1,Feb,6,1,Mon,0,1,9,10
2012-02-20,1,Feb,7,1,Mon,0,2,42,44
2012-02-20,1,Feb,8,1,Mon,0,9,111,120
2012-02-20,1,Feb,9,1,Mon,0,12,98,110
2012-02-20,1,Feb,10,1,Mon,0,30,113,143
2012-02-20,1,Feb,11,1,Mon,0,45,163,208
2012-02-20,1,Feb,12,1,Mon,0,65,216,281
2012-02-20,1,Feb,13,1,Mon,0,66,246,312
2012-02-20,1,Feb,14,1,Mon,0,57,206,263
2012-02-20,1,Feb,15,1,Mon,0,54,235,289
2012-02-20,1,Feb,16,1,Mon,0,64,216,280
2012-02-20,1,Feb,17,1,Mon,0,27,226,253
2012-02-20,1,Feb,18,1,Mon,0,27,215,242
2012-02-20,1,Feb,19,1,Mon,0,8,164,172
2012-02-20,1,Feb,20,1,Mon,0,9,117,126
2012-02-20,1,Feb,21,1,Mon,0,8,90,98
2012-02-20,1,Feb,22,1,Mon,0,9,53,62
2012-02-20,1,Feb,23,1,Mon,0,0,26,26
2012-02-21,1,Feb,0,0,Tue,1,1,11,12
2012-02-21,1,Feb,1,0,Tue,1,0,7,7
2012-02-21,1,Feb,2,0,Tue,1,0,3,3
2012-02-21,1,Feb,4,0,Tue,1,0,2,2
2012-02-21,1,Feb,5,0,Tue,1,0,15,15
2012-02-21,1,Feb,6,0,Tue,1,3,83,86
2012-02-21,1,Feb,7,0,Tue,1,6,273,279
2012-02-21,1,Feb,8,0,Tue,1,5,459,464
2012-02-21,1,Feb,9,0,Tue,1,6,211,217
2012-02-21,1,Feb,10,0,Tue,1,8,77,85
2012-02-21,1,Feb,11,0,Tue,1,5,81,86
2012-02-21,1,Feb,12,0,Tue,1,16,147,163
2012-02-21,1,Feb,13,0,Tue,1,8,123,131
2012-02-21,1,Feb,14,0,Tue,1,16,108,124
2012-02-21,1,Feb,15,0,Tue,1,23,137,160
2012-02-21,1,Feb,16,0,Tue,1,14,240,254
2012-02-21,1,Feb,17,0,Tue,1,21,411,432
2012-02-21,1,Feb,18,0,Tue,1,11,414,425
2012-02-21,1,Feb,19,0,Tue,1,5,299,304
2012-02-21,1,Feb,20,0,Tue,1,4,223,227
2012-02-21,1,Feb,21,0,Tue,1,7,147,154
2012-02-21,1,Feb,22,0,Tue,1,3,97,100
2012-02-21,1,Feb,23,0,Tue,1,1,46,47
2012-02-22,1,Feb,0,0,Wed,1,5,19,24
2012-02-22,1,Feb,1,0,Wed,1,3,4,7
2012-02-22,1,Feb,2,0,Wed,1,1,5,6
2012-02-22,1,Feb,3,0,Wed,1,1,3,4
2012-02-22,1,Feb,4,0,Wed,1,0,2,2
2012-02-22,1,Feb,5,0,Wed,1,1,29,30
2012-02-22,1,Feb,6,0,Wed,1,5,85,90
2012-02-22,1,Feb,7,0,Wed,1,10,292,302
2012-02-22,1,Feb,8,0,Wed,1,9,567,576
2012-02-22,1,Feb,9,0,Wed,1,11,241,252
2012-02-22,1,Feb,10,0,Wed,1,17,122,139
2012-02-22,1,Feb,11,0,Wed,1,22,149,171
2012-02-22,1,Feb,12,0,Wed,1,21,186,207
2012-02-22,1,Feb,13,0,Wed,1,15,175,190
2012-02-22,1,Feb,14,0,Wed,1,35,142,177
2012-02-22,1,Feb,15,0,Wed,1,34,161,195
2012-02-22,1,Feb,16,0,Wed,1,30,268,298
2012-02-22,1,Feb,17,0,Wed,1,43,486,529
2012-02-22,1,Feb,18,0,Wed,1,42,483,525
2012-02-22,1,Feb,19,0,Wed,1,22,305,327
2012-02-22,1,Feb,20,0,Wed,1,25,249,274
2012-02-22,1,Feb,21,0,Wed,1,19,220,239
2012-02-22,1,Feb,22,0,Wed,1,18,129,147
2012-02-22,1,Feb,23,0,Wed,1,5,57,62
2012-02-23,1,Feb,0,0,Thur,1,12,30,42
2012-02-23,1,Feb,1,0,Thur,1,3,12,15
2012-02-23,1,Feb,2,0,Thur,1,5,4,9
2012-02-23,1,Feb,3,0,Thur,1,2,4,6
2012-02-23,1,Feb,4,0,Thur,1,0,1,1
2012-02-23,1,Feb,5,0,Thur,1,2,30,32
2012-02-23,1,Feb,6,0,Thur,1,3,88,91
2012-02-23,1,Feb,7,0,Thur,1,9,317,326
2012-02-23,1,Feb,8,0,Thur,1,11,549,560
2012-02-23,1,Feb,9,0,Thur,1,14,228,242
2012-02-23,1,Feb,10,0,Thur,1,41,107,148
2012-02-23,1,Feb,11,0,Thur,1,54,128,182
2012-02-23,1,Feb,12,0,Thur,1,25,199,224
2012-02-23,1,Feb,13,0,Thur,1,30,188,218
2012-02-23,1,Feb,14,0,Thur,1,36,156,192
2012-02-23,1,Feb,15,0,Thur,1,46,171,217
2012-02-23,1,Feb,16,0,Thur,1,45,298,343
2012-02-23,1,Feb,17,0,Thur,1,49,561,610
2012-02-23,1,Feb,18,0,Thur,1,36,486,522
2012-02-23,1,Feb,19,0,Thur,1,20,349,369
2012-02-23,1,Feb,20,0,Thur,1,23,246,269
2012-02-23,1,Feb,21,0,Thur,1,17,205,222
2012-02-23,1,Feb,22,0,Thur,1,19,118,137
2012-02-23,1,Feb,23,0,Thur,1,14,71,85
2012-02-24,1,Feb,0,0,Fri,1,12,34,46
2012-02-24,1,Feb,1,0,Fri,1,3,15,18
2012-02-24,1,Feb,2,0,Fri,1,1,4,5
2012-02-24,1,Feb,3,0,Fri,1,0,5,5
2012-02-24,1,Feb,4,0,Fri,1,0,2,2
2012-02-24,1,Feb,5,0,Fri,1,1,25,26
2012-02-24,1,Feb,6,0,Fri,1,2,80,82
2012-02-24,1,Feb,7,0,Fri,1,7,265,272
2012-02-24,1,Feb,8,0,Fri,1,17,452,469
2012-02-24,1,Feb,9,0,Fri,1,15,229,244
2012-02-24,1,Feb,10,0,Fri,1,22,119,141
2012-02-24,1,Feb,11,0,Fri,1,27,136,163
2012-02-24,1,Feb,12,0,Fri,1,27,201,228
2012-02-24,1,Feb,13,0,Fri,1,30,153,183
2012-02-24,1,Feb,14,0,Fri,1,5,26,31
2012-02-24,1,Feb,15,0,Fri,1,11,83,94
2012-02-24,1,Feb,16,0,Fri,1,12,166,178
2012-02-24,1,Feb,17,0,Fri,1,14,242,256
2012-02-24,1,Feb,18,0,Fri,1,11,289,300
2012-02-24,1,Feb,19,0,Fri,1,6,227,233
2012-02-24,1,Feb,20,0,Fri,1,8,159,167
2012-02-24,1,Feb,21,0,Fri,1,1,151,152
2012-02-24,1,Feb,22,0,Fri,1,4,102,106
2012-02-24,1,Feb,23,0,Fri,1,10,76,86
2012-02-25,1,Feb,0,0,Sat,0,5,56,61
2012-02-25,1,Feb,1,0,Sat,0,4,42,46
2012-02-25,1,Feb,2,0,Sat,0,1,37,38
2012-02-25,1,Feb,3,0,Sat,0,0,7,7
2012-02-25,1,Feb,4,0,Sat,0,0,2,2
2012-02-25,1,Feb,5,0,Sat,0,0,3,3
2012-02-25,1,Feb,6,0,Sat,0,1,12,13
2012-02-25,1,Feb,7,0,Sat,0,3,20,23
2012-02-25,1,Feb,8,0,Sat,0,3,90,93
2012-02-25,1,Feb,9,0,Sat,0,15,107,122
2012-02-25,1,Feb,10,0,Sat,0,24,159,183
2012-02-25,1,Feb,11,0,Sat,0,23,187,210
2012-02-25,1,Feb,12,0,Sat,0,41,217,258
2012-02-25,1,Feb,13,0,Sat,0,48,178,226
2012-02-25,1,Feb,14,0,Sat,0,35,181,216
2012-02-25,1,Feb,15,0,Sat,0,21,211,232
2012-02-25,1,Feb,16,0,Sat,0,32,163,195
2012-02-25,1,Feb,17,0,Sat,0,16,143,159
2012-02-25,1,Feb,18,0,Sat,0,7,126,133
2012-02-25,1,Feb,19,0,Sat,0,12,137,149
2012-02-25,1,Feb,20,0,Sat,0,10,95,105
2012-02-25,1,Feb,21,0,Sat,0,5,80,85
2012-02-25,1,Feb,22,0,Sat,0,4,78,82
2012-02-25,1,Feb,23,0,Sat,0,7,84,91
2012-02-26,1,Feb,0,0,Sun,0,7,63,70
2012-02-26,1,Feb,1,0,Sun,0,5,50,55
2012-02-26,1,Feb,2,0,Sun,0,5,37,42
2012-02-26,1,Feb,3,0,Sun,0,0,21,21
2012-02-26,1,Feb,4,0,Sun,0,1,5,6
2012-02-26,1,Feb,5,0,Sun,0,0,5,5
2012-02-26,1,Feb,6,0,Sun,0,0,2,2
2012-02-26,1,Feb,7,0,Sun,0,2,20,22
2012-02-26,1,Feb,8,0,Sun,0,2,57,59
2012-02-26,1,Feb,9,0,Sun,0,11,76,87
2012-02-26,1,Feb,10,0,Sun,0,27,161,188
2012-02-26,1,Feb,11,0,Sun,0,43,184,227
2012-02-26,1,Feb,12,0,Sun,0,49,256,305
2012-02-26,1,Feb,13,0,Sun,0,58,267,325
2012-02-26,1,Feb,14,0,Sun,0,68,263,331
2012-02-26,1,Feb,15,0,Sun,0,72,281,353
2012-02-26,1,Feb,16,0,Sun,0,64,275,339
2012-02-26,1,Feb,17,0,Sun,0,46,241,287
2012-02-26,1,Feb,18,0,Sun,0,17,199,216
2012-02-26,1,Feb,19,0,Sun,0,13,130,143
2012-02-26,1,Feb,20,0,Sun,0,9,79,88
2012-02-26,1,Feb,21,0,Sun,0,8,75,83
2012-02-26,1,Feb,22,0,Sun,0,3,68,71
2012-02-26,1,Feb,23,0,Sun,0,5,59,64
2012-02-27,1,Feb,0,0,Mon,1,2,27,29
2012-02-27,1,Feb,1,0,Mon,1,0,6,6
2012-02-27,1,Feb,2,0,Mon,1,0,4,4
2012-02-27,1,Feb,3,0,Mon,1,0,2,2
2012-02-27,1,Feb,4,0,Mon,1,0,1,1
2012-02-27,1,Feb,5,0,Mon,1,0,16,16
2012-02-27,1,Feb,6,0,Mon,1,1,89,90
2012-02-27,1,Feb,7,0,Mon,1,2,278,280
2012-02-27,1,Feb,8,0,Mon,1,14,514,528
2012-02-27,1,Feb,9,0,Mon,1,11,219,230
2012-02-27,1,Feb,10,0,Mon,1,16,88,104
2012-02-27,1,Feb,11,0,Mon,1,11,92,103
2012-02-27,1,Feb,12,0,Mon,1,13,164,177
2012-02-27,1,Feb,13,0,Mon,1,23,159,182
2012-02-27,1,Feb,14,0,Mon,1,24,134,158
2012-02-27,1,Feb,15,0,Mon,1,24,150,174
2012-02-27,1,Feb,16,0,Mon,1,20,266,286
2012-02-27,1,Feb,17,0,Mon,1,26,503,529
2012-02-27,1,Feb,18,0,Mon,1,10,517,527
2012-02-27,1,Feb,19,0,Mon,1,16,318,334
2012-02-27,1,Feb,20,0,Mon,1,11,208,219
2012-02-27,1,Feb,21,0,Mon,1,14,181,195
2012-02-27,1,Feb,22,0,Mon,1,9,83,92
2012-02-27,1,Feb,23,0,Mon,1,6,50,56
2012-02-28,1,Feb,0,0,Tue,1,0,10,10
2012-02-28,1,Feb,1,0,Tue,1,0,6,6
2012-02-28,1,Feb,2,0,Tue,1,1,2,3
2012-02-28,1,Feb,3,0,Tue,1,0,6,6
2012-02-28,1,Feb,4,0,Tue,1,0,2,2
2012-02-28,1,Feb,5,0,Tue,1,1,20,21
2012-02-28,1,Feb,6,0,Tue,1,1,100,101
2012-02-28,1,Feb,7,0,Tue,1,12,313,325
2012-02-28,1,Feb,8,0,Tue,1,16,543,559
2012-02-28,1,Feb,9,0,Tue,1,7,225,232
2012-02-28,1,Feb,10,0,Tue,1,14,118,132
2012-02-28,1,Feb,11,0,Tue,1,8,155,163
2012-02-28,1,Feb,12,0,Tue,1,19,164,183
2012-02-28,1,Feb,13,0,Tue,1,16,174,190
2012-02-28,1,Feb,14,0,Tue,1,13,121,134
2012-02-28,1,Feb,15,0,Tue,1,17,149,166
2012-02-28,1,Feb,16,0,Tue,1,17,270,287
2012-02-28,1,Feb,17,0,Tue,1,33,497,530
2012-02-28,1,Feb,18,0,Tue,1,17,432,449
2012-02-28,1,Feb,19,0,Tue,1,15,291,306
2012-02-28,1,Feb,20,0,Tue,1,2,202,204
2012-02-28,1,Feb,21,0,Tue,1,10,178,188
2012-02-28,1,Feb,22,0,Tue,1,6,95,101
2012-02-28,1,Feb,23,0,Tue,1,4,61,65
2012-02-29,1,Feb,0,0,Wed,1,2,30,32
2012-02-29,1,Feb,1,0,Wed,1,0,6,6
2012-02-29,1,Feb,2,0,Wed,1,0,4,4
2012-02-29,1,Feb,3,0,Wed,1,0,2,2
2012-02-29,1,Feb,5,0,Wed,1,0,29,29
2012-02-29,1,Feb,6,0,Wed,1,4,100,104
2012-02-29,1,Feb,7,0,Wed,1,11,242,253
2012-02-29,1,Feb,8,0,Wed,1,2,114,116
2012-02-29,1,Feb,9,0,Wed,1,5,33,38
2012-02-29,1,Feb,10,0,Wed,1,0,10,10
2012-02-29,1,Feb,11,0,Wed,1,1,9,10
2012-02-29,1,Feb,12,0,Wed,1,1,69,70
2012-02-29,1,Feb,13,0,Wed,1,4,72,76
2012-02-29,1,Feb,14,0,Wed,1,2,54,56
2012-02-29,1,Feb,15,0,Wed,1,3,87,90
2012-02-29,1,Feb,16,0,Wed,1,5,162,167
2012-02-29,1,Feb,17,0,Wed,1,7,246,253
2012-02-29,1,Feb,18,0,Wed,1,11,181,192
2012-02-29,1,Feb,19,0,Wed,1,0,102,102
2012-02-29,1,Feb,20,0,Wed,1,2,95,97
2012-02-29,1,Feb,21,0,Wed,1,0,39,39
2012-02-29,1,Feb,22,0,Wed,1,2,53,55
2012-02-29,1,Feb,23,0,Wed,1,3,30,33
2012-03-01,1,Mar,0,0,Thur,1,1,10,11
2012-03-01,1,Mar,1,0,Thur,1,0,12,12
2012-03-01,1,Mar,2,0,Thur,1,0,6,6
2012-03-01,1,Mar,3,0,Thur,1,0,3,3
2012-03-01,1,Mar,4,0,Thur,1,0,5,5
2012-03-01,1,Mar,5,0,Thur,1,0,18,18
2012-03-01,1,Mar,6,0,Thur,1,2,107,109
2012-03-01,1,Mar,7,0,Thur,1,8,296,304
2012-03-01,1,Mar,8,0,Thur,1,15,579,594
2012-03-01,1,Mar,9,0,Thur,1,5,281,286
2012-03-01,1,Mar,10,0,Thur,1,11,122,133
2012-03-01,1,Mar,11,0,Thur,1,19,149,168
2012-03-01,1,Mar,12,0,Thur,1,16,204,220
2012-03-01,1,Mar,13,0,Thur,1,24,187,211
2012-03-01,1,Mar,14,0,Thur,1,37,174,211
2012-03-01,1,Mar,15,0,Thur,1,31,192,223
2012-03-01,1,Mar,16,0,Thur,1,38,323,361
2012-03-01,1,Mar,17,0,Thur,1,49,551,600
2012-03-01,1,Mar,18,0,Thur,1,27,498,525
2012-03-01,1,Mar,19,0,Thur,1,11,317,328
2012-03-01,1,Mar,20,0,Thur,1,12,242,254
2012-03-01,1,Mar,21,0,Thur,1,7,190,197
2012-03-01,1,Mar,22,0,Thur,1,3,123,126
2012-03-01,1,Mar,23,0,Thur,1,9,76,85
2012-03-02,1,Mar,0,0,Fri,1,1,45,46
2012-03-02,1,Mar,1,0,Fri,1,2,18,20
2012-03-02,1,Mar,2,0,Fri,1,2,4,6
2012-03-02,1,Mar,3,0,Fri,1,0,3,3
2012-03-02,1,Mar,4,0,Fri,1,0,2,2
2012-03-02,1,Mar,5,0,Fri,1,0,24,24
2012-03-02,1,Mar,6,0,Fri,1,4,88,92
2012-03-02,1,Mar,7,0,Fri,1,4,258,262
2012-03-02,1,Mar,8,0,Fri,1,16,533,549
2012-03-02,1,Mar,9,0,Fri,1,15,299,314
2012-03-02,1,Mar,10,0,Fri,1,14,118,132
2012-03-02,1,Mar,11,0,Fri,1,40,154,194
2012-03-02,1,Mar,12,0,Fri,1,40,194,234
2012-03-02,1,Mar,13,0,Fri,1,31,191,222
2012-03-02,1,Mar,14,0,Fri,1,29,176,205
2012-03-02,1,Mar,15,0,Fri,1,5,73,78
2012-03-02,1,Mar,16,0,Fri,1,1,49,50
2012-03-02,1,Mar,17,0,Fri,1,5,123,128
2012-03-02,1,Mar,18,0,Fri,1,6,154,160
2012-03-02,1,Mar,19,0,Fri,1,12,162,174
2012-03-02,1,Mar,20,0,Fri,1,7,93,100
2012-03-02,1,Mar,21,0,Fri,1,2,99,101
2012-03-02,1,Mar,22,0,Fri,1,6,69,75
2012-03-02,1,Mar,23,0,Fri,1,4,19,23
2012-03-03,1,Mar,0,0,Sat,0,1,21,22
2012-03-03,1,Mar,1,0,Sat,0,0,44,44
2012-03-03,1,Mar,2,0,Sat,0,4,34,38
2012-03-03,1,Mar,3,0,Sat,0,1,20,21
2012-03-03,1,Mar,4,0,Sat,0,0,2,2
2012-03-03,1,Mar,5,0,Sat,0,1,1,2
2012-03-03,1,Mar,6,0,Sat,0,1,6,7
2012-03-03,1,Mar,7,0,Sat,0,2,14,16
2012-03-03,1,Mar,8,0,Sat,0,2,46,48
2012-03-03,1,Mar,9,0,Sat,0,7,87,94
2012-03-03,1,Mar,10,0,Sat,0,31,137,168
2012-03-03,1,Mar,11,0,Sat,0,33,181,214
2012-03-03,1,Mar,12,0,Sat,0,47,252,299
2012-03-03,1,Mar,13,0,Sat,0,87,252,339
2012-03-03,1,Mar,14,0,Sat,0,151,279,430
2012-03-03,1,Mar,15,0,Sat,0,145,254,399
2012-03-03,1,Mar,16,0,Sat,0,167,300,467
2012-03-03,1,Mar,17,0,Sat,0,106,279,385
2012-03-03,1,Mar,18,0,Sat,0,53,250,303
2012-03-03,1,Mar,19,0,Sat,0,34,191,225
2012-03-03,1,Mar,20,0,Sat,0,28,121,149
2012-03-03,1,Mar,21,0,Sat,0,24,130,154
2012-03-03,1,Mar,22,0,Sat,0,19,115,134
2012-03-03,1,Mar,23,0,Sat,0,12,94,106
2012-03-04,1,Mar,0,0,Sun,0,5,67,72
2012-03-04,1,Mar,1,0,Sun,0,16,60,76
2012-03-04,1,Mar,2,0,Sun,0,14,66,80
2012-03-04,1,Mar,3,0,Sun,0,5,21,26
2012-03-04,1,Mar,4,0,Sun,0,3,11,14
2012-03-04,1,Mar,5,0,Sun,0,0,5,5
2012-03-04,1,Mar,6,0,Sun,0,0,5,5
2012-03-04,1,Mar,7,0,Sun,0,2,21,23
2012-03-04,1,Mar,8,0,Sun,0,12,54,66
2012-03-04,1,Mar,9,0,Sun,0,14,104,118
2012-03-04,1,Mar,10,0,Sun,0,31,161,192
2012-03-04,1,Mar,11,0,Sun,0,64,192,256
2012-03-04,1,Mar,12,0,Sun,0,71,256,327
2012-03-04,1,Mar,13,0,Sun,0,108,256,364
2012-03-04,1,Mar,14,0,Sun,0,106,226,332
2012-03-04,1,Mar,15,0,Sun,0,82,252,334
2012-03-04,1,Mar,16,0,Sun,0,68,231,299
2012-03-04,1,Mar,17,0,Sun,0,49,214,263
2012-03-04,1,Mar,18,0,Sun,0,20,164,184
2012-03-04,1,Mar,19,0,Sun,0,12,120,132
2012-03-04,1,Mar,20,0,Sun,0,8,80,88
2012-03-04,1,Mar,21,0,Sun,0,9,70,79
2012-03-04,1,Mar,22,0,Sun,0,9,53,62
2012-03-04,1,Mar,23,0,Sun,0,2,24,26
2012-03-05,1,Mar,0,0,Mon,1,2,15,17
2012-03-05,1,Mar,1,0,Mon,1,3,3,6
2012-03-05,1,Mar,2,0,Mon,1,1,3,4
2012-03-05,1,Mar,3,0,Mon,1,0,1,1
2012-03-05,1,Mar,4,0,Mon,1,0,1,1
2012-03-05,1,Mar,5,0,Mon,1,1,17,18
2012-03-05,1,Mar,6,0,Mon,1,2,89,91
2012-03-05,1,Mar,7,0,Mon,1,7,253,260
2012-03-05,1,Mar,8,0,Mon,1,13,415,428
2012-03-05,1,Mar,9,0,Mon,1,11,186,197
2012-03-05,1,Mar,10,0,Mon,1,12,74,86
2012-03-05,1,Mar,11,0,Mon,1,17,86,103
2012-03-05,1,Mar,12,0,Mon,1,15,122,137
2012-03-05,1,Mar,13,0,Mon,1,11,109,120
2012-03-05,1,Mar,14,0,Mon,1,13,115,128
2012-03-05,1,Mar,15,0,Mon,1,20,110,130
2012-03-05,1,Mar,16,0,Mon,1,30,180,210
2012-03-05,1,Mar,17,0,Mon,1,11,376,387
2012-03-05,1,Mar,18,0,Mon,1,12,363,375
2012-03-05,1,Mar,19,0,Mon,1,6,220,226
2012-03-05,1,Mar,20,0,Mon,1,8,171,179
2012-03-05,1,Mar,21,0,Mon,1,4,116,120
2012-03-05,1,Mar,22,0,Mon,1,2,76,78
2012-03-05,1,Mar,23,0,Mon,1,2,29,31
2012-03-06,1,Mar,0,0,Tue,1,0,8,8
2012-03-06,1,Mar,1,0,Tue,1,0,6,6
2012-03-06,1,Mar,2,0,Tue,1,0,4,4
2012-03-06,1,Mar,3,0,Tue,1,0,1,1
2012-03-06,1,Mar,4,0,Tue,1,0,3,3
2012-03-06,1,Mar,5,0,Tue,1,0,25,25
2012-03-06,1,Mar,6,0,Tue,1,3,99,102
2012-03-06,1,Mar,7,0,Tue,1,5,270,275
2012-03-06,1,Mar,8,0,Tue,1,14,487,501
2012-03-06,1,Mar,9,0,Tue,1,11,222,233
2012-03-06,1,Mar,10,0,Tue,1,16,113,129
2012-03-06,1,Mar,11,0,Tue,1,20,110,130
2012-03-06,1,Mar,12,0,Tue,1,9,129,138
2012-03-06,1,Mar,13,0,Tue,1,16,148,164
2012-03-06,1,Mar,14,0,Tue,1,20,116,136
2012-03-06,1,Mar,15,0,Tue,1,24,142,166
2012-03-06,1,Mar,16,0,Tue,1,22,228,250
2012-03-06,1,Mar,17,0,Tue,1,21,425,446
2012-03-06,1,Mar,18,0,Tue,1,15,442,457
2012-03-06,1,Mar,19,0,Tue,1,9,278,287
2012-03-06,1,Mar,20,0,Tue,1,3,184,187
2012-03-06,1,Mar,21,0,Tue,1,5,143,148
2012-03-06,1,Mar,22,0,Tue,1,5,101,106
2012-03-06,1,Mar,23,0,Tue,1,3,51,54
2012-03-07,1,Mar,0,0,Wed,1,3,12,15
2012-03-07,1,Mar,1,0,Wed,1,1,4,5
2012-03-07,1,Mar,2,0,Wed,1,0,4,4
2012-03-07,1,Mar,3,0,Wed,1,1,2,3
2012-03-07,1,Mar,4,0,Wed,1,0,3,3
2012-03-07,1,Mar,5,0,Wed,1,0,18,18
2012-03-07,1,Mar,6,0,Wed,1,4,104,108
2012-03-07,1,Mar,7,0,Wed,1,12,332,344
2012-03-07,1,Mar,8,0,Wed,1,12,554,566
2012-03-07,1,Mar,9,0,Wed,1,12,252,264
2012-03-07,1,Mar,10,0,Wed,1,20,127,147
2012-03-07,1,Mar,11,0,Wed,1,33,128,161
2012-03-07,1,Mar,12,0,Wed,1,40,175,215
2012-03-07,1,Mar,13,0,Wed,1,26,179,205
2012-03-07,1,Mar,14,0,Wed,1,38,137,175
2012-03-07,1,Mar,15,0,Wed,1,44,165,209
2012-03-07,1,Mar,16,0,Wed,1,34,254,288
2012-03-07,1,Mar,17,0,Wed,1,58,554,612
2012-03-07,1,Mar,18,0,Wed,1,35,509,544
2012-03-07,1,Mar,19,0,Wed,1,16,345,361
2012-03-07,1,Mar,20,0,Wed,1,18,242,260
2012-03-07,1,Mar,21,0,Wed,1,11,177,188
2012-03-07,1,Mar,22,0,Wed,1,10,149,159
2012-03-07,1,Mar,23,0,Wed,1,4,58,62
2012-03-08,1,Mar,0,0,Thur,1,11,35,46
2012-03-08,1,Mar,1,0,Thur,1,4,17,21
2012-03-08,1,Mar,2,0,Thur,1,6,5,11
2012-03-08,1,Mar,3,0,Thur,1,0,3,3
2012-03-08,1,Mar,4,0,Thur,1,0,2,2
2012-03-08,1,Mar,5,0,Thur,1,1,28,29
2012-03-08,1,Mar,6,0,Thur,1,4,105,109
2012-03-08,1,Mar,7,0,Thur,1,8,326,334
2012-03-08,1,Mar,8,0,Thur,1,12,573,585
2012-03-08,1,Mar,9,0,Thur,1,19,282,301
2012-03-08,1,Mar,10,0,Thur,1,19,119,138
2012-03-08,1,Mar,11,0,Thur,1,48,156,204
2012-03-08,1,Mar,12,0,Thur,1,27,224,251
2012-03-08,1,Mar,13,0,Thur,1,35,198,233
2012-03-08,1,Mar,14,0,Thur,1,48,155,203
2012-03-08,1,Mar,15,0,Thur,1,24,161,185
2012-03-08,1,Mar,16,0,Thur,1,37,305,342
2012-03-08,1,Mar,17,0,Thur,1,52,545,597
2012-03-08,1,Mar,18,0,Thur,1,45,545,590
2012-03-08,1,Mar,19,0,Thur,1,21,395,416
2012-03-08,1,Mar,20,0,Thur,1,20,282,302
2012-03-08,1,Mar,21,0,Thur,1,27,206,233
2012-03-08,1,Mar,22,0,Thur,1,12,141,153
2012-03-08,1,Mar,23,0,Thur,1,6,88,94
2012-03-09,1,Mar,0,0,Fri,1,3,51,54
2012-03-09,1,Mar,1,0,Fri,1,4,22,26
2012-03-09,1,Mar,2,0,Fri,1,2,9,11
2012-03-09,1,Mar,3,0,Fri,1,0,7,7
2012-03-09,1,Mar,4,0,Fri,1,0,1,1
2012-03-09,1,Mar,5,0,Fri,1,2,27,29
2012-03-09,1,Mar,6,0,Fri,1,2,83,85
2012-03-09,1,Mar,7,0,Fri,1,6,262,268
2012-03-09,1,Mar,8,0,Fri,1,17,484,501
2012-03-09,1,Mar,9,0,Fri,1,17,267,284
2012-03-09,1,Mar,10,0,Fri,1,14,145,159
2012-03-09,1,Mar,11,0,Fri,1,17,170,187
2012-03-09,1,Mar,12,0,Fri,1,27,174,201
2012-03-09,1,Mar,13,0,Fri,1,49,175,224
2012-03-09,1,Mar,14,0,Fri,1,49,129,178
2012-03-09,1,Mar,15,0,Fri,1,50,188,238
2012-03-09,1,Mar,16,0,Fri,1,51,292,343
2012-03-09,1,Mar,17,0,Fri,1,68,498,566
2012-03-09,1,Mar,18,0,Fri,1,30,440,470
2012-03-09,1,Mar,19,0,Fri,1,12,232,244
2012-03-09,1,Mar,20,0,Fri,1,3,156,159
2012-03-09,1,Mar,21,0,Fri,1,8,133,141
2012-03-09,1,Mar,22,0,Fri,1,7,100,107
2012-03-09,1,Mar,23,0,Fri,1,9,77,86
2012-03-10,1,Mar,0,0,Sat,0,9,68,77
2012-03-10,1,Mar,1,0,Sat,0,1,50,51
2012-03-10,1,Mar,2,0,Sat,0,12,30,42
2012-03-10,1,Mar,3,0,Sat,0,0,16,16
2012-03-10,1,Mar,4,0,Sat,0,1,3,4
2012-03-10,1,Mar,5,0,Sat,0,3,7,10
2012-03-10,1,Mar,6,0,Sat,0,1,11,12
2012-03-10,1,Mar,7,0,Sat,0,4,36,40
2012-03-10,1,Mar,8,0,Sat,0,15,96,111
2012-03-10,1,Mar,9,0,Sat,0,21,127,148
2012-03-10,1,Mar,10,0,Sat,0,47,176,223
2012-03-10,1,Mar,11,0,Sat,0,56,218,274
2012-03-10,1,Mar,12,0,Sat,0,88,241,329
2012-03-10,1,Mar,13,0,Sat,0,89,268,357
2012-03-10,1,Mar,14,0,Sat,0,117,262,379
2012-03-10,1,Mar,15,0,Sat,0,132,274,406
2012-03-10,1,Mar,16,0,Sat,0,115,275,390
2012-03-10,1,Mar,17,0,Sat,0,104,250,354
2012-03-10,1,Mar,18,0,Sat,0,67,230,297
2012-03-10,1,Mar,19,0,Sat,0,25,159,184
2012-03-10,1,Mar,20,0,Sat,0,20,101,121
2012-03-10,1,Mar,21,0,Sat,0,16,94,110
2012-03-10,1,Mar,22,0,Sat,0,19,81,100
2012-03-10,1,Mar,23,0,Sat,0,6,77,83
2012-03-11,1,Mar,0,0,Sun,0,7,62,69
2012-03-11,1,Mar,1,0,Sun,0,4,57,61
2012-03-11,1,Mar,3,0,Sun,0,15,51,66
2012-03-11,1,Mar,4,0,Sun,0,7,15,22
2012-03-11,1,Mar,5,0,Sun,0,2,5,7
2012-03-11,1,Mar,6,0,Sun,0,2,8,10
2012-03-11,1,Mar,7,0,Sun,0,2,15,17
2012-03-11,1,Mar,8,0,Sun,0,4,68,72
2012-03-11,1,Mar,9,0,Sun,0,20,70,90
2012-03-11,1,Mar,10,0,Sun,0,71,147,218
2012-03-11,1,Mar,11,0,Sun,0,90,209,299
2012-03-11,1,Mar,12,0,Sun,0,146,264,410
2012-03-11,1,Mar,13,0,Sun,0,176,288,464
2012-03-11,1,Mar,14,0,Sun,0,212,289,501
2012-03-11,1,Mar,15,0,Sun,0,201,286,487
2012-03-11,1,Mar,16,0,Sun,0,208,301,509
2012-03-11,1,Mar,17,0,Sun,0,199,299,498
2012-03-11,1,Mar,18,0,Sun,0,133,256,389
2012-03-11,1,Mar,19,0,Sun,0,55,203,258
2012-03-11,1,Mar,20,0,Sun,0,42,129,171
2012-03-11,1,Mar,21,0,Sun,0,37,110,147
2012-03-11,1,Mar,22,0,Sun,0,13,81,94
2012-03-11,1,Mar,23,0,Sun,0,12,40,52
2012-03-12,1,Mar,0,0,Mon,1,4,20,24
2012-03-12,1,Mar,1,0,Mon,1,1,9,10
2012-03-12,1,Mar,2,0,Mon,1,4,5,9
2012-03-12,1,Mar,3,0,Mon,1,0,2,2
2012-03-12,1,Mar,4,0,Mon,1,0,3,3
2012-03-12,1,Mar,5,0,Mon,1,1,15,16
2012-03-12,1,Mar,6,0,Mon,1,2,86,88
2012-03-12,1,Mar,7,0,Mon,1,9,259,268
2012-03-12,1,Mar,8,0,Mon,1,17,547,564
2012-03-12,1,Mar,9,0,Mon,1,21,260,281
2012-03-12,1,Mar,10,0,Mon,1,39,98,137
2012-03-12,1,Mar,11,0,Mon,1,39,111,150
2012-03-12,1,Mar,12,0,Mon,1,59,162,221
2012-03-12,1,Mar,13,0,Mon,1,74,176,250
2012-03-12,1,Mar,14,0,Mon,1,76,145,221
2012-03-12,1,Mar,15,0,Mon,1,74,159,233
2012-03-12,1,Mar,16,0,Mon,1,77,255,332
2012-03-12,1,Mar,17,0,Mon,1,87,557,644
2012-03-12,1,Mar,18,0,Mon,1,89,623,712
2012-03-12,1,Mar,19,0,Mon,1,67,379,446
2012-03-12,1,Mar,20,0,Mon,1,49,237,286
2012-03-12,1,Mar,21,0,Mon,1,22,183,205
2012-03-12,1,Mar,22,0,Mon,1,17,116,133
2012-03-12,1,Mar,23,0,Mon,1,10,53,63
2012-03-13,1,Mar,0,0,Tue,1,5,21,26
2012-03-13,1,Mar,1,0,Tue,1,2,14,16
2012-03-13,1,Mar,2,0,Tue,1,0,1,1
2012-03-13,1,Mar,3,0,Tue,1,0,2,2
2012-03-13,1,Mar,4,0,Tue,1,0,1,1
2012-03-13,1,Mar,5,0,Tue,1,0,24,24
2012-03-13,1,Mar,6,0,Tue,1,5,108,113
2012-03-13,1,Mar,7,0,Tue,1,16,292,308
2012-03-13,1,Mar,8,0,Tue,1,22,571,593
2012-03-13,1,Mar,9,0,Tue,1,18,324,342
2012-03-13,1,Mar,10,0,Tue,1,28,115,143
2012-03-13,1,Mar,11,0,Tue,1,64,155,219
2012-03-13,1,Mar,12,0,Tue,1,47,197,244
2012-03-13,1,Mar,13,0,Tue,1,53,180,233
2012-03-13,1,Mar,14,0,Tue,1,52,160,212
2012-03-13,1,Mar,15,0,Tue,1,68,196,264
2012-03-13,1,Mar,16,0,Tue,1,53,312,365
2012-03-13,1,Mar,17,0,Tue,1,62,614,676
2012-03-13,1,Mar,18,0,Tue,1,96,638,734
2012-03-13,1,Mar,19,0,Tue,1,50,429,479
2012-03-13,1,Mar,20,0,Tue,1,45,306,351
2012-03-13,1,Mar,21,0,Tue,1,44,200,244
2012-03-13,1,Mar,22,0,Tue,1,24,146,170
2012-03-13,1,Mar,23,0,Tue,1,8,79,87
2012-03-14,1,Mar,0,0,Wed,1,5,34,39
2012-03-14,1,Mar,1,0,Wed,1,2,25,27
2012-03-14,1,Mar,2,0,Wed,1,0,2,2
2012-03-14,1,Mar,3,0,Wed,1,1,3,4
2012-03-14,1,Mar,4,0,Wed,1,1,4,5
2012-03-14,1,Mar,5,0,Wed,1,2,25,27
2012-03-14,1,Mar,6,0,Wed,1,1,120,121
2012-03-14,1,Mar,7,0,Wed,1,20,348,368
2012-03-14,1,Mar,8,0,Wed,1,34,628,662
2012-03-14,1,Mar,9,0,Wed,1,26,325,351
2012-03-14,1,Mar,10,0,Wed,1,38,150,188
2012-03-14,1,Mar,11,0,Wed,1,65,155,220
2012-03-14,1,Mar,12,0,Wed,1,55,212,267
2012-03-14,1,Mar,13,0,Wed,1,57,197,254
2012-03-14,1,Mar,14,0,Wed,1,61,163,224
2012-03-14,1,Mar,15,0,Wed,1,86,197,283
2012-03-14,1,Mar,16,0,Wed,1,78,278,356
2012-03-14,1,Mar,17,0,Wed,1,140,642,782
2012-03-14,1,Mar,18,0,Wed,1,102,647,749
2012-03-14,1,Mar,19,0,Wed,1,70,402,472
2012-03-14,1,Mar,20,0,Wed,1,44,286,330
2012-03-14,1,Mar,21,0,Wed,1,47,241,288
2012-03-14,1,Mar,22,0,Wed,1,43,159,202
2012-03-14,1,Mar,23,0,Wed,1,19,72,91
2012-03-15,1,Mar,0,0,Thur,1,14,46,60
2012-03-15,1,Mar,1,0,Thur,1,15,8,23
2012-03-15,1,Mar,2,0,Thur,1,14,5,19
2012-03-15,1,Mar,3,0,Thur,1,0,7,7
2012-03-15,1,Mar,4,0,Thur,1,11,3,14
2012-03-15,1,Mar,5,0,Thur,1,2,24,26
2012-03-15,1,Mar,6,0,Thur,1,4,113,117
2012-03-15,1,Mar,7,0,Thur,1,14,367,381
2012-03-15,1,Mar,8,0,Thur,1,21,602,623
2012-03-15,1,Mar,9,0,Thur,1,30,285,315
2012-03-15,1,Mar,10,0,Thur,1,34,130,164
2012-03-15,1,Mar,11,0,Thur,1,60,151,211
2012-03-15,1,Mar,12,0,Thur,1,59,206,265
2012-03-15,1,Mar,13,0,Thur,1,62,211,273
2012-03-15,1,Mar,14,0,Thur,1,81,177,258
2012-03-15,1,Mar,15,0,Thur,1,100,187,287
2012-03-15,1,Mar,16,0,Thur,1,95,331,426
2012-03-15,1,Mar,17,0,Thur,1,79,634,713
2012-03-15,1,Mar,18,0,Thur,1,98,648,746
2012-03-15,1,Mar,19,0,Thur,1,72,353,425
2012-03-15,1,Mar,20,0,Thur,1,60,270,330
2012-03-15,1,Mar,21,0,Thur,1,36,207,243
2012-03-15,1,Mar,22,0,Thur,1,32,137,169
2012-03-15,1,Mar,23,0,Thur,1,12,85,97
2012-03-16,1,Mar,0,0,Fri,1,8,49,57
2012-03-16,1,Mar,1,0,Fri,1,4,22,26
2012-03-16,1,Mar,2,0,Fri,1,0,4,4
2012-03-16,1,Mar,3,0,Fri,1,0,3,3
2012-03-16,1,Mar,4,0,Fri,1,0,3,3
2012-03-16,1,Mar,5,0,Fri,1,2,30,32
2012-03-16,1,Mar,6,0,Fri,1,3,96,99
2012-03-16,1,Mar,7,0,Fri,1,13,265,278
2012-03-16,1,Mar,8,0,Fri,1,28,534,562
2012-03-16,1,Mar,9,0,Fri,1,35,277,312
2012-03-16,1,Mar,10,0,Fri,1,44,136,180
2012-03-16,1,Mar,11,0,Fri,1,40,167,207
2012-03-16,1,Mar,12,0,Fri,1,72,222,294
2012-03-16,1,Mar,13,0,Fri,1,52,208,260
2012-03-16,1,Mar,14,0,Fri,1,56,146,202
2012-03-16,1,Mar,15,0,Fri,1,19,88,107
2012-03-16,1,Mar,16,0,Fri,1,18,111,129
2012-03-16,1,Mar,17,0,Fri,1,23,235,258
2012-03-16,1,Mar,18,0,Fri,1,31,377,408
2012-03-16,1,Mar,19,0,Fri,1,23,273,296
2012-03-16,1,Mar,20,0,Fri,1,31,204,235
2012-03-16,1,Mar,21,0,Fri,1,8,144,152
2012-03-16,1,Mar,22,0,Fri,1,16,132,148
2012-03-16,1,Mar,23,0,Fri,1,22,104,126
2012-03-17,1,Mar,0,0,Sat,0,13,87,100
2012-03-17,1,Mar,1,0,Sat,0,12,57,69
2012-03-17,1,Mar,2,0,Sat,0,10,32,42
2012-03-17,1,Mar,3,0,Sat,0,2,24,26
2012-03-17,1,Mar,4,0,Sat,0,0,2,2
2012-03-17,1,Mar,5,0,Sat,0,5,3,8
2012-03-17,1,Mar,6,0,Sat,0,1,29,30
2012-03-17,1,Mar,7,0,Sat,0,29,57,86
2012-03-17,1,Mar,8,0,Sat,0,63,155,218
2012-03-17,1,Mar,9,0,Sat,0,104,217,321
2012-03-17,1,Mar,10,0,Sat,0,140,303,443
2012-03-17,1,Mar,11,0,Sat,0,226,359,585
2012-03-17,1,Mar,12,0,Sat,0,286,365,651
2012-03-17,1,Mar,13,0,Sat,0,286,400,686
2012-03-17,1,Mar,14,0,Sat,0,352,338,690
2012-03-17,1,Mar,15,0,Sat,0,357,322,679
2012-03-17,1,Mar,16,0,Sat,0,367,318,685
2012-03-17,1,Mar,17,0,Sat,0,291,357,648
2012-03-17,1,Mar,18,0,Sat,0,221,339,560
2012-03-17,1,Mar,19,0,Sat,0,155,262,417
2012-03-17,1,Mar,20,0,Sat,0,89,182,271
2012-03-17,1,Mar,21,0,Sat,0,54,169,223
2012-03-17,1,Mar,22,0,Sat,0,58,153,211
2012-03-17,1,Mar,23,0,Sat,0,34,151,185
2012-03-18,1,Mar,0,0,Sun,0,27,80,107
2012-03-18,1,Mar,1,0,Sun,0,25,88,113
2012-03-18,1,Mar,2,0,Sun,0,15,41,56
2012-03-18,1,Mar,3,0,Sun,0,3,15,18
2012-03-18,1,Mar,4,0,Sun,0,6,8,14
2012-03-18,1,Mar,5,0,Sun,0,0,6,6
2012-03-18,1,Mar,6,0,Sun,0,2,9,11
2012-03-18,1,Mar,7,0,Sun,0,17,25,42
2012-03-18,1,Mar,8,0,Sun,0,25,71,96
2012-03-18,1,Mar,9,0,Sun,0,65,113,178
2012-03-18,1,Mar,10,0,Sun,0,139,212,351
2012-03-18,1,Mar,11,0,Sun,0,129,239,368
2012-03-18,1,Mar,12,0,Sun,0,222,281,503
2012-03-18,1,Mar,13,0,Sun,0,198,346,544
2012-03-18,1,Mar,14,0,Sun,0,218,303,521
2012-03-18,1,Mar,15,0,Sun,0,240,314,554
2012-03-18,1,Mar,16,0,Sun,0,229,312,541
2012-03-18,1,Mar,17,0,Sun,0,233,308,541
2012-03-18,1,Mar,18,0,Sun,0,165,294,459
2012-03-18,1,Mar,19,0,Sun,0,118,234,352
2012-03-18,1,Mar,20,0,Sun,0,59,139,198
2012-03-18,1,Mar,21,0,Sun,0,44,129,173
2012-03-18,1,Mar,22,0,Sun,0,21,79,100
2012-03-18,1,Mar,23,0,Sun,0,7,39,46
2012-03-19,1,Mar,0,0,Mon,1,4,19,23
2012-03-19,1,Mar,1,0,Mon,1,0,15,15
2012-03-19,1,Mar,2,0,Mon,1,1,7,8
2012-03-19,1,Mar,3,0,Mon,1,0,2,2
2012-03-19,1,Mar,4,0,Mon,1,0,3,3
2012-03-19,1,Mar,5,0,Mon,1,0,31,31
2012-03-19,1,Mar,6,0,Mon,1,2,118,120
2012-03-19,1,Mar,7,0,Mon,1,25,329,354
2012-03-19,1,Mar,8,0,Mon,1,16,563,579
2012-03-19,1,Mar,9,0,Mon,1,55,276,331
2012-03-19,1,Mar,10,0,Mon,1,56,128,184
2012-03-19,1,Mar,11,0,Mon,1,56,145,201
2012-03-19,1,Mar,12,0,Mon,1,71,211,282
2012-03-19,1,Mar,13,0,Mon,1,69,194,263
2012-03-19,1,Mar,14,0,Mon,1,60,200,260
2012-03-19,1,Mar,15,0,Mon,1,97,189,286
2012-03-19,1,Mar,16,0,Mon,1,65,320,385
2012-03-19,1,Mar,17,0,Mon,1,106,615,721
2012-03-19,1,Mar,18,0,Mon,1,120,681,801
2012-03-19,1,Mar,19,0,Mon,1,86,463,549
2012-03-19,1,Mar,20,0,Mon,1,34,296,330
2012-03-19,1,Mar,21,0,Mon,1,33,190,223
2012-03-19,1,Mar,22,0,Mon,1,17,131,148
2012-03-19,1,Mar,23,0,Mon,1,9,45,54
2012-03-20,1,Mar,0,0,Tue,1,5,24,29
2012-03-20,1,Mar,1,0,Tue,1,6,9,15
2012-03-20,1,Mar,2,0,Tue,1,2,8,10
2012-03-20,1,Mar,3,0,Tue,1,0,3,3
2012-03-20,1,Mar,4,0,Tue,1,0,6,6
2012-03-20,1,Mar,5,0,Tue,1,0,20,20
2012-03-20,1,Mar,6,0,Tue,1,6,94,100
2012-03-20,1,Mar,7,0,Tue,1,3,167,170
2012-03-20,1,Mar,8,0,Tue,1,28,488,516
2012-03-20,1,Mar,9,0,Tue,1,41,284,325
2012-03-20,1,Mar,10,0,Tue,1,44,119,163
2012-03-20,1,Mar,11,0,Tue,1,74,156,230
2012-03-20,1,Mar,12,0,Tue,1,56,205,261
2012-03-20,1,Mar,13,0,Tue,1,77,207,284
2012-03-20,1,Mar,14,0,Tue,1,66,182,248
2012-03-20,1,Mar,15,0,Tue,1,67,177,244
2012-03-20,1,Mar,16,0,Tue,1,99,332,431
2012-03-20,1,Mar,17,0,Tue,1,108,642,750
2012-03-20,1,Mar,18,0,Tue,1,136,665,801
2012-03-20,1,Mar,19,0,Tue,1,75,480,555
2012-03-20,1,Mar,20,0,Tue,1,78,299,377
2012-03-20,1,Mar,21,0,Tue,1,38,239,277
2012-03-20,1,Mar,22,0,Tue,1,32,156,188
2012-03-20,1,Mar,23,0,Tue,1,10,80,90
2012-03-21,1,Mar,0,0,Wed,1,4,29,33
2012-03-21,1,Mar,1,0,Wed,1,4,22,26
2012-03-21,1,Mar,2,0,Wed,1,2,8,10
2012-03-21,1,Mar,3,0,Wed,1,1,7,8
2012-03-21,1,Mar,4,0,Wed,1,0,4,4
2012-03-21,1,Mar,5,0,Wed,1,4,35,39
2012-03-21,1,Mar,6,0,Wed,1,10,139,149
2012-03-21,1,Mar,7,0,Wed,1,34,338,372
2012-03-21,1,Mar,8,0,Wed,1,33,502,535
2012-03-21,1,Mar,9,0,Wed,1,38,255,293
2012-03-21,1,Mar,10,0,Wed,1,30,124,154
2012-03-21,1,Mar,11,0,Wed,1,38,154,192
2012-03-21,1,Mar,12,0,Wed,1,58,171,229
2012-03-21,1,Mar,13,0,Wed,1,81,222,303
2012-03-21,1,Mar,14,0,Wed,1,74,151,225
2012-03-21,1,Mar,15,0,Wed,1,68,175,243
2012-03-21,1,Mar,16,0,Wed,1,91,287,378
2012-03-21,1,Mar,17,0,Wed,1,113,616,729
2012-03-21,1,Mar,18,0,Wed,1,152,627,779
2012-03-21,1,Mar,19,0,Wed,1,86,496,582
2012-03-21,1,Mar,20,0,Wed,1,76,298,374
2012-03-21,1,Mar,21,0,Wed,1,47,204,251
2012-03-21,1,Mar,22,0,Wed,1,41,156,197
2012-03-21,1,Mar,23,0,Wed,1,37,88,125
2012-03-22,1,Mar,0,0,Thur,1,9,32,41
2012-03-22,1,Mar,1,0,Thur,1,14,16,30
2012-03-22,1,Mar,2,0,Thur,1,1,5,6
2012-03-22,1,Mar,3,0,Thur,1,0,7,7
2012-03-22,1,Mar,4,0,Thur,1,0,6,6
2012-03-22,1,Mar,5,0,Thur,1,2,32,34
2012-03-22,1,Mar,6,0,Thur,1,10,126,136
2012-03-22,1,Mar,7,0,Thur,1,29,332,361
2012-03-22,1,Mar,8,0,Thur,1,51,598,649
2012-03-22,1,Mar,9,0,Thur,1,41,277,318
2012-03-22,1,Mar,10,0,Thur,1,32,110,142
2012-03-22,1,Mar,11,0,Thur,1,53,166,219
2012-03-22,1,Mar,12,0,Thur,1,48,224,272
2012-03-22,1,Mar,13,0,Thur,1,83,215,298
2012-03-22,1,Mar,14,0,Thur,1,96,161,257
2012-03-22,1,Mar,15,0,Thur,1,102,202,304
2012-03-22,1,Mar,16,0,Thur,1,125,300,425
2012-03-22,1,Mar,17,0,Thur,1,154,656,810
2012-03-22,1,Mar,18,0,Thur,1,147,654,801
2012-03-22,1,Mar,19,0,Thur,1,117,469,586
2012-03-22,1,Mar,20,0,Thur,1,64,360,424
2012-03-22,1,Mar,21,0,Thur,1,66,308,374
2012-03-22,1,Mar,22,0,Thur,1,56,164,220
2012-03-22,1,Mar,23,0,Thur,1,34,117,151
2012-03-23,1,Mar,0,0,Fri,1,30,65,95
2012-03-23,1,Mar,1,0,Fri,1,18,32,50
2012-03-23,1,Mar,2,0,Fri,1,12,20,32
2012-03-23,1,Mar,3,0,Fri,1,4,6,10
2012-03-23,1,Mar,4,0,Fri,1,0,3,3
2012-03-23,1,Mar,5,0,Fri,1,5,29,34
2012-03-23,1,Mar,6,0,Fri,1,6,110,116
2012-03-23,1,Mar,7,0,Fri,1,28,318,346
2012-03-23,1,Mar,8,0,Fri,1,47,615,662
2012-03-23,1,Mar,9,0,Fri,1,75,305,380
2012-03-23,1,Mar,10,0,Fri,1,125,150,275
2012-03-23,1,Mar,11,0,Fri,1,131,187,318
2012-03-23,1,Mar,12,0,Fri,1,199,272,471
2012-03-23,1,Mar,13,0,Fri,1,172,256,428
2012-03-23,1,Mar,14,0,Fri,1,208,224,432
2012-03-23,1,Mar,15,0,Fri,1,191,281,472
2012-03-23,1,Mar,16,0,Fri,1,219,370,589
2012-03-23,1,Mar,17,0,Fri,1,264,693,957
2012-03-23,1,Mar,18,0,Fri,1,237,593,830
2012-03-23,1,Mar,19,0,Fri,1,213,473,686
2012-03-23,1,Mar,20,0,Fri,1,117,328,445
2012-03-23,1,Mar,21,0,Fri,1,64,220,284
2012-03-23,1,Mar,22,0,Fri,1,53,218,271
2012-03-23,1,Mar,23,0,Fri,1,51,125,176
2012-03-24,1,Mar,0,0,Sat,0,45,111,156
2012-03-24,1,Mar,1,0,Sat,0,20,108,128
2012-03-24,1,Mar,2,0,Sat,0,14,55,69
2012-03-24,1,Mar,3,0,Sat,0,10,22,32
2012-03-24,1,Mar,4,0,Sat,0,1,6,7
2012-03-24,1,Mar,5,0,Sat,0,0,4,4
2012-03-24,1,Mar,6,0,Sat,0,4,24,28
2012-03-24,1,Mar,7,0,Sat,0,25,45,70
2012-03-24,1,Mar,8,0,Sat,0,41,113,154
2012-03-24,1,Mar,9,0,Sat,0,96,153,249
2012-03-24,1,Mar,10,0,Sat,0,148,197,345
2012-03-24,1,Mar,11,0,Sat,0,98,175,273
2012-03-24,1,Mar,12,0,Sat,0,61,122,183
2012-03-24,1,Mar,13,0,Sat,0,62,134,196
2012-03-24,1,Mar,14,0,Sat,0,63,160,223
2012-03-24,1,Mar,15,0,Sat,0,118,172,290
2012-03-24,1,Mar,16,0,Sat,0,49,128,177
2012-03-24,1,Mar,17,0,Sat,0,47,68,115
2012-03-24,1,Mar,18,0,Sat,0,27,110,137
2012-03-24,1,Mar,19,0,Sat,0,28,105,133
2012-03-24,1,Mar,20,0,Sat,0,31,80,111
2012-03-24,1,Mar,21,0,Sat,0,16,88,104
2012-03-24,1,Mar,22,0,Sat,0,12,71,83
2012-03-24,1,Mar,23,0,Sat,0,17,88,105
2012-03-25,1,Mar,0,0,Sun,0,18,62,80
2012-03-25,1,Mar,1,0,Sun,0,24,65,89
2012-03-25,1,Mar,2,0,Sun,0,6,29,35
2012-03-25,1,Mar,3,0,Sun,0,8,10,18
2012-03-25,1,Mar,4,0,Sun,0,1,7,8
2012-03-25,1,Mar,5,0,Sun,0,0,6,6
2012-03-25,1,Mar,6,0,Sun,0,5,13,18
2012-03-25,1,Mar,7,0,Sun,0,14,25,39
2012-03-25,1,Mar,8,0,Sun,0,21,68,89
2012-03-25,1,Mar,9,0,Sun,0,26,92,118
2012-03-25,1,Mar,10,0,Sun,0,78,172,250
2012-03-25,1,Mar,11,0,Sun,0,106,217,323
2012-03-25,1,Mar,12,0,Sun,0,122,238,360
2012-03-25,1,Mar,13,0,Sun,0,110,257,367
2012-03-25,1,Mar,14,0,Sun,0,123,291,414
2012-03-25,1,Mar,15,0,Sun,0,139,282,421
2012-03-25,1,Mar,16,0,Sun,0,153,339,492
2012-03-25,1,Mar,17,0,Sun,0,146,273,419
2012-03-25,1,Mar,18,0,Sun,0,202,289,491
2012-03-25,1,Mar,19,0,Sun,0,114,261,375
2012-03-25,1,Mar,20,0,Sun,0,63,196,259
2012-03-25,1,Mar,21,0,Sun,0,25,124,149
2012-03-25,1,Mar,22,0,Sun,0,19,92,111
2012-03-25,1,Mar,23,0,Sun,0,9,56,65
2012-03-26,1,Mar,0,0,Mon,1,10,23,33
2012-03-26,1,Mar,1,0,Mon,1,18,10,28
2012-03-26,1,Mar,2,0,Mon,1,14,6,20
2012-03-26,1,Mar,3,0,Mon,1,0,1,1
2012-03-26,1,Mar,4,0,Mon,1,0,4,4
2012-03-26,1,Mar,5,0,Mon,1,0,36,36
2012-03-26,1,Mar,6,0,Mon,1,7,110,117
2012-03-26,1,Mar,7,0,Mon,1,15,355,370
2012-03-26,1,Mar,8,0,Mon,1,32,625,657
2012-03-26,1,Mar,9,0,Mon,1,37,245,282
2012-03-26,1,Mar,10,0,Mon,1,55,98,153
2012-03-26,1,Mar,11,0,Mon,1,47,131,178
2012-03-26,1,Mar,12,0,Mon,1,63,216,279
2012-03-26,1,Mar,13,0,Mon,1,79,222,301
2012-03-26,1,Mar,14,0,Mon,1,58,159,217
2012-03-26,1,Mar,15,0,Mon,1,66,157,223
2012-03-26,1,Mar,16,0,Mon,1,60,245,305
2012-03-26,1,Mar,17,0,Mon,1,65,599,664
2012-03-26,1,Mar,18,0,Mon,1,90,594,684
2012-03-26,1,Mar,19,0,Mon,1,41,417,458
2012-03-26,1,Mar,20,0,Mon,1,12,209,221
2012-03-26,1,Mar,21,0,Mon,1,11,175,186
2012-03-26,1,Mar,22,0,Mon,1,13,80,93
2012-03-26,1,Mar,23,0,Mon,1,2,46,48
2012-03-27,1,Mar,0,0,Tue,1,1,9,10
2012-03-27,1,Mar,1,0,Tue,1,1,4,5
2012-03-27,1,Mar,2,0,Tue,1,1,6,7
2012-03-27,1,Mar,3,0,Tue,1,0,4,4
2012-03-27,1,Mar,4,0,Tue,1,0,3,3
2012-03-27,1,Mar,5,0,Tue,1,1,16,17
2012-03-27,1,Mar,6,0,Tue,1,5,96,101
2012-03-27,1,Mar,7,0,Tue,1,9,277,286
2012-03-27,1,Mar,8,0,Tue,1,14,567,581
2012-03-27,1,Mar,9,0,Tue,1,8,259,267
2012-03-27,1,Mar,10,0,Tue,1,20,118,138
2012-03-27,1,Mar,11,0,Tue,1,34,141,175
2012-03-27,1,Mar,12,0,Tue,1,34,186,220
2012-03-27,1,Mar,13,0,Tue,1,46,165,211
2012-03-27,1,Mar,14,0,Tue,1,37,147,184
2012-03-27,1,Mar,15,0,Tue,1,42,158,200
2012-03-27,1,Mar,16,0,Tue,1,38,267,305
2012-03-27,1,Mar,17,0,Tue,1,72,542,614
2012-03-27,1,Mar,18,0,Tue,1,67,577,644
2012-03-27,1,Mar,19,0,Tue,1,40,377,417
2012-03-27,1,Mar,20,0,Tue,1,28,266,294
2012-03-27,1,Mar,21,0,Tue,1,21,200,221
2012-03-27,1,Mar,22,0,Tue,1,7,127,134
2012-03-27,1,Mar,23,0,Tue,1,5,59,64
2012-03-28,1,Mar,0,0,Wed,1,1,29,30
2012-03-28,1,Mar,1,0,Wed,1,0,8,8
2012-03-28,1,Mar,2,0,Wed,1,0,3,3
2012-03-28,1,Mar,3,0,Wed,1,1,4,5
2012-03-28,1,Mar,4,0,Wed,1,1,0,1
2012-03-28,1,Mar,5,0,Wed,1,2,38,40
2012-03-28,1,Mar,6,0,Wed,1,4,111,115
2012-03-28,1,Mar,7,0,Wed,1,10,348,358
2012-03-28,1,Mar,8,0,Wed,1,19,639,658
2012-03-28,1,Mar,9,0,Wed,1,16,298,314
2012-03-28,1,Mar,10,0,Wed,1,33,140,173
2012-03-28,1,Mar,11,0,Wed,1,54,168,222
2012-03-28,1,Mar,12,0,Wed,1,50,218,268
2012-03-28,1,Mar,13,0,Wed,1,60,213,273
2012-03-28,1,Mar,14,0,Wed,1,52,169,221
2012-03-28,1,Mar,15,0,Wed,1,47,152,199
2012-03-28,1,Mar,16,0,Wed,1,51,170,221
2012-03-28,1,Mar,17,0,Wed,1,72,532,604
2012-03-28,1,Mar,18,0,Wed,1,61,580,641
2012-03-28,1,Mar,19,0,Wed,1,41,415,456
2012-03-28,1,Mar,20,0,Wed,1,38,324,362
2012-03-28,1,Mar,21,0,Wed,1,28,233,261
2012-03-28,1,Mar,22,0,Wed,1,21,151,172
2012-03-28,1,Mar,23,0,Wed,1,12,81,93
2012-03-29,1,Mar,0,0,Thur,1,10,38,48
2012-03-29,1,Mar,1,0,Thur,1,15,18,33
2012-03-29,1,Mar,2,0,Thur,1,0,6,6
2012-03-29,1,Mar,3,0,Thur,1,1,4,5
2012-03-29,1,Mar,4,0,Thur,1,1,8,9
2012-03-29,1,Mar,5,0,Thur,1,2,30,32
2012-03-29,1,Mar,6,0,Thur,1,3,114,117
2012-03-29,1,Mar,7,0,Thur,1,14,353,367
2012-03-29,1,Mar,8,0,Thur,1,26,628,654
2012-03-29,1,Mar,9,0,Thur,1,22,299,321
2012-03-29,1,Mar,10,0,Thur,1,42,124,166
2012-03-29,1,Mar,11,0,Thur,1,54,166,220
2012-03-29,1,Mar,12,0,Thur,1,64,228,292
2012-03-29,1,Mar,13,0,Thur,1,50,223,273
2012-03-29,1,Mar,14,0,Thur,1,63,175,238
2012-03-29,1,Mar,15,0,Thur,1,109,198,307
2012-03-29,1,Mar,16,0,Thur,1,67,321,388
2012-03-29,1,Mar,17,0,Thur,1,83,620,703
2012-03-29,1,Mar,18,0,Thur,1,83,598,681
2012-03-29,1,Mar,19,0,Thur,1,47,421,468
2012-03-29,1,Mar,20,0,Thur,1,34,301,335
2012-03-29,1,Mar,21,0,Thur,1,10,214,224
2012-03-29,1,Mar,22,0,Thur,1,17,135,152
2012-03-29,1,Mar,23,0,Thur,1,17,77,94
2012-03-30,1,Mar,0,0,Fri,1,10,49,59
2012-03-30,1,Mar,1,0,Fri,1,6,21,27
2012-03-30,1,Mar,2,0,Fri,1,1,6,7
2012-03-30,1,Mar,3,0,Fri,1,0,7,7
2012-03-30,1,Mar,4,0,Fri,1,1,1,2
2012-03-30,1,Mar,5,0,Fri,1,0,26,26
2012-03-30,1,Mar,6,0,Fri,1,5,81,86
2012-03-30,1,Mar,7,0,Fri,1,9,280,289
2012-03-30,1,Mar,8,0,Fri,1,38,555,593
2012-03-30,1,Mar,9,0,Fri,1,29,292,321
2012-03-30,1,Mar,10,0,Fri,1,50,137,187
2012-03-30,1,Mar,11,0,Fri,1,48,153,201
2012-03-30,1,Mar,12,0,Fri,1,62,208,270
2012-03-30,1,Mar,13,0,Fri,1,44,198,242
2012-03-30,1,Mar,14,0,Fri,1,56,173,229
2012-03-30,1,Mar,15,0,Fri,1,73,207,280
2012-03-30,1,Mar,16,0,Fri,1,75,292,367
2012-03-30,1,Mar,17,0,Fri,1,93,513,606
2012-03-30,1,Mar,18,0,Fri,1,68,492,560
2012-03-30,1,Mar,19,0,Fri,1,42,353,395
2012-03-30,1,Mar,20,0,Fri,1,17,192,209
2012-03-30,1,Mar,21,0,Fri,1,30,190,220
2012-03-30,1,Mar,22,0,Fri,1,23,130,153
2012-03-30,1,Mar,23,0,Fri,1,16,107,123
2012-03-31,1,Mar,0,0,Sat,0,12,80,92
2012-03-31,1,Mar,1,0,Sat,0,17,65,82
2012-03-31,1,Mar,2,0,Sat,0,14,55,69
2012-03-31,1,Mar,3,0,Sat,0,10,21,31
2012-03-31,1,Mar,4,0,Sat,0,4,4,8
2012-03-31,1,Mar,5,0,Sat,0,0,5,5
2012-03-31,1,Mar,6,0,Sat,0,7,16,23
2012-03-31,1,Mar,7,0,Sat,0,5,39,44
2012-03-31,1,Mar,8,0,Sat,0,19,126,145
2012-03-31,1,Mar,9,0,Sat,0,62,161,223
2012-03-31,1,Mar,10,0,Sat,0,108,205,313
2012-03-31,1,Mar,11,0,Sat,0,184,279,463
2012-03-31,1,Mar,12,0,Sat,0,263,358,621
2012-03-31,1,Mar,13,0,Sat,0,265,373,638
2012-03-31,1,Mar,14,0,Sat,0,240,311,551
2012-03-31,1,Mar,15,0,Sat,0,275,330,605
2012-03-31,1,Mar,16,0,Sat,0,243,292,535
2012-03-31,1,Mar,17,0,Sat,0,238,305,543
2012-03-31,1,Mar,18,0,Sat,0,102,239,341
2012-03-31,1,Mar,19,0,Sat,0,93,191,284
2012-03-31,1,Mar,20,0,Sat,0,52,156,208
2012-03-31,1,Mar,21,0,Sat,0,36,107,143
2012-03-31,1,Mar,22,0,Sat,0,40,116,156
2012-03-31,1,Mar,23,0,Sat,0,12,100,112
2012-04-01,1,Apr,0,0,Sun,0,8,59,67
2012-04-01,1,Apr,1,0,Sun,0,13,49,62
2012-04-01,1,Apr,2,0,Sun,0,20,61,81
2012-04-01,1,Apr,3,0,Sun,0,4,21,25
2012-04-01,1,Apr,4,0,Sun,0,3,9,12
2012-04-01,1,Apr,5,0,Sun,0,8,10,18
2012-04-01,1,Apr,6,0,Sun,0,9,88,97
2012-04-01,1,Apr,7,0,Sun,0,29,55,84
2012-04-01,1,Apr,8,0,Sun,0,37,88,125
2012-04-01,1,Apr,9,0,Sun,0,102,173,275
2012-04-01,1,Apr,10,0,Sun,0,132,228,360
2012-04-01,1,Apr,11,0,Sun,0,180,271,451
2012-04-01,1,Apr,12,0,Sun,0,187,258,445
2012-04-01,1,Apr,13,0,Sun,0,190,274,464
2012-04-01,1,Apr,14,0,Sun,0,283,278,561
2012-04-01,1,Apr,15,0,Sun,0,295,278,573
2012-04-01,1,Apr,16,0,Sun,0,236,275,511
2012-04-01,1,Apr,17,0,Sun,0,232,323,555
2012-04-01,1,Apr,18,0,Sun,0,153,279,432
2012-04-01,1,Apr,19,0,Sun,0,110,236,346
2012-04-01,1,Apr,20,0,Sun,0,66,166,232
2012-04-01,1,Apr,21,0,Sun,0,33,101,134
2012-04-01,1,Apr,22,0,Sun,0,7,61,68
2012-04-01,1,Apr,23,0,Sun,0,10,53,63
2012-04-02,1,Apr,0,0,Mon,1,6,11,17
2012-04-02,1,Apr,1,0,Mon,1,0,5,5
2012-04-02,1,Apr,2,0,Mon,1,2,3,5
2012-04-02,1,Apr,4,0,Mon,1,2,2,4
2012-04-02,1,Apr,5,0,Mon,1,2,22,24
2012-04-02,1,Apr,6,0,Mon,1,6,104,110
2012-04-02,1,Apr,7,0,Mon,1,12,294,306
2012-04-02,1,Apr,8,0,Mon,1,36,553,589
2012-04-02,1,Apr,9,0,Mon,1,52,265,317
2012-04-02,1,Apr,10,0,Mon,1,85,119,204
2012-04-02,1,Apr,11,0,Mon,1,81,128,209
2012-04-02,1,Apr,12,0,Mon,1,100,181,281
2012-04-02,1,Apr,13,0,Mon,1,97,184,281
2012-04-02,1,Apr,14,0,Mon,1,127,141,268
2012-04-02,1,Apr,15,0,Mon,1,132,192,324
2012-04-02,1,Apr,16,0,Mon,1,104,291,395
2012-04-02,1,Apr,17,0,Mon,1,128,601,729
2012-04-02,1,Apr,18,0,Mon,1,75,543,618
2012-04-02,1,Apr,19,0,Mon,1,66,428,494
2012-04-02,1,Apr,20,0,Mon,1,48,281,329
2012-04-02,1,Apr,21,0,Mon,1,24,214,238
2012-04-02,1,Apr,22,0,Mon,1,17,106,123
2012-04-02,1,Apr,23,0,Mon,1,6,60,66
2012-04-03,1,Apr,0,0,Tue,1,1,32,33
2012-04-03,1,Apr,1,0,Tue,1,0,11,11
2012-04-03,1,Apr,2,0,Tue,1,0,5,5
2012-04-03,1,Apr,3,0,Tue,1,0,3,3
2012-04-03,1,Apr,4,0,Tue,1,0,1,1
2012-04-03,1,Apr,5,0,Tue,1,2,25,27
2012-04-03,1,Apr,6,0,Tue,1,2,98,100
2012-04-03,1,Apr,7,0,Tue,1,14,327,341
2012-04-03,1,Apr,8,0,Tue,1,27,577,604
2012-04-03,1,Apr,9,0,Tue,1,54,354,408
2012-04-03,1,Apr,10,0,Tue,1,77,142,219
2012-04-03,1,Apr,11,0,Tue,1,91,167,258
2012-04-03,1,Apr,12,0,Tue,1,101,230,331
2012-04-03,1,Apr,13,0,Tue,1,120,225,345
2012-04-03,1,Apr,14,0,Tue,1,120,191,311
2012-04-03,1,Apr,15,0,Tue,1,109,207,316
2012-04-03,1,Apr,16,0,Tue,1,145,340,485
2012-04-03,1,Apr,17,0,Tue,1,123,634,757
2012-04-03,1,Apr,18,0,Tue,1,139,661,800
2012-04-03,1,Apr,19,0,Tue,1,98,460,558
2012-04-03,1,Apr,20,0,Tue,1,54,325,379
2012-04-03,1,Apr,21,0,Tue,1,33,210,243
2012-04-03,1,Apr,22,0,Tue,1,25,133,158
2012-04-03,1,Apr,23,0,Tue,1,13,66,79
2012-04-04,1,Apr,0,0,Wed,1,18,23,41
2012-04-04,1,Apr,1,0,Wed,1,0,11,11
2012-04-04,1,Apr,2,0,Wed,1,0,5,5
2012-04-04,1,Apr,3,0,Wed,1,0,3,3
2012-04-04,1,Apr,4,0,Wed,1,0,1,1
2012-04-04,1,Apr,5,0,Wed,1,0,27,27
2012-04-04,1,Apr,6,0,Wed,1,6,120,126
2012-04-04,1,Apr,7,0,Wed,1,12,354,366
2012-04-04,1,Apr,8,0,Wed,1,31,653,684
2012-04-04,1,Apr,9,0,Wed,1,47,316,363
2012-04-04,1,Apr,10,0,Wed,1,68,99,167
2012-04-04,1,Apr,11,0,Wed,1,61,152,213
2012-04-04,1,Apr,12,0,Wed,1,73,210,283
2012-04-04,1,Apr,13,0,Wed,1,70,181,251
2012-04-04,1,Apr,14,0,Wed,1,82,176,258
2012-04-04,1,Apr,15,0,Wed,1,86,182,268
2012-04-04,1,Apr,16,0,Wed,1,86,304,390
2012-04-04,1,Apr,17,0,Wed,1,99,645,744
2012-04-04,1,Apr,18,0,Wed,1,113,646,759
2012-04-04,1,Apr,19,0,Wed,1,75,419,494
2012-04-04,1,Apr,20,0,Wed,1,39,333,372
2012-04-04,1,Apr,21,0,Wed,1,43,255,298
2012-04-04,1,Apr,22,0,Wed,1,30,151,181
2012-04-04,1,Apr,23,0,Wed,1,19,112,131
2012-04-05,1,Apr,0,0,Thur,1,12,33,45
2012-04-05,1,Apr,1,0,Thur,1,4,9,13
2012-04-05,1,Apr,2,0,Thur,1,7,11,18
2012-04-05,1,Apr,3,0,Thur,1,0,5,5
2012-04-05,1,Apr,4,0,Thur,1,0,1,1
2012-04-05,1,Apr,5,0,Thur,1,1,28,29
2012-04-05,1,Apr,6,0,Thur,1,8,118,126
2012-04-05,1,Apr,7,0,Thur,1,15,339,354
2012-04-05,1,Apr,8,0,Thur,1,28,610,638
2012-04-05,1,Apr,9,0,Thur,1,61,290,351
2012-04-05,1,Apr,10,0,Thur,1,88,158,246
2012-04-05,1,Apr,11,0,Thur,1,109,159,268
2012-04-05,1,Apr,12,0,Thur,1,66,210,276
2012-04-05,1,Apr,13,0,Thur,1,89,202,291
2012-04-05,1,Apr,14,0,Thur,1,143,144,287
2012-04-05,1,Apr,15,0,Thur,1,98,171,269
2012-04-05,1,Apr,16,0,Thur,1,84,318,402
2012-04-05,1,Apr,17,0,Thur,1,145,677,822
2012-04-05,1,Apr,18,0,Thur,1,80,618,698
2012-04-05,1,Apr,19,0,Thur,1,64,423,487
2012-04-05,1,Apr,20,0,Thur,1,33,279,312
2012-04-05,1,Apr,21,0,Thur,1,25,209,234
2012-04-05,1,Apr,22,0,Thur,1,20,129,149
2012-04-05,1,Apr,23,0,Thur,1,12,124,136
2012-04-06,1,Apr,0,0,Fri,1,12,49,61
2012-04-06,1,Apr,1,0,Fri,1,10,28,38
2012-04-06,1,Apr,2,0,Fri,1,6,5,11
2012-04-06,1,Apr,3,0,Fri,1,3,5,8
2012-04-06,1,Apr,4,0,Fri,1,2,3,5
2012-04-06,1,Apr,5,0,Fri,1,0,23,23
2012-04-06,1,Apr,6,0,Fri,1,0,80,80
2012-04-06,1,Apr,7,0,Fri,1,15,231,246
2012-04-06,1,Apr,8,0,Fri,1,19,489,508
2012-04-06,1,Apr,9,0,Fri,1,58,318,376
2012-04-06,1,Apr,10,0,Fri,1,81,157,238
2012-04-06,1,Apr,11,0,Fri,1,112,179,291
2012-04-06,1,Apr,12,0,Fri,1,113,224,337
2012-04-06,1,Apr,13,0,Fri,1,173,238,411
2012-04-06,1,Apr,14,0,Fri,1,240,250,490
2012-04-06,1,Apr,15,0,Fri,1,218,319,537
2012-04-06,1,Apr,16,0,Fri,1,184,352,536
2012-04-06,1,Apr,17,0,Fri,1,172,483,655
2012-04-06,1,Apr,18,0,Fri,1,104,380,484
2012-04-06,1,Apr,19,0,Fri,1,115,297,412
2012-04-06,1,Apr,20,0,Fri,1,61,191,252
2012-04-06,1,Apr,21,0,Fri,1,54,136,190
2012-04-06,1,Apr,22,0,Fri,1,34,124,158
2012-04-06,1,Apr,23,0,Fri,1,21,92,113
2012-04-07,1,Apr,0,0,Sat,0,9,85,94
2012-04-07,1,Apr,1,0,Sat,0,9,60,69
2012-04-07,1,Apr,2,0,Sat,0,11,25,36
2012-04-07,1,Apr,3,0,Sat,0,7,21,28
2012-04-07,1,Apr,4,0,Sat,0,3,4,7
2012-04-07,1,Apr,5,0,Sat,0,0,2,2
2012-04-07,1,Apr,6,0,Sat,0,1,18,19
2012-04-07,1,Apr,7,0,Sat,0,14,40,54
2012-04-07,1,Apr,8,0,Sat,0,29,94,123
2012-04-07,1,Apr,9,0,Sat,0,103,173,276
2012-04-07,1,Apr,10,0,Sat,0,187,176,363
2012-04-07,1,Apr,11,0,Sat,0,251,244,495
2012-04-07,1,Apr,12,0,Sat,0,320,270,590
2012-04-07,1,Apr,13,0,Sat,0,355,288,643
2012-04-07,1,Apr,14,0,Sat,0,326,252,578
2012-04-07,1,Apr,15,0,Sat,0,321,305,626
2012-04-07,1,Apr,16,0,Sat,0,354,261,615
2012-04-07,1,Apr,17,0,Sat,0,299,268,567
2012-04-07,1,Apr,18,0,Sat,0,227,290,517
2012-04-07,1,Apr,19,0,Sat,0,170,243,413
2012-04-07,1,Apr,20,0,Sat,0,73,135,208
2012-04-07,1,Apr,21,0,Sat,0,75,159,234
2012-04-07,1,Apr,22,0,Sat,0,76,106,182
2012-04-07,1,Apr,23,0,Sat,0,32,86,118
2012-04-08,1,Apr,0,0,Sun,0,21,64,85
2012-04-08,1,Apr,1,0,Sun,0,14,50,64
2012-04-08,1,Apr,2,0,Sun,0,7,25,32
2012-04-08,1,Apr,3,0,Sun,0,8,18,26
2012-04-08,1,Apr,4,0,Sun,0,0,7,7
2012-04-08,1,Apr,5,0,Sun,0,4,8,12
2012-04-08,1,Apr,6,0,Sun,0,7,21,28
2012-04-08,1,Apr,7,0,Sun,0,12,25,37
2012-04-08,1,Apr,8,0,Sun,0,19,65,84
2012-04-08,1,Apr,9,0,Sun,0,71,108,179
2012-04-08,1,Apr,10,0,Sun,0,113,186,299
2012-04-08,1,Apr,11,0,Sun,0,195,209,404
2012-04-08,1,Apr,12,0,Sun,0,198,259,457
2012-04-08,1,Apr,13,0,Sun,0,229,254,483
2012-04-08,1,Apr,14,0,Sun,0,254,249,503
2012-04-08,1,Apr,15,0,Sun,0,260,226,486
2012-04-08,1,Apr,16,0,Sun,0,232,244,476
2012-04-08,1,Apr,17,0,Sun,0,185,226,411
2012-04-08,1,Apr,18,0,Sun,0,151,159,310
2012-04-08,1,Apr,19,0,Sun,0,89,187,276
2012-04-08,1,Apr,20,0,Sun,0,65,146,211
2012-04-08,1,Apr,21,0,Sun,0,53,77,130
2012-04-08,1,Apr,22,0,Sun,0,33,85,118
2012-04-08,1,Apr,23,0,Sun,0,10,41,51
2012-04-09,1,Apr,0,0,Mon,1,8,29,37
2012-04-09,1,Apr,1,0,Mon,1,4,12,16
2012-04-09,1,Apr,2,0,Mon,1,2,4,6
2012-04-09,1,Apr,3,0,Mon,1,0,3,3
2012-04-09,1,Apr,4,0,Mon,1,2,3,5
2012-04-09,1,Apr,5,0,Mon,1,2,30,32
2012-04-09,1,Apr,6,0,Mon,1,3,108,111
2012-04-09,1,Apr,7,0,Mon,1,11,320,331
2012-04-09,1,Apr,8,0,Mon,1,22,595,617
2012-04-09,1,Apr,9,0,Mon,1,50,236,286
2012-04-09,1,Apr,10,0,Mon,1,65,113,178
2012-04-09,1,Apr,11,0,Mon,1,96,127,223
2012-04-09,1,Apr,12,0,Mon,1,94,186,280
2012-04-09,1,Apr,13,0,Mon,1,108,173,281
2012-04-09,1,Apr,14,0,Mon,1,66,152,218
2012-04-09,1,Apr,15,0,Mon,1,82,173,255
2012-04-09,1,Apr,16,0,Mon,1,81,310,391
2012-04-09,1,Apr,17,0,Mon,1,67,565,632
2012-04-09,1,Apr,18,0,Mon,1,60,586,646
2012-04-09,1,Apr,19,0,Mon,1,35,386,421
2012-04-09,1,Apr,20,0,Mon,1,21,255,276
2012-04-09,1,Apr,21,0,Mon,1,14,151,165
2012-04-09,1,Apr,22,0,Mon,1,6,102,108
2012-04-09,1,Apr,23,0,Mon,1,6,61,67
2012-04-10,1,Apr,0,0,Tue,1,3,23,26
2012-04-10,1,Apr,1,0,Tue,1,0,9,9
2012-04-10,1,Apr,2,0,Tue,1,0,2,2
2012-04-10,1,Apr,3,0,Tue,1,0,2,2
2012-04-10,1,Apr,4,0,Tue,1,0,2,2
2012-04-10,1,Apr,5,0,Tue,1,0,24,24
2012-04-10,1,Apr,6,0,Tue,1,3,100,103
2012-04-10,1,Apr,7,0,Tue,1,16,368,384
2012-04-10,1,Apr,8,0,Tue,1,22,670,692
2012-04-10,1,Apr,9,0,Tue,1,16,303,319
2012-04-10,1,Apr,10,0,Tue,1,49,132,181
2012-04-10,1,Apr,11,0,Tue,1,78,161,239
2012-04-10,1,Apr,12,0,Tue,1,75,184,259
2012-04-10,1,Apr,13,0,Tue,1,81,202,283
2012-04-10,1,Apr,14,0,Tue,1,75,149,224
2012-04-10,1,Apr,15,0,Tue,1,46,157,203
2012-04-10,1,Apr,16,0,Tue,1,66,296,362
2012-04-10,1,Apr,17,0,Tue,1,88,656,744
2012-04-10,1,Apr,18,0,Tue,1,78,626,704
2012-04-10,1,Apr,19,0,Tue,1,51,428,479
2012-04-10,1,Apr,20,0,Tue,1,34,248,282
2012-04-10,1,Apr,21,0,Tue,1,15,191,206
2012-04-10,1,Apr,22,0,Tue,1,9,118,127
2012-04-10,1,Apr,23,0,Tue,1,14,48,62
2012-04-11,1,Apr,0,0,Wed,1,8,22,30
2012-04-11,1,Apr,1,0,Wed,1,3,9,12
2012-04-11,1,Apr,2,0,Wed,1,0,2,2
2012-04-11,1,Apr,3,0,Wed,1,0,2,2
2012-04-11,1,Apr,5,0,Wed,1,1,26,27
2012-04-11,1,Apr,6,0,Wed,1,3,103,106
2012-04-11,1,Apr,7,0,Wed,1,18,303,321
2012-04-11,1,Apr,8,0,Wed,1,14,581,595
2012-04-11,1,Apr,9,0,Wed,1,20,282,302
2012-04-11,1,Apr,10,0,Wed,1,26,127,153
2012-04-11,1,Apr,11,0,Wed,1,38,142,180
2012-04-11,1,Apr,12,0,Wed,1,35,147,182
2012-04-11,1,Apr,13,0,Wed,1,16,147,163
2012-04-11,1,Apr,14,0,Wed,1,34,101,135
2012-04-11,1,Apr,15,0,Wed,1,50,152,202
2012-04-11,1,Apr,16,0,Wed,1,51,256,307
2012-04-11,1,Apr,17,0,Wed,1,52,527,579
2012-04-11,1,Apr,18,0,Wed,1,39,546,585
2012-04-11,1,Apr,19,0,Wed,1,28,356,384
2012-04-11,1,Apr,20,0,Wed,1,22,213,235
2012-04-11,1,Apr,21,0,Wed,1,11,154,165
2012-04-11,1,Apr,22,0,Wed,1,4,130,134
2012-04-11,1,Apr,23,0,Wed,1,9,52,61
2012-04-12,1,Apr,0,0,Thur,1,1,22,23
2012-04-12,1,Apr,1,0,Thur,1,2,7,9
2012-04-12,1,Apr,2,0,Thur,1,0,4,4
2012-04-12,1,Apr,3,0,Thur,1,2,3,5
2012-04-12,1,Apr,4,0,Thur,1,0,1,1
2012-04-12,1,Apr,5,0,Thur,1,0,21,21
2012-04-12,1,Apr,6,0,Thur,1,2,94,96
2012-04-12,1,Apr,7,0,Thur,1,12,294,306
2012-04-12,1,Apr,8,0,Thur,1,20,604,624
2012-04-12,1,Apr,9,0,Thur,1,16,271,287
2012-04-12,1,Apr,10,0,Thur,1,38,103,141
2012-04-12,1,Apr,11,0,Thur,1,50,174,224
2012-04-12,1,Apr,12,0,Thur,1,60,199,259
2012-04-12,1,Apr,13,0,Thur,1,55,148,203
2012-04-12,1,Apr,14,0,Thur,1,74,150,224
2012-04-12,1,Apr,15,0,Thur,1,42,169,211
2012-04-12,1,Apr,16,0,Thur,1,54,299,353
2012-04-12,1,Apr,17,0,Thur,1,60,596,656
2012-04-12,1,Apr,18,0,Thur,1,63,547,610
2012-04-12,1,Apr,19,0,Thur,1,50,383,433
2012-04-12,1,Apr,20,0,Thur,1,26,254,280
2012-04-12,1,Apr,21,0,Thur,1,13,174,187
2012-04-12,1,Apr,22,0,Thur,1,15,143,158
2012-04-12,1,Apr,23,0,Thur,1,8,86,94
2012-04-13,1,Apr,0,0,Fri,1,14,41,55
2012-04-13,1,Apr,1,0,Fri,1,2,28,30
2012-04-13,1,Apr,2,0,Fri,1,6,5,11
2012-04-13,1,Apr,3,0,Fri,1,3,8,11
2012-04-13,1,Apr,4,0,Fri,1,1,4,5
2012-04-13,1,Apr,5,0,Fri,1,2,19,21
2012-04-13,1,Apr,6,0,Fri,1,0,84,84
2012-04-13,1,Apr,7,0,Fri,1,13,283,296
2012-04-13,1,Apr,8,0,Fri,1,24,539,563
2012-04-13,1,Apr,9,0,Fri,1,36,294,330
2012-04-13,1,Apr,10,0,Fri,1,59,133,192
2012-04-13,1,Apr,11,0,Fri,1,75,158,233
2012-04-13,1,Apr,12,0,Fri,1,104,218,322
2012-04-13,1,Apr,13,0,Fri,1,112,246,358
2012-04-13,1,Apr,14,0,Fri,1,125,223,348
2012-04-13,1,Apr,15,0,Fri,1,115,237,352
2012-04-13,1,Apr,16,0,Fri,1,113,350,463
2012-04-13,1,Apr,17,0,Fri,1,117,621,738
2012-04-13,1,Apr,18,0,Fri,1,107,564,671
2012-04-13,1,Apr,19,0,Fri,1,75,352,427
2012-04-13,1,Apr,20,0,Fri,1,44,242,286
2012-04-13,1,Apr,21,0,Fri,1,36,153,189
2012-04-13,1,Apr,22,0,Fri,1,34,181,215
2012-04-13,1,Apr,23,0,Fri,1,35,163,198
2012-04-14,1,Apr,0,0,Sat,0,11,85,96
2012-04-14,1,Apr,1,0,Sat,0,10,60,70
2012-04-14,1,Apr,2,0,Sat,0,3,53,56
2012-04-14,1,Apr,3,0,Sat,0,6,26,32
2012-04-14,1,Apr,4,0,Sat,0,5,9,14
2012-04-14,1,Apr,5,0,Sat,0,2,5,7
2012-04-14,1,Apr,6,0,Sat,0,2,19,21
2012-04-14,1,Apr,7,0,Sat,0,8,56,64
2012-04-14,1,Apr,8,0,Sat,0,24,136,160
2012-04-14,1,Apr,9,0,Sat,0,59,206,265
2012-04-14,1,Apr,10,0,Sat,0,139,267,406
2012-04-14,1,Apr,11,0,Sat,0,207,357,564
2012-04-14,1,Apr,12,0,Sat,0,274,404,678
2012-04-14,1,Apr,13,0,Sat,0,308,370,678
2012-04-14,1,Apr,14,0,Sat,0,288,372,660
2012-04-14,1,Apr,15,0,Sat,0,311,347,658
2012-04-14,1,Apr,16,0,Sat,0,253,329,582
2012-04-14,1,Apr,17,0,Sat,0,251,309,560
2012-04-14,1,Apr,18,0,Sat,0,197,284,481
2012-04-14,1,Apr,19,0,Sat,0,163,296,459
2012-04-14,1,Apr,20,0,Sat,0,112,209,321
2012-04-14,1,Apr,21,0,Sat,0,53,167,220
2012-04-14,1,Apr,22,0,Sat,0,64,148,212
2012-04-14,1,Apr,23,0,Sat,0,45,151,196
2012-04-15,1,Apr,0,0,Sun,0,30,94,124
2012-04-15,1,Apr,1,0,Sun,0,17,89,106
2012-04-15,1,Apr,2,0,Sun,0,20,54,74
2012-04-15,1,Apr,3,0,Sun,0,18,27,45
2012-04-15,1,Apr,4,0,Sun,0,2,10,12
2012-04-15,1,Apr,5,0,Sun,0,4,6,10
2012-04-15,1,Apr,6,0,Sun,0,5,11,16
2012-04-15,1,Apr,7,0,Sun,0,16,30,46
2012-04-15,1,Apr,8,0,Sun,0,33,64,97
2012-04-15,1,Apr,9,0,Sun,0,97,154,251
2012-04-15,1,Apr,10,0,Sun,0,186,235,421
2012-04-15,1,Apr,11,0,Sun,0,227,301,528
2012-04-15,1,Apr,12,0,Sun,0,275,360,635
2012-04-15,1,Apr,13,0,Sun,0,298,383,681
2012-04-15,1,Apr,14,0,Sun,0,282,346,628
2012-04-15,1,Apr,15,0,Sun,0,266,351,617
2012-04-15,1,Apr,16,0,Sun,0,286,330,616
2012-04-15,1,Apr,17,0,Sun,0,262,361,623
2012-04-15,1,Apr,18,0,Sun,0,184,295,479
2012-04-15,1,Apr,19,0,Sun,0,114,265,379
2012-04-15,1,Apr,20,0,Sun,0,86,205,291
2012-04-15,1,Apr,21,0,Sun,0,76,153,229
2012-04-15,1,Apr,22,0,Sun,0,37,97,134
2012-04-15,1,Apr,23,0,Sun,0,25,65,90
2012-04-16,1,Apr,0,1,Mon,0,15,26,41
2012-04-16,1,Apr,1,1,Mon,0,7,21,28
2012-04-16,1,Apr,2,1,Mon,0,5,9,14
2012-04-16,1,Apr,3,1,Mon,0,3,5,8
2012-04-16,1,Apr,4,1,Mon,0,0,6,6
2012-04-16,1,Apr,5,1,Mon,0,4,34,38
2012-04-16,1,Apr,6,1,Mon,0,10,123,133
2012-04-16,1,Apr,7,1,Mon,0,20,367,387
2012-04-16,1,Apr,8,1,Mon,0,48,549,597
2012-04-16,1,Apr,9,1,Mon,0,59,238,297
2012-04-16,1,Apr,10,1,Mon,0,75,149,224
2012-04-16,1,Apr,11,1,Mon,0,115,136,251
2012-04-16,1,Apr,12,1,Mon,0,75,196,271
2012-04-16,1,Apr,13,1,Mon,0,79,184,263
2012-04-16,1,Apr,14,1,Mon,0,105,183,288
2012-04-16,1,Apr,15,1,Mon,0,81,194,275
2012-04-16,1,Apr,16,1,Mon,0,92,266,358
2012-04-16,1,Apr,17,1,Mon,0,111,601,712
2012-04-16,1,Apr,18,1,Mon,0,87,589,676
2012-04-16,1,Apr,19,1,Mon,0,61,461,522
2012-04-16,1,Apr,20,1,Mon,0,48,327,375
2012-04-16,1,Apr,21,1,Mon,0,39,232,271
2012-04-16,1,Apr,22,1,Mon,0,35,179,214
2012-04-16,1,Apr,23,1,Mon,0,24,97,121
2012-04-17,1,Apr,0,0,Tue,1,10,33,43
2012-04-17,1,Apr,1,0,Tue,1,6,5,11
2012-04-17,1,Apr,2,0,Tue,1,1,3,4
2012-04-17,1,Apr,3,0,Tue,1,0,6,6
2012-04-17,1,Apr,4,0,Tue,1,3,6,9
2012-04-17,1,Apr,5,0,Tue,1,1,29,30
2012-04-17,1,Apr,6,0,Tue,1,8,136,144
2012-04-17,1,Apr,7,0,Tue,1,18,443,461
2012-04-17,1,Apr,8,0,Tue,1,42,631,673
2012-04-17,1,Apr,9,0,Tue,1,71,329,400
2012-04-17,1,Apr,10,0,Tue,1,52,165,217
2012-04-17,1,Apr,11,0,Tue,1,65,174,239
2012-04-17,1,Apr,12,0,Tue,1,65,179,244
2012-04-17,1,Apr,13,0,Tue,1,52,187,239
2012-04-17,1,Apr,14,0,Tue,1,59,198,257
2012-04-17,1,Apr,15,0,Tue,1,91,217,308
2012-04-17,1,Apr,16,0,Tue,1,50,320,370
2012-04-17,1,Apr,17,0,Tue,1,108,673,781
2012-04-17,1,Apr,18,0,Tue,1,105,670,775
2012-04-17,1,Apr,19,0,Tue,1,73,464,537
2012-04-17,1,Apr,20,0,Tue,1,44,358,402
2012-04-17,1,Apr,21,0,Tue,1,37,260,297
2012-04-17,1,Apr,22,0,Tue,1,18,144,162
2012-04-17,1,Apr,23,0,Tue,1,10,72,82
2012-04-18,1,Apr,0,0,Wed,1,3,35,38
2012-04-18,1,Apr,1,0,Wed,1,1,13,14
2012-04-18,1,Apr,2,0,Wed,1,1,8,9
2012-04-18,1,Apr,3,0,Wed,1,0,6,6
2012-04-18,1,Apr,4,0,Wed,1,0,7,7
2012-04-18,1,Apr,5,0,Wed,1,0,34,34
2012-04-18,1,Apr,6,0,Wed,1,6,128,134
2012-04-18,1,Apr,7,0,Wed,1,10,408,418
2012-04-18,1,Apr,8,0,Wed,1,25,551,576
2012-04-18,1,Apr,9,0,Wed,1,20,245,265
2012-04-18,1,Apr,10,0,Wed,1,31,116,147
2012-04-18,1,Apr,11,0,Wed,1,14,105,119
2012-04-18,1,Apr,12,0,Wed,1,15,95,110
2012-04-18,1,Apr,13,0,Wed,1,13,51,64
2012-04-18,1,Apr,14,0,Wed,1,8,43,51
2012-04-18,1,Apr,15,0,Wed,1,10,88,98
2012-04-18,1,Apr,16,0,Wed,1,36,199,235
2012-04-18,1,Apr,17,0,Wed,1,46,442,488
2012-04-18,1,Apr,18,0,Wed,1,27,478,505
2012-04-18,1,Apr,19,0,Wed,1,26,342,368
2012-04-18,1,Apr,20,0,Wed,1,8,252,260
2012-04-18,1,Apr,21,0,Wed,1,24,165,189
2012-04-18,1,Apr,22,0,Wed,1,9,153,162
2012-04-18,1,Apr,23,0,Wed,1,14,56,70
2012-04-19,1,Apr,0,0,Thur,1,5,20,25
2012-04-19,1,Apr,1,0,Thur,1,2,11,13
2012-04-19,1,Apr,2,0,Thur,1,2,4,6
2012-04-19,1,Apr,3,0,Thur,1,1,3,4
2012-04-19,1,Apr,4,0,Thur,1,0,4,4
2012-04-19,1,Apr,5,0,Thur,1,0,30,30
2012-04-19,1,Apr,6,0,Thur,1,4,116,120
2012-04-19,1,Apr,7,0,Thur,1,15,391,406
2012-04-19,1,Apr,8,0,Thur,1,26,651,677
2012-04-19,1,Apr,9,0,Thur,1,31,270,301
2012-04-19,1,Apr,10,0,Thur,1,46,143,189
2012-04-19,1,Apr,11,0,Thur,1,46,183,229
2012-04-19,1,Apr,12,0,Thur,1,51,213,264
2012-04-19,1,Apr,13,0,Thur,1,52,186,238
2012-04-19,1,Apr,14,0,Thur,1,54,183,237
2012-04-19,1,Apr,15,0,Thur,1,66,196,262
2012-04-19,1,Apr,16,0,Thur,1,63,324,387
2012-04-19,1,Apr,17,0,Thur,1,85,663,748
2012-04-19,1,Apr,18,0,Thur,1,99,677,776
2012-04-19,1,Apr,19,0,Thur,1,70,516,586
2012-04-19,1,Apr,20,0,Thur,1,52,352,404
2012-04-19,1,Apr,21,0,Thur,1,27,240,267
2012-04-19,1,Apr,22,0,Thur,1,29,219,248
2012-04-19,1,Apr,23,0,Thur,1,20,124,144
2012-04-20,1,Apr,0,0,Fri,1,5,59,64
2012-04-20,1,Apr,1,0,Fri,1,3,22,25
2012-04-20,1,Apr,2,0,Fri,1,3,18,21
2012-04-20,1,Apr,3,0,Fri,1,1,9,10
2012-04-20,1,Apr,4,0,Fri,1,0,3,3
2012-04-20,1,Apr,5,0,Fri,1,1,24,25
2012-04-20,1,Apr,6,0,Fri,1,8,105,113
2012-04-20,1,Apr,7,0,Fri,1,9,350,359
2012-04-20,1,Apr,8,0,Fri,1,32,668,700
2012-04-20,1,Apr,9,0,Fri,1,30,329,359
2012-04-20,1,Apr,10,0,Fri,1,67,170,237
2012-04-20,1,Apr,11,0,Fri,1,64,190,254
2012-04-20,1,Apr,12,0,Fri,1,102,260,362
2012-04-20,1,Apr,13,0,Fri,1,105,276,381
2012-04-20,1,Apr,14,0,Fri,1,156,238,394
2012-04-20,1,Apr,15,0,Fri,1,145,262,407
2012-04-20,1,Apr,16,0,Fri,1,151,429,580
2012-04-20,1,Apr,17,0,Fri,1,122,697,819
2012-04-20,1,Apr,18,0,Fri,1,110,558,668
2012-04-20,1,Apr,19,0,Fri,1,82,410,492
2012-04-20,1,Apr,20,0,Fri,1,52,289,341
2012-04-20,1,Apr,21,0,Fri,1,35,252,287
2012-04-20,1,Apr,22,0,Fri,1,26,176,202
2012-04-20,1,Apr,23,0,Fri,1,31,156,187
2012-04-21,1,Apr,0,0,Sat,0,31,111,142
2012-04-21,1,Apr,1,0,Sat,0,24,64,88
2012-04-21,1,Apr,2,0,Sat,0,12,69,81
2012-04-21,1,Apr,3,0,Sat,0,4,25,29
2012-04-21,1,Apr,4,0,Sat,0,0,9,9
2012-04-21,1,Apr,5,0,Sat,0,0,1,1
2012-04-21,1,Apr,6,0,Sat,0,10,21,31
2012-04-21,1,Apr,7,0,Sat,0,21,55,76
2012-04-21,1,Apr,8,0,Sat,0,52,149,201
2012-04-21,1,Apr,9,0,Sat,0,115,216,331
2012-04-21,1,Apr,10,0,Sat,0,183,299,482
2012-04-21,1,Apr,11,0,Sat,0,260,348,608
2012-04-21,1,Apr,12,0,Sat,0,262,378,640
2012-04-21,1,Apr,13,0,Sat,0,291,358,649
2012-04-21,1,Apr,14,0,Sat,0,278,331,609
2012-04-21,1,Apr,15,0,Sat,0,267,361,628
2012-04-21,1,Apr,16,0,Sat,0,267,372,639
2012-04-21,1,Apr,17,0,Sat,0,259,309,568
2012-04-21,1,Apr,18,0,Sat,0,133,283,416
2012-04-21,1,Apr,19,0,Sat,0,9,45,54
2012-04-21,1,Apr,20,0,Sat,0,5,34,39
2012-04-21,1,Apr,21,0,Sat,0,20,82,102
2012-04-21,1,Apr,22,0,Sat,0,20,90,110
2012-04-21,1,Apr,23,0,Sat,0,18,73,91
2012-04-22,1,Apr,0,0,Sun,0,32,85,117
2012-04-22,1,Apr,1,0,Sun,0,10,63,73
2012-04-22,1,Apr,2,0,Sun,0,7,49,56
2012-04-22,1,Apr,3,0,Sun,0,7,33,40
2012-04-22,1,Apr,4,0,Sun,0,0,7,7
2012-04-22,1,Apr,5,0,Sun,0,0,6,6
2012-04-22,1,Apr,6,0,Sun,0,6,6,12
2012-04-22,1,Apr,7,0,Sun,0,2,22,24
2012-04-22,1,Apr,8,0,Sun,0,8,43,51
2012-04-22,1,Apr,9,0,Sun,0,8,71,79
2012-04-22,1,Apr,10,0,Sun,0,11,57,68
2012-04-22,1,Apr,11,0,Sun,0,7,70,77
2012-04-22,1,Apr,12,0,Sun,0,5,56,61
2012-04-22,1,Apr,13,0,Sun,0,5,47,52
2012-04-22,1,Apr,14,0,Sun,0,3,50,53
2012-04-22,1,Apr,15,0,Sun,0,0,38,38
2012-04-22,1,Apr,16,0,Sun,0,4,32,36
2012-04-22,1,Apr,17,0,Sun,0,2,25,27
2012-04-22,1,Apr,18,0,Sun,0,1,38,39
2012-04-22,1,Apr,19,0,Sun,0,1,34,35
2012-04-22,1,Apr,20,0,Sun,0,1,34,35
2012-04-22,1,Apr,21,0,Sun,0,0,11,11
2012-04-22,1,Apr,22,0,Sun,0,0,13,13
2012-04-22,1,Apr,23,0,Sun,0,0,17,17
2012-04-23,1,Apr,0,0,Mon,1,0,6,6
2012-04-23,1,Apr,1,0,Mon,1,1,1,2
2012-04-23,1,Apr,2,0,Mon,1,1,3,4
2012-04-23,1,Apr,3,0,Mon,1,0,1,1
2012-04-23,1,Apr,4,0,Mon,1,0,3,3
2012-04-23,1,Apr,5,0,Mon,1,0,14,14
2012-04-23,1,Apr,6,0,Mon,1,2,43,45
2012-04-23,1,Apr,7,0,Mon,1,1,206,207
2012-04-23,1,Apr,8,0,Mon,1,11,471,482
2012-04-23,1,Apr,9,0,Mon,1,17,255,272
2012-04-23,1,Apr,10,0,Mon,1,12,88,100
2012-04-23,1,Apr,11,0,Mon,1,10,91,101
2012-04-23,1,Apr,12,0,Mon,1,12,117,129
2012-04-23,1,Apr,13,0,Mon,1,9,98,107
2012-04-23,1,Apr,14,0,Mon,1,12,102,114
2012-04-23,1,Apr,15,0,Mon,1,11,101,112
2012-04-23,1,Apr,16,0,Mon,1,10,93,103
2012-04-23,1,Apr,17,0,Mon,1,13,219,232
2012-04-23,1,Apr,18,0,Mon,1,10,369,379
2012-04-23,1,Apr,19,0,Mon,1,11,287,298
2012-04-23,1,Apr,20,0,Mon,1,17,186,203
2012-04-23,1,Apr,21,0,Mon,1,7,145,152
2012-04-23,1,Apr,22,0,Mon,1,18,71,89
2012-04-23,1,Apr,23,0,Mon,1,10,49,59
2012-04-24,1,Apr,0,0,Tue,1,0,13,13
2012-04-24,1,Apr,1,0,Tue,1,1,6,7
2012-04-24,1,Apr,2,0,Tue,1,0,3,3
2012-04-24,1,Apr,3,0,Tue,1,0,2,2
2012-04-24,1,Apr,4,0,Tue,1,0,3,3
2012-04-24,1,Apr,5,0,Tue,1,0,22,22
2012-04-24,1,Apr,6,0,Tue,1,3,117,120
2012-04-24,1,Apr,7,0,Tue,1,3,387,390
2012-04-24,1,Apr,8,0,Tue,1,12,599,611
2012-04-24,1,Apr,9,0,Tue,1,6,302,308
2012-04-24,1,Apr,10,0,Tue,1,33,129,162
2012-04-24,1,Apr,11,0,Tue,1,27,157,184
2012-04-24,1,Apr,12,0,Tue,1,36,188,224
2012-04-24,1,Apr,13,0,Tue,1,35,189,224
2012-04-24,1,Apr,14,0,Tue,1,50,166,216
2012-04-24,1,Apr,15,0,Tue,1,60,176,236
2012-04-24,1,Apr,16,0,Tue,1,54,308,362
2012-04-24,1,Apr,17,0,Tue,1,72,619,691
2012-04-24,1,Apr,18,0,Tue,1,52,580,632
2012-04-24,1,Apr,19,0,Tue,1,33,449,482
2012-04-24,1,Apr,20,0,Tue,1,16,269,285
2012-04-24,1,Apr,21,0,Tue,1,13,213,226
2012-04-24,1,Apr,22,0,Tue,1,8,149,157
2012-04-24,1,Apr,23,0,Tue,1,4,69,73
2012-04-25,1,Apr,0,0,Wed,1,13,23,36
2012-04-25,1,Apr,1,0,Wed,1,8,17,25
2012-04-25,1,Apr,2,0,Wed,1,1,6,7
2012-04-25,1,Apr,3,0,Wed,1,0,3,3
2012-04-25,1,Apr,4,0,Wed,1,0,6,6
2012-04-25,1,Apr,5,0,Wed,1,0,24,24
2012-04-25,1,Apr,6,0,Wed,1,3,103,106
2012-04-25,1,Apr,7,0,Wed,1,13,376,389
2012-04-25,1,Apr,8,0,Wed,1,20,634,654
2012-04-25,1,Apr,9,0,Wed,1,33,288,321
2012-04-25,1,Apr,10,0,Wed,1,44,138,182
2012-04-25,1,Apr,11,0,Wed,1,42,177,219
2012-04-25,1,Apr,12,0,Wed,1,49,220,269
2012-04-25,1,Apr,13,0,Wed,1,35,193,228
2012-04-25,1,Apr,14,0,Wed,1,47,176,223
2012-04-25,1,Apr,15,0,Wed,1,47,182,229
2012-04-25,1,Apr,16,0,Wed,1,49,327,376
2012-04-25,1,Apr,17,0,Wed,1,68,664,732
2012-04-25,1,Apr,18,0,Wed,1,60,649,709
2012-04-25,1,Apr,19,0,Wed,1,42,501,543
2012-04-25,1,Apr,20,0,Wed,1,22,358,380
2012-04-25,1,Apr,21,0,Wed,1,27,212,239
2012-04-25,1,Apr,22,0,Wed,1,22,170,192
2012-04-25,1,Apr,23,0,Wed,1,10,94,104
2012-04-26,1,Apr,0,0,Thur,1,1,42,43
2012-04-26,1,Apr,1,0,Thur,1,1,22,23
2012-04-26,1,Apr,2,0,Thur,1,3,10,13
2012-04-26,1,Apr,3,0,Thur,1,1,5,6
2012-04-26,1,Apr,4,0,Thur,1,1,2,3
2012-04-26,1,Apr,5,0,Thur,1,0,17,17
2012-04-26,1,Apr,6,0,Thur,1,5,122,127
2012-04-26,1,Apr,7,0,Thur,1,3,222,225
2012-04-26,1,Apr,8,0,Thur,1,4,358,362
2012-04-26,1,Apr,9,0,Thur,1,12,189,201
2012-04-26,1,Apr,10,0,Thur,1,14,125,139
2012-04-26,1,Apr,11,0,Thur,1,16,135,151
2012-04-26,1,Apr,12,0,Thur,1,24,180,204
2012-04-26,1,Apr,13,0,Thur,1,19,178,197
2012-04-26,1,Apr,14,0,Thur,1,37,132,169
2012-04-26,1,Apr,15,0,Thur,1,39,165,204
2012-04-26,1,Apr,16,0,Thur,1,37,281,318
2012-04-26,1,Apr,17,0,Thur,1,49,565,614
2012-04-26,1,Apr,18,0,Thur,1,75,589,664
2012-04-26,1,Apr,19,0,Thur,1,57,407,464
2012-04-26,1,Apr,20,0,Thur,1,23,314,337
2012-04-26,1,Apr,21,0,Thur,1,28,222,250
2012-04-26,1,Apr,22,0,Thur,1,20,163,183
2012-04-26,1,Apr,23,0,Thur,1,6,106,112
2012-04-27,1,Apr,0,0,Fri,1,12,61,73
2012-04-27,1,Apr,1,0,Fri,1,3,32,35
2012-04-27,1,Apr,2,0,Fri,1,4,18,22
2012-04-27,1,Apr,3,0,Fri,1,1,2,3
2012-04-27,1,Apr,4,0,Fri,1,0,6,6
2012-04-27,1,Apr,5,0,Fri,1,0,19,19
2012-04-27,1,Apr,6,0,Fri,1,5,115,120
2012-04-27,1,Apr,7,0,Fri,1,10,305,315
2012-04-27,1,Apr,8,0,Fri,1,17,575,592
2012-04-27,1,Apr,9,0,Fri,1,42,292,334
2012-04-27,1,Apr,10,0,Fri,1,64,172,236
2012-04-27,1,Apr,11,0,Fri,1,47,186,233
2012-04-27,1,Apr,12,0,Fri,1,63,244,307
2012-04-27,1,Apr,13,0,Fri,1,94,212,306
2012-04-27,1,Apr,14,0,Fri,1,94,206,300
2012-04-27,1,Apr,15,0,Fri,1,101,223,324
2012-04-27,1,Apr,16,0,Fri,1,105,335,440
2012-04-27,1,Apr,17,0,Fri,1,89,613,702
2012-04-27,1,Apr,18,0,Fri,1,94,560,654
2012-04-27,1,Apr,19,0,Fri,1,62,379,441
2012-04-27,1,Apr,20,0,Fri,1,49,240,289
2012-04-27,1,Apr,21,0,Fri,1,23,185,208
2012-04-27,1,Apr,22,0,Fri,1,24,134,158
2012-04-27,1,Apr,23,0,Fri,1,11,105,116
2012-04-28,1,Apr,0,0,Sat,0,4,99,103
2012-04-28,1,Apr,1,0,Sat,0,7,60,67
2012-04-28,1,Apr,2,0,Sat,0,8,49,57
2012-04-28,1,Apr,3,0,Sat,0,3,23,26
2012-04-28,1,Apr,4,0,Sat,0,0,2,2
2012-04-28,1,Apr,5,0,Sat,0,2,3,5
2012-04-28,1,Apr,6,0,Sat,0,10,18,28
2012-04-28,1,Apr,7,0,Sat,0,10,45,55
2012-04-28,1,Apr,8,0,Sat,0,24,134,158
2012-04-28,1,Apr,9,0,Sat,0,45,169,214
2012-04-28,1,Apr,10,0,Sat,0,60,231,291
2012-04-28,1,Apr,11,0,Sat,0,96,262,358
2012-04-28,1,Apr,12,0,Sat,0,105,276,381
2012-04-28,1,Apr,13,0,Sat,0,120,269,389
2012-04-28,1,Apr,14,0,Sat,0,147,293,440
2012-04-28,1,Apr,15,0,Sat,0,148,260,408
2012-04-28,1,Apr,16,0,Sat,0,132,244,376
2012-04-28,1,Apr,17,0,Sat,0,98,224,322
2012-04-28,1,Apr,18,0,Sat,0,17,73,90
2012-04-28,1,Apr,19,0,Sat,0,29,110,139
2012-04-28,1,Apr,20,0,Sat,0,21,81,102
2012-04-28,1,Apr,21,0,Sat,0,12,72,84
2012-04-28,1,Apr,22,0,Sat,0,17,66,83
2012-04-28,1,Apr,23,0,Sat,0,5,37,42
2012-04-29,1,Apr,0,0,Sun,0,0,36,36
2012-04-29,1,Apr,1,0,Sun,0,5,37,42
2012-04-29,1,Apr,2,0,Sun,0,4,36,40
2012-04-29,1,Apr,3,0,Sun,0,2,14,16
2012-04-29,1,Apr,4,0,Sun,0,0,4,4
2012-04-29,1,Apr,5,0,Sun,0,0,6,6
2012-04-29,1,Apr,6,0,Sun,0,1,6,7
2012-04-29,1,Apr,7,0,Sun,0,7,20,27
2012-04-29,1,Apr,8,0,Sun,0,26,81,107
2012-04-29,1,Apr,9,0,Sun,0,52,133,185
2012-04-29,1,Apr,10,0,Sun,0,127,253,380
2012-04-29,1,Apr,11,0,Sun,0,128,283,411
2012-04-29,1,Apr,12,0,Sun,0,223,361,584
2012-04-29,1,Apr,13,0,Sun,0,226,369,595
2012-04-29,1,Apr,14,0,Sun,0,281,372,653
2012-04-29,1,Apr,15,0,Sun,0,279,324,603
2012-04-29,1,Apr,16,0,Sun,0,240,347,587
2012-04-29,1,Apr,17,0,Sun,0,188,334,522
2012-04-29,1,Apr,18,0,Sun,0,164,323,487
2012-04-29,1,Apr,19,0,Sun,0,128,247,375
2012-04-29,1,Apr,20,0,Sun,0,45,198,243
2012-04-29,1,Apr,21,0,Sun,0,65,139,204
2012-04-29,1,Apr,22,0,Sun,0,23,85,108
2012-04-29,1,Apr,23,0,Sun,0,15,67,82
2012-04-30,1,Apr,0,0,Mon,1,12,36,48
2012-04-30,1,Apr,1,0,Mon,1,9,15,24
2012-04-30,1,Apr,2,0,Mon,1,3,5,8
2012-04-30,1,Apr,3,0,Mon,1,0,4,4
2012-04-30,1,Apr,4,0,Mon,1,0,2,2
2012-04-30,1,Apr,5,0,Mon,1,1,19,20
2012-04-30,1,Apr,6,0,Mon,1,2,121,123
2012-04-30,1,Apr,7,0,Mon,1,6,343,349
2012-04-30,1,Apr,8,0,Mon,1,17,579,596
2012-04-30,1,Apr,9,0,Mon,1,29,239,268
2012-04-30,1,Apr,10,0,Mon,1,41,116,157
2012-04-30,1,Apr,11,0,Mon,1,52,111,163
2012-04-30,1,Apr,12,0,Mon,1,45,180,225
2012-04-30,1,Apr,13,0,Mon,1,48,199,247
2012-04-30,1,Apr,14,0,Mon,1,56,162,218
2012-04-30,1,Apr,15,0,Mon,1,55,176,231
2012-04-30,1,Apr,16,0,Mon,1,44,303,347
2012-04-30,1,Apr,17,0,Mon,1,66,617,683
2012-04-30,1,Apr,18,0,Mon,1,53,611,664
2012-04-30,1,Apr,19,0,Mon,1,51,420,471
2012-04-30,1,Apr,20,0,Mon,1,28,281,309
2012-04-30,1,Apr,21,0,Mon,1,26,195,221
2012-04-30,1,Apr,22,0,Mon,1,11,123,134
2012-04-30,1,Apr,23,0,Mon,1,10,50,60
2012-05-01,1,May,0,0,Tue,1,7,28,35
2012-05-01,1,May,1,0,Tue,1,0,21,21
2012-05-01,1,May,2,0,Tue,1,1,7,8
2012-05-01,1,May,3,0,Tue,1,1,2,3
2012-05-01,1,May,4,0,Tue,1,1,7,8
2012-05-01,1,May,5,0,Tue,1,0,17,17
2012-05-01,1,May,6,0,Tue,1,2,24,26
2012-05-01,1,May,7,0,Tue,1,8,161,169
2012-05-01,1,May,8,0,Tue,1,19,538,557
2012-05-01,1,May,9,0,Tue,1,18,331,349
2012-05-01,1,May,10,0,Tue,1,30,144,174
2012-05-01,1,May,11,0,Tue,1,50,179,229
2012-05-01,1,May,12,0,Tue,1,41,228,269
2012-05-01,1,May,13,0,Tue,1,41,208,249
2012-05-01,1,May,14,0,Tue,1,37,167,204
2012-05-01,1,May,15,0,Tue,1,48,186,234
2012-05-01,1,May,16,0,Tue,1,41,313,354
2012-05-01,1,May,17,0,Tue,1,65,616,681
2012-05-01,1,May,18,0,Tue,1,81,662,743
2012-05-01,1,May,19,0,Tue,1,58,429,487
2012-05-01,1,May,20,0,Tue,1,36,299,335
2012-05-01,1,May,21,0,Tue,1,31,251,282
2012-05-01,1,May,22,0,Tue,1,21,190,211
2012-05-01,1,May,23,0,Tue,1,16,79,95
2012-05-02,1,May,0,0,Wed,1,4,43,47
2012-05-02,1,May,1,0,Wed,1,8,7,15
2012-05-02,1,May,2,0,Wed,1,7,9,16
2012-05-02,1,May,3,0,Wed,1,0,6,6
2012-05-02,1,May,4,0,Wed,1,2,2,4
2012-05-02,1,May,5,0,Wed,1,2,31,33
2012-05-02,1,May,6,0,Wed,1,3,117,120
2012-05-02,1,May,7,0,Wed,1,14,344,358
2012-05-02,1,May,8,0,Wed,1,26,640,666
2012-05-02,1,May,9,0,Wed,1,26,289,315
2012-05-02,1,May,10,0,Wed,1,28,147,175
2012-05-02,1,May,11,0,Wed,1,39,145,184
2012-05-02,1,May,12,0,Wed,1,35,210,245
2012-05-02,1,May,13,0,Wed,1,49,179,228
2012-05-02,1,May,14,0,Wed,1,51,189,240
2012-05-02,1,May,15,0,Wed,1,52,204,256
2012-05-02,1,May,16,0,Wed,1,54,313,367
2012-05-02,1,May,17,0,Wed,1,70,659,729
2012-05-02,1,May,18,0,Wed,1,43,770,813
2012-05-02,1,May,19,0,Wed,1,43,461,504
2012-05-02,1,May,20,0,Wed,1,42,296,338
2012-05-02,1,May,21,0,Wed,1,21,218,239
2012-05-02,1,May,22,0,Wed,1,27,146,173
2012-05-02,1,May,23,0,Wed,1,21,77,98
2012-05-03,1,May,0,0,Thur,1,15,75,90
2012-05-03,1,May,1,0,Thur,1,9,15,24
2012-05-03,1,May,2,0,Thur,1,4,13,17
2012-05-03,1,May,3,0,Thur,1,2,4,6
2012-05-03,1,May,4,0,Thur,1,0,2,2
2012-05-03,1,May,5,0,Thur,1,1,20,21
2012-05-03,1,May,6,0,Thur,1,8,128,136
2012-05-03,1,May,7,0,Thur,1,8,376,384
2012-05-03,1,May,8,0,Thur,1,19,608,627
2012-05-03,1,May,9,0,Thur,1,25,279,304
2012-05-03,1,May,10,0,Thur,1,36,132,168
2012-05-03,1,May,11,0,Thur,1,34,167,201
2012-05-03,1,May,12,0,Thur,1,64,237,301
2012-05-03,1,May,13,0,Thur,1,48,217,265
2012-05-03,1,May,14,0,Thur,1,33,171,204
2012-05-03,1,May,15,0,Thur,1,63,220,283
2012-05-03,1,May,16,0,Thur,1,45,325,370
2012-05-03,1,May,17,0,Thur,1,87,617,704
2012-05-03,1,May,18,0,Thur,1,64,642,706
2012-05-03,1,May,19,0,Thur,1,55,467,522
2012-05-03,1,May,20,0,Thur,1,52,368,420
2012-05-03,1,May,21,0,Thur,1,42,257,299
2012-05-03,1,May,22,0,Thur,1,29,217,246
2012-05-03,1,May,23,0,Thur,1,21,100,121
2012-05-04,1,May,0,0,Fri,1,19,70,89
2012-05-04,1,May,1,0,Fri,1,15,33,48
2012-05-04,1,May,2,0,Fri,1,0,11,11
2012-05-04,1,May,3,0,Fri,1,0,14,14
2012-05-04,1,May,4,0,Fri,1,0,4,4
2012-05-04,1,May,5,0,Fri,1,0,24,24
2012-05-04,1,May,6,0,Fri,1,8,127,135
2012-05-04,1,May,7,0,Fri,1,9,347,356
2012-05-04,1,May,8,0,Fri,1,34,584,618
2012-05-04,1,May,9,0,Fri,1,32,262,294
2012-05-04,1,May,10,0,Fri,1,45,154,199
2012-05-04,1,May,11,0,Fri,1,77,181,258
2012-05-04,1,May,12,0,Fri,1,46,125,171
2012-05-04,1,May,13,0,Fri,1,71,207,278
2012-05-04,1,May,14,0,Fri,1,83,159,242
2012-05-04,1,May,15,0,Fri,1,103,240,343
2012-05-04,1,May,16,0,Fri,1,82,358,440
2012-05-04,1,May,17,0,Fri,1,96,547,643
2012-05-04,1,May,18,0,Fri,1,77,564,641
2012-05-04,1,May,19,0,Fri,1,64,388,452
2012-05-04,1,May,20,0,Fri,1,58,255,313
2012-05-04,1,May,21,0,Fri,1,49,186,235
2012-05-04,1,May,22,0,Fri,1,50,182,232
2012-05-04,1,May,23,0,Fri,1,51,205,256
2012-05-05,1,May,0,0,Sat,0,42,111,153
2012-05-05,1,May,1,0,Sat,0,28,79,107
2012-05-05,1,May,2,0,Sat,0,24,51,75
2012-05-05,1,May,3,0,Sat,0,11,21,32
2012-05-05,1,May,4,0,Sat,0,0,9,9
2012-05-05,1,May,5,0,Sat,0,8,14,22
2012-05-05,1,May,6,0,Sat,0,9,33,42
2012-05-05,1,May,7,0,Sat,0,8,79,87
2012-05-05,1,May,8,0,Sat,0,42,155,197
2012-05-05,1,May,9,0,Sat,0,61,223,284
2012-05-05,1,May,10,0,Sat,0,148,284,432
2012-05-05,1,May,11,0,Sat,0,221,354,575
2012-05-05,1,May,12,0,Sat,0,220,330,550
2012-05-05,1,May,13,0,Sat,0,217,307,524
2012-05-05,1,May,14,0,Sat,0,187,241,428
2012-05-05,1,May,15,0,Sat,0,241,300,541
2012-05-05,1,May,16,0,Sat,0,230,310,540
2012-05-05,1,May,17,0,Sat,0,204,298,502
2012-05-05,1,May,18,0,Sat,0,156,278,434
2012-05-05,1,May,19,0,Sat,0,151,254,405
2012-05-05,1,May,20,0,Sat,0,100,209,309
2012-05-05,1,May,21,0,Sat,0,86,183,269
2012-05-05,1,May,22,0,Sat,0,67,150,217
2012-05-05,1,May,23,0,Sat,0,35,114,149
2012-05-06,1,May,0,0,Sun,0,23,111,134
2012-05-06,1,May,1,0,Sun,0,37,84,121
2012-05-06,1,May,2,0,Sun,0,29,64,93
2012-05-06,1,May,3,0,Sun,0,9,19,28
2012-05-06,1,May,4,0,Sun,0,9,7,16
2012-05-06,1,May,5,0,Sun,0,1,10,11
2012-05-06,1,May,6,0,Sun,0,3,14,17
2012-05-06,1,May,7,0,Sun,0,5,31,36
2012-05-06,1,May,8,0,Sun,0,23,91,114
2012-05-06,1,May,9,0,Sun,0,63,128,191
2012-05-06,1,May,10,0,Sun,0,112,221,333
2012-05-06,1,May,11,0,Sun,0,144,270,414
2012-05-06,1,May,12,0,Sun,0,207,351,558
2012-05-06,1,May,13,0,Sun,0,197,368,565
2012-05-06,1,May,14,0,Sun,0,226,292,518
2012-05-06,1,May,15,0,Sun,0,229,342,571
2012-05-06,1,May,16,0,Sun,0,181,363,544
2012-05-06,1,May,17,0,Sun,0,195,316,511
2012-05-06,1,May,18,0,Sun,0,131,332,463
2012-05-06,1,May,19,0,Sun,0,117,266,383
2012-05-06,1,May,20,0,Sun,0,73,203,276
2012-05-06,1,May,21,0,Sun,0,55,148,203
2012-05-06,1,May,22,0,Sun,0,44,113,157
2012-05-06,1,May,23,0,Sun,0,22,80,102
2012-05-07,1,May,0,0,Mon,1,13,21,34
2012-05-07,1,May,1,0,Mon,1,1,8,9
2012-05-07,1,May,2,0,Mon,1,1,5,6
2012-05-07,1,May,3,0,Mon,1,2,3,5
2012-05-07,1,May,4,0,Mon,1,0,2,2
2012-05-07,1,May,5,0,Mon,1,2,21,23
2012-05-07,1,May,6,0,Mon,1,8,134,142
2012-05-07,1,May,7,0,Mon,1,18,367,385
2012-05-07,1,May,8,0,Mon,1,31,608,639
2012-05-07,1,May,9,0,Mon,1,61,289,350
2012-05-07,1,May,10,0,Mon,1,62,128,190
2012-05-07,1,May,11,0,Mon,1,64,149,213
2012-05-07,1,May,12,0,Mon,1,74,189,263
2012-05-07,1,May,13,0,Mon,1,75,197,272
2012-05-07,1,May,14,0,Mon,1,59,180,239
2012-05-07,1,May,15,0,Mon,1,76,186,262
2012-05-07,1,May,16,0,Mon,1,68,320,388
2012-05-07,1,May,17,0,Mon,1,102,667,769
2012-05-07,1,May,18,0,Mon,1,78,602,680
2012-05-07,1,May,19,0,Mon,1,83,463,546
2012-05-07,1,May,20,0,Mon,1,46,277,323
2012-05-07,1,May,21,0,Mon,1,37,210,247
2012-05-07,1,May,22,0,Mon,1,26,147,173
2012-05-07,1,May,23,0,Mon,1,21,92,113
2012-05-08,1,May,0,0,Tue,1,10,28,38
2012-05-08,1,May,1,0,Tue,1,6,3,9
2012-05-08,1,May,2,0,Tue,1,9,7,16
2012-05-08,1,May,3,0,Tue,1,2,4,6
2012-05-08,1,May,4,0,Tue,1,0,5,5
2012-05-08,1,May,5,0,Tue,1,0,20,20
2012-05-08,1,May,6,0,Tue,1,7,158,165
2012-05-08,1,May,7,0,Tue,1,21,442,463
2012-05-08,1,May,8,0,Tue,1,36,605,641
2012-05-08,1,May,9,0,Tue,1,37,258,295
2012-05-08,1,May,10,0,Tue,1,46,111,157
2012-05-08,1,May,11,0,Tue,1,60,157,217
2012-05-08,1,May,12,0,Tue,1,60,203,263
2012-05-08,1,May,13,0,Tue,1,53,166,219
2012-05-08,1,May,14,0,Tue,1,8,63,71
2012-05-08,1,May,15,0,Tue,1,40,94,134
2012-05-08,1,May,16,0,Tue,1,54,335,389
2012-05-08,1,May,17,0,Tue,1,77,640,717
2012-05-08,1,May,18,0,Tue,1,69,641,710
2012-05-08,1,May,19,0,Tue,1,59,399,458
2012-05-08,1,May,20,0,Tue,1,40,262,302
2012-05-08,1,May,21,0,Tue,1,21,202,223
2012-05-08,1,May,22,0,Tue,1,13,134,147
2012-05-08,1,May,23,0,Tue,1,10,53,63
2012-05-09,1,May,0,0,Wed,1,8,27,35
2012-05-09,1,May,1,0,Wed,1,3,11,14
2012-05-09,1,May,2,0,Wed,1,0,1,1
2012-05-09,1,May,3,0,Wed,1,0,2,2
2012-05-09,1,May,4,0,Wed,1,0,5,5
2012-05-09,1,May,5,0,Wed,1,1,27,28
2012-05-09,1,May,6,0,Wed,1,5,121,126
2012-05-09,1,May,7,0,Wed,1,17,401,418
2012-05-09,1,May,8,0,Wed,1,28,594,622
2012-05-09,1,May,9,0,Wed,1,40,285,325
2012-05-09,1,May,10,0,Wed,1,40,113,153
2012-05-09,1,May,11,0,Wed,1,45,156,201
2012-05-09,1,May,12,0,Wed,1,58,222,280
2012-05-09,1,May,13,0,Wed,1,50,216,266
2012-05-09,1,May,14,0,Wed,1,68,175,243
2012-05-09,1,May,15,0,Wed,1,68,191,259
2012-05-09,1,May,16,0,Wed,1,68,289,357
2012-05-09,1,May,17,0,Wed,1,76,629,705
2012-05-09,1,May,18,0,Wed,1,23,349,372
2012-05-09,1,May,19,0,Wed,1,2,96,98
2012-05-09,1,May,20,0,Wed,1,3,48,51
2012-05-09,1,May,21,0,Wed,1,4,30,34
2012-05-09,1,May,22,0,Wed,1,5,62,67
2012-05-09,1,May,23,0,Wed,1,8,47,55
2012-05-10,1,May,0,0,Thur,1,2,31,33
2012-05-10,1,May,1,0,Thur,1,2,9,11
2012-05-10,1,May,2,0,Thur,1,0,3,3
2012-05-10,1,May,3,0,Thur,1,0,3,3
2012-05-10,1,May,4,0,Thur,1,0,2,2
2012-05-10,1,May,5,0,Thur,1,1,23,24
2012-05-10,1,May,6,0,Thur,1,9,130,139
2012-05-10,1,May,7,0,Thur,1,8,393,401
2012-05-10,1,May,8,0,Thur,1,27,603,630
2012-05-10,1,May,9,0,Thur,1,62,299,361
2012-05-10,1,May,10,0,Thur,1,42,112,154
2012-05-10,1,May,11,0,Thur,1,77,179,256
2012-05-10,1,May,12,0,Thur,1,65,207,272
2012-05-10,1,May,13,0,Thur,1,90,228,318
2012-05-10,1,May,14,0,Thur,1,61,186,247
2012-05-10,1,May,15,0,Thur,1,79,192,271
2012-05-10,1,May,16,0,Thur,1,87,334,421
2012-05-10,1,May,17,0,Thur,1,84,648,732
2012-05-10,1,May,18,0,Thur,1,109,661,770
2012-05-10,1,May,19,0,Thur,1,84,469,553
2012-05-10,1,May,20,0,Thur,1,59,315,374
2012-05-10,1,May,21,0,Thur,1,19,211,230
2012-05-10,1,May,22,0,Thur,1,36,196,232
2012-05-10,1,May,23,0,Thur,1,23,112,135
2012-05-11,1,May,0,0,Fri,1,17,47,64
2012-05-11,1,May,1,0,Fri,1,14,32,46
2012-05-11,1,May,2,0,Fri,1,15,16,31
2012-05-11,1,May,3,0,Fri,1,5,8,13
2012-05-11,1,May,4,0,Fri,1,3,6,9
2012-05-11,1,May,5,0,Fri,1,3,23,26
2012-05-11,1,May,6,0,Fri,1,7,128,135
2012-05-11,1,May,7,0,Fri,1,6,345,351
2012-05-11,1,May,8,0,Fri,1,41,579,620
2012-05-11,1,May,9,0,Fri,1,34,288,322
2012-05-11,1,May,10,0,Fri,1,69,141,210
2012-05-11,1,May,11,0,Fri,1,88,203,291
2012-05-11,1,May,12,0,Fri,1,89,259,348
2012-05-11,1,May,13,0,Fri,1,100,263,363
2012-05-11,1,May,14,0,Fri,1,116,218,334
2012-05-11,1,May,15,0,Fri,1,140,299,439
2012-05-11,1,May,16,0,Fri,1,128,397,525
2012-05-11,1,May,17,0,Fri,1,102,677,779
2012-05-11,1,May,18,0,Fri,1,78,518,596
2012-05-11,1,May,19,0,Fri,1,73,430,503
2012-05-11,1,May,20,0,Fri,1,64,277,341
2012-05-11,1,May,21,0,Fri,1,45,225,270
2012-05-11,1,May,22,0,Fri,1,44,190,234
2012-05-11,1,May,23,0,Fri,1,38,142,180
2012-05-12,1,May,0,0,Sat,0,25,111,136
2012-05-12,1,May,1,0,Sat,0,14,79,93
2012-05-12,1,May,2,0,Sat,0,10,46,56
2012-05-12,1,May,3,0,Sat,0,14,20,34
2012-05-12,1,May,4,0,Sat,0,3,6,9
2012-05-12,1,May,5,0,Sat,0,5,8,13
2012-05-12,1,May,6,0,Sat,0,10,23,33
2012-05-12,1,May,7,0,Sat,0,10,57,67
2012-05-12,1,May,8,0,Sat,0,22,156,178
2012-05-12,1,May,9,0,Sat,0,87,248,335
2012-05-12,1,May,10,0,Sat,0,132,279,411
2012-05-12,1,May,11,0,Sat,0,157,365,522
2012-05-12,1,May,12,0,Sat,0,206,353,559
2012-05-12,1,May,13,0,Sat,0,293,366,659
2012-05-12,1,May,14,0,Sat,0,257,358,615
2012-05-12,1,May,15,0,Sat,0,269,321,590
2012-05-12,1,May,16,0,Sat,0,254,337,591
2012-05-12,1,May,17,0,Sat,0,233,343,576
2012-05-12,1,May,18,0,Sat,0,164,382,546
2012-05-12,1,May,19,0,Sat,0,166,273,439
2012-05-12,1,May,20,0,Sat,0,113,174,287
2012-05-12,1,May,21,0,Sat,0,74,156,230
2012-05-12,1,May,22,0,Sat,0,62,212,274
2012-05-12,1,May,23,0,Sat,0,42,134,176
2012-05-13,1,May,0,0,Sun,0,19,79,98
2012-05-13,1,May,1,0,Sun,0,22,72,94
2012-05-13,1,May,2,0,Sun,0,22,60,82
2012-05-13,1,May,3,0,Sun,0,2,26,28
2012-05-13,1,May,4,0,Sun,0,2,7,9
2012-05-13,1,May,5,0,Sun,0,4,8,12
2012-05-13,1,May,6,0,Sun,0,6,15,21
2012-05-13,1,May,7,0,Sun,0,18,42,60
2012-05-13,1,May,8,0,Sun,0,32,124,156
2012-05-13,1,May,9,0,Sun,0,79,143,222
2012-05-13,1,May,10,0,Sun,0,128,222,350
2012-05-13,1,May,11,0,Sun,0,150,278,428
2012-05-13,1,May,12,0,Sun,0,189,342,531
2012-05-13,1,May,13,0,Sun,0,255,347,602
2012-05-13,1,May,14,0,Sun,0,228,324,552
2012-05-13,1,May,15,0,Sun,0,190,309,499
2012-05-13,1,May,16,0,Sun,0,225,339,564
2012-05-13,1,May,17,0,Sun,0,191,287,478
2012-05-13,1,May,18,0,Sun,0,129,260,389
2012-05-13,1,May,19,0,Sun,0,107,232,339
2012-05-13,1,May,20,0,Sun,0,67,163,230
2012-05-13,1,May,21,0,Sun,0,48,121,169
2012-05-13,1,May,22,0,Sun,0,42,89,131
2012-05-13,1,May,23,0,Sun,0,17,57,74
2012-05-14,1,May,0,0,Mon,1,21,14,35
2012-05-14,1,May,1,0,Mon,1,5,6,11
2012-05-14,1,May,2,0,Mon,1,1,1,2
2012-05-14,1,May,3,0,Mon,1,0,2,2
2012-05-14,1,May,4,0,Mon,1,3,3,6
2012-05-14,1,May,5,0,Mon,1,1,25,26
2012-05-14,1,May,6,0,Mon,1,3,62,65
2012-05-14,1,May,7,0,Mon,1,3,72,75
2012-05-14,1,May,8,0,Mon,1,1,155,156
2012-05-14,1,May,9,0,Mon,1,5,105,110
2012-05-14,1,May,10,0,Mon,1,6,53,59
2012-05-14,1,May,11,0,Mon,1,12,67,79
2012-05-14,1,May,12,0,Mon,1,53,132,185
2012-05-14,1,May,13,0,Mon,1,33,143,176
2012-05-14,1,May,14,0,Mon,1,43,128,171
2012-05-14,1,May,15,0,Mon,1,40,156,196
2012-05-14,1,May,16,0,Mon,1,20,91,111
2012-05-14,1,May,17,0,Mon,1,25,204,229
2012-05-14,1,May,18,0,Mon,1,17,283,300
2012-05-14,1,May,19,0,Mon,1,10,294,304
2012-05-14,1,May,20,0,Mon,1,11,178,189
2012-05-14,1,May,21,0,Mon,1,7,145,152
2012-05-14,1,May,22,0,Mon,1,11,118,129
2012-05-14,1,May,23,0,Mon,1,11,64,75
2012-05-15,1,May,0,0,Tue,1,7,25,32
2012-05-15,1,May,1,0,Tue,1,5,14,19
2012-05-15,1,May,2,0,Tue,1,1,3,4
2012-05-15,1,May,3,0,Tue,1,1,5,6
2012-05-15,1,May,4,0,Tue,1,1,4,5
2012-05-15,1,May,5,0,Tue,1,0,8,8
2012-05-15,1,May,6,0,Tue,1,2,22,24
2012-05-15,1,May,7,0,Tue,1,1,91,92
2012-05-15,1,May,8,0,Tue,1,8,401,409
2012-05-15,1,May,9,0,Tue,1,28,327,355
2012-05-15,1,May,10,0,Tue,1,27,144,171
2012-05-15,1,May,11,0,Tue,1,38,186,224
2012-05-15,1,May,12,0,Tue,1,44,220,264
2012-05-15,1,May,13,0,Tue,1,35,204,239
2012-05-15,1,May,14,0,Tue,1,39,145,184
2012-05-15,1,May,15,0,Tue,1,51,205,256
2012-05-15,1,May,16,0,Tue,1,74,300,374
2012-05-15,1,May,17,0,Tue,1,75,603,678
2012-05-15,1,May,18,0,Tue,1,68,665,733
2012-05-15,1,May,19,0,Tue,1,57,455,512
2012-05-15,1,May,20,0,Tue,1,30,233,263
2012-05-15,1,May,21,0,Tue,1,11,98,109
2012-05-15,1,May,22,0,Tue,1,9,74,83
2012-05-15,1,May,23,0,Tue,1,13,58,71
2012-05-16,1,May,0,0,Wed,1,12,27,39
2012-05-16,1,May,1,0,Wed,1,7,14,21
2012-05-16,1,May,2,0,Wed,1,5,14,19
2012-05-16,1,May,3,0,Wed,1,1,5,6
2012-05-16,1,May,4,0,Wed,1,1,3,4
2012-05-16,1,May,5,0,Wed,1,4,34,38
2012-05-16,1,May,6,0,Wed,1,8,150,158
2012-05-16,1,May,7,0,Wed,1,14,426,440
2012-05-16,1,May,8,0,Wed,1,33,617,650
2012-05-16,1,May,9,0,Wed,1,33,314,347
2012-05-16,1,May,10,0,Wed,1,43,149,192
2012-05-16,1,May,11,0,Wed,1,55,212,267
2012-05-16,1,May,12,0,Wed,1,59,271,330
2012-05-16,1,May,13,0,Wed,1,77,273,350
2012-05-16,1,May,14,0,Wed,1,42,221,263
2012-05-16,1,May,15,0,Wed,1,52,222,274
2012-05-16,1,May,16,0,Wed,1,70,376,446
2012-05-16,1,May,17,0,Wed,1,104,769,873
2012-05-16,1,May,18,0,Wed,1,97,749,846
2012-05-16,1,May,19,0,Wed,1,91,499,590
2012-05-16,1,May,20,0,Wed,1,61,398,459
2012-05-16,1,May,21,0,Wed,1,63,330,393
2012-05-16,1,May,22,0,Wed,1,33,253,286
2012-05-16,1,May,23,0,Wed,1,26,107,133
2012-05-17,1,May,0,0,Thur,1,30,49,79
2012-05-17,1,May,1,0,Thur,1,12,16,28
2012-05-17,1,May,2,0,Thur,1,8,8,16
2012-05-17,1,May,3,0,Thur,1,0,3,3
2012-05-17,1,May,4,0,Thur,1,3,13,16
2012-05-17,1,May,5,0,Thur,1,1,34,35
2012-05-17,1,May,6,0,Thur,1,10,149,159
2012-05-17,1,May,7,0,Thur,1,25,449,474
2012-05-17,1,May,8,0,Thur,1,29,605,634
2012-05-17,1,May,9,0,Thur,1,57,289,346
2012-05-17,1,May,10,0,Thur,1,43,162,205
2012-05-17,1,May,11,0,Thur,1,77,202,279
2012-05-17,1,May,12,0,Thur,1,72,276,348
2012-05-17,1,May,13,0,Thur,1,86,241,327
2012-05-17,1,May,14,0,Thur,1,68,202,270
2012-05-17,1,May,15,0,Thur,1,83,233,316
2012-05-17,1,May,16,0,Thur,1,86,344,430
2012-05-17,1,May,17,0,Thur,1,133,719,852
2012-05-17,1,May,18,0,Thur,1,134,734,868
2012-05-17,1,May,19,0,Thur,1,86,451,537
2012-05-17,1,May,20,0,Thur,1,83,363,446
2012-05-17,1,May,21,0,Thur,1,45,254,299
2012-05-17,1,May,22,0,Thur,1,42,209,251
2012-05-17,1,May,23,0,Thur,1,29,137,166
2012-05-18,1,May,0,0,Fri,1,13,57,70
2012-05-18,1,May,1,0,Fri,1,16,33,49
2012-05-18,1,May,2,0,Fri,1,12,9,21
2012-05-18,1,May,3,0,Fri,1,6,8,14
2012-05-18,1,May,4,0,Fri,1,0,11,11
2012-05-18,1,May,5,0,Fri,1,1,33,34
2012-05-18,1,May,6,0,Fri,1,14,168,182
2012-05-18,1,May,7,0,Fri,1,40,475,515
2012-05-18,1,May,8,0,Fri,1,49,696,745
2012-05-18,1,May,9,0,Fri,1,57,304,361
2012-05-18,1,May,10,0,Fri,1,74,181,255
2012-05-18,1,May,11,0,Fri,1,109,225,334
2012-05-18,1,May,12,0,Fri,1,108,252,360
2012-05-18,1,May,13,0,Fri,1,98,297,395
2012-05-18,1,May,14,0,Fri,1,108,242,350
2012-05-18,1,May,15,0,Fri,1,131,260,391
2012-05-18,1,May,16,0,Fri,1,151,417,568
2012-05-18,1,May,17,0,Fri,1,124,688,812
2012-05-18,1,May,18,0,Fri,1,99,570,669
2012-05-18,1,May,19,0,Fri,1,91,392,483
2012-05-18,1,May,20,0,Fri,1,73,264,337
2012-05-18,1,May,21,0,Fri,1,49,209,258
2012-05-18,1,May,22,0,Fri,1,57,194,251
2012-05-18,1,May,23,0,Fri,1,41,133,174
2012-05-19,1,May,0,0,Sat,0,30,118,148
2012-05-19,1,May,1,0,Sat,0,20,84,104
2012-05-19,1,May,2,0,Sat,0,13,56,69
2012-05-19,1,May,3,0,Sat,0,10,23,33
2012-05-19,1,May,4,0,Sat,0,6,8,14
2012-05-19,1,May,5,0,Sat,0,1,11,12
2012-05-19,1,May,6,0,Sat,0,12,38,50
2012-05-19,1,May,7,0,Sat,0,28,67,95
2012-05-19,1,May,8,0,Sat,0,33,162,195
2012-05-19,1,May,9,0,Sat,0,79,213,292
2012-05-19,1,May,10,0,Sat,0,177,275,452
2012-05-19,1,May,11,0,Sat,0,235,351,586
2012-05-19,1,May,12,0,Sat,0,276,366,642
2012-05-19,1,May,13,0,Sat,0,332,372,704
2012-05-19,1,May,14,0,Sat,0,361,369,730
2012-05-19,1,May,15,0,Sat,0,356,316,672
2012-05-19,1,May,16,0,Sat,0,331,311,642
2012-05-19,1,May,17,0,Sat,0,279,347,626
2012-05-19,1,May,18,0,Sat,0,254,391,645
2012-05-19,1,May,19,0,Sat,0,203,229,432
2012-05-19,1,May,20,0,Sat,0,118,197,315
2012-05-19,1,May,21,0,Sat,0,81,178,259
2012-05-19,1,May,22,0,Sat,0,104,234,338
2012-05-19,1,May,23,0,Sat,0,71,168,239
2012-05-20,1,May,0,0,Sun,0,42,128,170
2012-05-20,1,May,1,0,Sun,0,28,102,130
2012-05-20,1,May,2,0,Sun,0,36,62,98
2012-05-20,1,May,3,0,Sun,0,26,40,66
2012-05-20,1,May,4,0,Sun,0,2,14,16
2012-05-20,1,May,5,0,Sun,0,1,7,8
2012-05-20,1,May,6,0,Sun,0,4,21,25
2012-05-20,1,May,7,0,Sun,0,35,55,90
2012-05-20,1,May,8,0,Sun,0,51,120,171
2012-05-20,1,May,9,0,Sun,0,129,184,313
2012-05-20,1,May,10,0,Sun,0,174,258,432
2012-05-20,1,May,11,0,Sun,0,258,323,581
2012-05-20,1,May,12,0,Sun,0,247,390,637
2012-05-20,1,May,13,0,Sun,0,244,363,607
2012-05-20,1,May,14,0,Sun,0,236,307,543
2012-05-20,1,May,15,0,Sun,0,246,256,502
2012-05-20,1,May,16,0,Sun,0,238,339,577
2012-05-20,1,May,17,0,Sun,0,209,340,549
2012-05-20,1,May,18,0,Sun,0,146,328,474
2012-05-20,1,May,19,0,Sun,0,142,260,402
2012-05-20,1,May,20,0,Sun,0,83,191,274
2012-05-20,1,May,21,0,Sun,0,51,182,233
2012-05-20,1,May,22,0,Sun,0,44,101,145
2012-05-20,1,May,23,0,Sun,0,32,54,86
2012-05-21,1,May,0,0,Mon,1,12,28,40
2012-05-21,1,May,1,0,Mon,1,4,11,15
2012-05-21,1,May,2,0,Mon,1,2,9,11
2012-05-21,1,May,3,0,Mon,1,0,2,2
2012-05-21,1,May,4,0,Mon,1,2,5,7
2012-05-21,1,May,5,0,Mon,1,1,14,15
2012-05-21,1,May,6,0,Mon,1,3,76,79
2012-05-21,1,May,7,0,Mon,1,7,146,153
2012-05-21,1,May,8,0,Mon,1,12,258,270
2012-05-21,1,May,9,0,Mon,1,14,172,186
2012-05-21,1,May,10,0,Mon,1,28,71,99
2012-05-21,1,May,11,0,Mon,1,24,82,106
2012-05-21,1,May,12,0,Mon,1,46,124,170
2012-05-21,1,May,13,0,Mon,1,49,135,184
2012-05-21,1,May,14,0,Mon,1,45,135,180
2012-05-21,1,May,15,0,Mon,1,67,158,225
2012-05-21,1,May,16,0,Mon,1,46,269,315
2012-05-21,1,May,17,0,Mon,1,40,468,508
2012-05-21,1,May,18,0,Mon,1,52,478,530
2012-05-21,1,May,19,0,Mon,1,57,391,448
2012-05-21,1,May,20,0,Mon,1,44,292,336
2012-05-21,1,May,21,0,Mon,1,31,210,241
2012-05-21,1,May,22,0,Mon,1,26,116,142
2012-05-21,1,May,23,0,Mon,1,18,79,97
2012-05-22,1,May,0,0,Tue,1,10,26,36
2012-05-22,1,May,1,0,Tue,1,11,16,27
2012-05-22,1,May,2,0,Tue,1,1,10,11
2012-05-22,1,May,3,0,Tue,1,0,5,5
2012-05-22,1,May,4,0,Tue,1,0,7,7
2012-05-22,1,May,5,0,Tue,1,0,17,17
2012-05-22,1,May,6,0,Tue,1,8,129,137
2012-05-22,1,May,7,0,Tue,1,9,315,324
2012-05-22,1,May,8,0,Tue,1,20,570,590
2012-05-22,1,May,9,0,Tue,1,46,287,333
2012-05-22,1,May,10,0,Tue,1,52,148,200
2012-05-22,1,May,11,0,Tue,1,39,150,189
2012-05-22,1,May,12,0,Tue,1,76,178,254
2012-05-22,1,May,13,0,Tue,1,48,195,243
2012-05-22,1,May,14,0,Tue,1,73,149,222
2012-05-22,1,May,15,0,Tue,1,54,191,245
2012-05-22,1,May,16,0,Tue,1,70,316,386
2012-05-22,1,May,17,0,Tue,1,69,716,785
2012-05-22,1,May,18,0,Tue,1,76,709,785
2012-05-22,1,May,19,0,Tue,1,44,320,364
2012-05-22,1,May,20,0,Tue,1,54,319,373
2012-05-22,1,May,21,0,Tue,1,28,233,261
2012-05-22,1,May,22,0,Tue,1,17,157,174
2012-05-22,1,May,23,0,Tue,1,14,91,105
2012-05-23,1,May,0,0,Wed,1,19,28,47
2012-05-23,1,May,1,0,Wed,1,23,9,32
2012-05-23,1,May,2,0,Wed,1,2,10,12
2012-05-23,1,May,3,0,Wed,1,0,5,5
2012-05-23,1,May,4,0,Wed,1,0,3,3
2012-05-23,1,May,5,0,Wed,1,6,29,35
2012-05-23,1,May,6,0,Wed,1,6,154,160
2012-05-23,1,May,7,0,Wed,1,16,452,468
2012-05-23,1,May,8,0,Wed,1,38,681,719
2012-05-23,1,May,9,0,Wed,1,39,258,297
2012-05-23,1,May,10,0,Wed,1,52,139,191
2012-05-23,1,May,11,0,Wed,1,46,151,197
2012-05-23,1,May,12,0,Wed,1,42,206,248
2012-05-23,1,May,13,0,Wed,1,69,201,270
2012-05-23,1,May,14,0,Wed,1,67,181,248
2012-05-23,1,May,15,0,Wed,1,65,192,257
2012-05-23,1,May,16,0,Wed,1,62,216,278
2012-05-23,1,May,17,0,Wed,1,45,240,285
2012-05-23,1,May,18,0,Wed,1,31,296,327
2012-05-23,1,May,19,0,Wed,1,40,336,376
2012-05-23,1,May,20,0,Wed,1,28,267,295
2012-05-23,1,May,21,0,Wed,1,24,221,245
2012-05-23,1,May,22,0,Wed,1,23,136,159
2012-05-23,1,May,23,0,Wed,1,23,83,106
2012-05-24,1,May,0,0,Thur,1,7,49,56
2012-05-24,1,May,1,0,Thur,1,9,21,30
2012-05-24,1,May,2,0,Thur,1,1,15,16
2012-05-24,1,May,3,0,Thur,1,1,3,4
2012-05-24,1,May,4,0,Thur,1,0,5,5
2012-05-24,1,May,5,0,Thur,1,1,29,30
2012-05-24,1,May,6,0,Thur,1,10,146,156
2012-05-24,1,May,7,0,Thur,1,22,393,415
2012-05-24,1,May,8,0,Thur,1,33,659,692
2012-05-24,1,May,9,0,Thur,1,34,267,301
2012-05-24,1,May,10,0,Thur,1,47,138,185
2012-05-24,1,May,11,0,Thur,1,61,160,221
2012-05-24,1,May,12,0,Thur,1,76,213,289
2012-05-24,1,May,13,0,Thur,1,69,233,302
2012-05-24,1,May,14,0,Thur,1,72,180,252
2012-05-24,1,May,15,0,Thur,1,69,222,291
2012-05-24,1,May,16,0,Thur,1,61,329,390
2012-05-24,1,May,17,0,Thur,1,120,678,798
2012-05-24,1,May,18,0,Thur,1,118,634,752
2012-05-24,1,May,19,0,Thur,1,76,416,492
2012-05-24,1,May,20,0,Thur,1,55,343,398
2012-05-24,1,May,21,0,Thur,1,48,237,285
2012-05-24,1,May,22,0,Thur,1,33,210,243
2012-05-24,1,May,23,0,Thur,1,36,131,167
2012-05-25,1,May,0,0,Fri,1,10,63,73
2012-05-25,1,May,1,0,Fri,1,8,34,42
2012-05-25,1,May,2,0,Fri,1,7,16,23
2012-05-25,1,May,3,0,Fri,1,8,6,14
2012-05-25,1,May,4,0,Fri,1,3,6,9
2012-05-25,1,May,5,0,Fri,1,2,28,30
2012-05-25,1,May,6,0,Fri,1,5,108,113
2012-05-25,1,May,7,0,Fri,1,7,352,359
2012-05-25,1,May,8,0,Fri,1,32,551,583
2012-05-25,1,May,9,0,Fri,1,52,288,340
2012-05-25,1,May,10,0,Fri,1,69,163,232
2012-05-25,1,May,11,0,Fri,1,90,193,283
2012-05-25,1,May,12,0,Fri,1,84,237,321
2012-05-25,1,May,13,0,Fri,1,86,247,333
2012-05-25,1,May,14,0,Fri,1,104,263,367
2012-05-25,1,May,15,0,Fri,1,106,360,466
2012-05-25,1,May,16,0,Fri,1,137,447,584
2012-05-25,1,May,17,0,Fri,1,124,529,653
2012-05-25,1,May,18,0,Fri,1,131,391,522
2012-05-25,1,May,19,0,Fri,1,111,293,404
2012-05-25,1,May,20,0,Fri,1,80,270,350
2012-05-25,1,May,21,0,Fri,1,62,193,255
2012-05-25,1,May,22,0,Fri,1,65,147,212
2012-05-25,1,May,23,0,Fri,1,34,132,166
2012-05-26,1,May,0,0,Sat,0,18,98,116
2012-05-26,1,May,1,0,Sat,0,18,64,82
2012-05-26,1,May,2,0,Sat,0,9,55,64
2012-05-26,1,May,3,0,Sat,0,9,22,31
2012-05-26,1,May,4,0,Sat,0,0,2,2
2012-05-26,1,May,5,0,Sat,0,0,10,10
2012-05-26,1,May,6,0,Sat,0,6,25,31
2012-05-26,1,May,7,0,Sat,0,10,44,54
2012-05-26,1,May,8,0,Sat,0,38,103,141
2012-05-26,1,May,9,0,Sat,0,97,192,289
2012-05-26,1,May,10,0,Sat,0,181,256,437
2012-05-26,1,May,11,0,Sat,0,208,312,520
2012-05-26,1,May,12,0,Sat,0,236,293,529
2012-05-26,1,May,13,0,Sat,0,265,274,539
2012-05-26,1,May,14,0,Sat,0,307,257,564
2012-05-26,1,May,15,0,Sat,0,274,239,513
2012-05-26,1,May,16,0,Sat,0,261,243,504
2012-05-26,1,May,17,0,Sat,0,235,227,462
2012-05-26,1,May,18,0,Sat,0,199,216,415
2012-05-26,1,May,19,0,Sat,0,159,214,373
2012-05-26,1,May,20,0,Sat,0,103,152,255
2012-05-26,1,May,21,0,Sat,0,100,151,251
2012-05-26,1,May,22,0,Sat,0,86,118,204
2012-05-26,1,May,23,0,Sat,0,36,114,150
2012-05-27,1,May,0,0,Sun,0,48,89,137
2012-05-27,1,May,1,0,Sun,0,17,61,78
2012-05-27,1,May,2,0,Sun,0,16,45,61
2012-05-27,1,May,3,0,Sun,0,11,25,36
2012-05-27,1,May,4,0,Sun,0,4,7,11
2012-05-27,1,May,5,0,Sun,0,2,5,7
2012-05-27,1,May,6,0,Sun,0,8,14,22
2012-05-27,1,May,7,0,Sun,0,22,30,52
2012-05-27,1,May,8,0,Sun,0,69,82,151
2012-05-27,1,May,9,0,Sun,0,130,140,270
2012-05-27,1,May,10,0,Sun,0,209,215,424
2012-05-27,1,May,11,0,Sun,0,268,251,519
2012-05-27,1,May,12,0,Sun,0,301,269,570
2012-05-27,1,May,13,0,Sun,0,270,228,498
2012-05-27,1,May,14,0,Sun,0,317,230,547
2012-05-27,1,May,15,0,Sun,0,290,245,535
2012-05-27,1,May,16,0,Sun,0,258,243,501
2012-05-27,1,May,17,0,Sun,0,275,247,522
2012-05-27,1,May,18,0,Sun,0,266,252,518
2012-05-27,1,May,19,0,Sun,0,230,212,442
2012-05-27,1,May,20,0,Sun,0,168,224,392
2012-05-27,1,May,21,0,Sun,0,64,79,143
2012-05-27,1,May,22,0,Sun,0,9,50,59
2012-05-27,1,May,23,0,Sun,0,31,65,96
2012-05-28,1,May,0,1,Mon,0,21,44,65
2012-05-28,1,May,1,1,Mon,0,14,45,59
2012-05-28,1,May,2,1,Mon,0,20,28,48
2012-05-28,1,May,3,1,Mon,0,6,12,18
2012-05-28,1,May,4,1,Mon,0,2,4,6
2012-05-28,1,May,5,1,Mon,0,4,5,9
2012-05-28,1,May,6,1,Mon,0,6,14,20
2012-05-28,1,May,7,1,Mon,0,24,43,67
2012-05-28,1,May,8,1,Mon,0,62,93,155
2012-05-28,1,May,9,1,Mon,0,121,142,263
2012-05-28,1,May,10,1,Mon,0,189,175,364
2012-05-28,1,May,11,1,Mon,0,254,222,476
2012-05-28,1,May,12,1,Mon,0,233,292,525
2012-05-28,1,May,13,1,Mon,0,272,284,556
2012-05-28,1,May,14,1,Mon,0,238,227,465
2012-05-28,1,May,15,1,Mon,0,181,279,460
2012-05-28,1,May,16,1,Mon,0,223,278,501
2012-05-28,1,May,17,1,Mon,0,158,247,405
2012-05-28,1,May,18,1,Mon,0,132,251,383
2012-05-28,1,May,19,1,Mon,0,148,247,395
2012-05-28,1,May,20,1,Mon,0,114,203,317
2012-05-28,1,May,21,1,Mon,0,66,181,247
2012-05-28,1,May,22,1,Mon,0,47,110,157
2012-05-28,1,May,23,1,Mon,0,22,60,82
2012-05-29,1,May,0,0,Tue,1,12,33,45
2012-05-29,1,May,1,0,Tue,1,1,13,14
2012-05-29,1,May,2,0,Tue,1,0,8,8
2012-05-29,1,May,3,0,Tue,1,1,2,3
2012-05-29,1,May,4,0,Tue,1,0,5,5
2012-05-29,1,May,5,0,Tue,1,1,32,33
2012-05-29,1,May,6,0,Tue,1,9,145,154
2012-05-29,1,May,7,0,Tue,1,19,431,450
2012-05-29,1,May,8,0,Tue,1,46,588,634
2012-05-29,1,May,9,0,Tue,1,26,231,257
2012-05-29,1,May,10,0,Tue,1,67,116,183
2012-05-29,1,May,11,0,Tue,1,50,147,197
2012-05-29,1,May,12,0,Tue,1,56,181,237
2012-05-29,1,May,13,0,Tue,1,63,176,239
2012-05-29,1,May,14,0,Tue,1,80,158,238
2012-05-29,1,May,15,0,Tue,1,71,185,256
2012-05-29,1,May,16,0,Tue,1,73,320,393
2012-05-29,1,May,17,0,Tue,1,107,674,781
2012-05-29,1,May,18,0,Tue,1,78,632,710
2012-05-29,1,May,19,0,Tue,1,69,457,526
2012-05-29,1,May,20,0,Tue,1,36,168,204
2012-05-29,1,May,21,0,Tue,1,3,68,71
2012-05-29,1,May,22,0,Tue,1,2,53,55
2012-05-29,1,May,23,0,Tue,1,10,40,50
2012-05-30,1,May,0,0,Wed,1,4,32,36
2012-05-30,1,May,1,0,Wed,1,0,4,4
2012-05-30,1,May,2,0,Wed,1,1,4,5
2012-05-30,1,May,3,0,Wed,1,0,5,5
2012-05-30,1,May,4,0,Wed,1,0,6,6
2012-05-30,1,May,5,0,Wed,1,1,40,41
2012-05-30,1,May,6,0,Wed,1,5,139,144
2012-05-30,1,May,7,0,Wed,1,14,469,483
2012-05-30,1,May,8,0,Wed,1,29,642,671
2012-05-30,1,May,9,0,Wed,1,23,282,305
2012-05-30,1,May,10,0,Wed,1,39,138,177
2012-05-30,1,May,11,0,Wed,1,53,155,208
2012-05-30,1,May,12,0,Wed,1,33,220,253
2012-05-30,1,May,13,0,Wed,1,53,236,289
2012-05-30,1,May,14,0,Wed,1,44,208,252
2012-05-30,1,May,15,0,Wed,1,54,221,275
2012-05-30,1,May,16,0,Wed,1,46,352,398
2012-05-30,1,May,17,0,Wed,1,83,756,839
2012-05-30,1,May,18,0,Wed,1,50,746,796
2012-05-30,1,May,19,0,Wed,1,50,506,556
2012-05-30,1,May,20,0,Wed,1,57,374,431
2012-05-30,1,May,21,0,Wed,1,41,263,304
2012-05-30,1,May,22,0,Wed,1,26,191,217
2012-05-30,1,May,23,0,Wed,1,39,121,160
2012-05-31,1,May,0,0,Thur,1,13,48,61
2012-05-31,1,May,1,0,Thur,1,4,22,26
2012-05-31,1,May,2,0,Thur,1,6,8,14
2012-05-31,1,May,3,0,Thur,1,0,8,8
2012-05-31,1,May,4,0,Thur,1,0,8,8
2012-05-31,1,May,5,0,Thur,1,1,32,33
2012-05-31,1,May,6,0,Thur,1,7,171,178
2012-05-31,1,May,7,0,Thur,1,18,489,507
2012-05-31,1,May,8,0,Thur,1,18,675,693
2012-05-31,1,May,9,0,Thur,1,47,264,311
2012-05-31,1,May,10,0,Thur,1,65,155,220
2012-05-31,1,May,11,0,Thur,1,65,153,218
2012-05-31,1,May,12,0,Thur,1,62,230,292
2012-05-31,1,May,13,0,Thur,1,77,216,293
2012-05-31,1,May,14,0,Thur,1,61,193,254
2012-05-31,1,May,15,0,Thur,1,81,209,290
2012-05-31,1,May,16,0,Thur,1,103,384,487
2012-05-31,1,May,17,0,Thur,1,85,742,827
2012-05-31,1,May,18,0,Thur,1,85,700,785
2012-05-31,1,May,19,0,Thur,1,104,487,591
2012-05-31,1,May,20,0,Thur,1,88,391,479
2012-05-31,1,May,21,0,Thur,1,41,318,359
2012-05-31,1,May,22,0,Thur,1,43,221,264
2012-05-31,1,May,23,0,Thur,1,26,114,140
2012-06-01,1,Jun,0,0,Fri,1,10,76,86
2012-06-01,1,Jun,1,0,Fri,1,0,34,34
2012-06-01,1,Jun,2,0,Fri,1,3,13,16
2012-06-01,1,Jun,3,0,Fri,1,0,4,4
2012-06-01,1,Jun,4,0,Fri,1,1,5,6
2012-06-01,1,Jun,5,0,Fri,1,4,41,45
2012-06-01,1,Jun,6,0,Fri,1,5,136,141
2012-06-01,1,Jun,7,0,Fri,1,33,369,402
2012-06-01,1,Jun,8,0,Fri,1,19,675,694
2012-06-01,1,Jun,9,0,Fri,1,24,274,298
2012-06-01,1,Jun,10,0,Fri,1,49,155,204
2012-06-01,1,Jun,11,0,Fri,1,42,193,235
2012-06-01,1,Jun,12,0,Fri,1,72,238,310
2012-06-01,1,Jun,13,0,Fri,1,76,240,316
2012-06-01,1,Jun,14,0,Fri,1,55,199,254
2012-06-01,1,Jun,15,0,Fri,1,45,213,258
2012-06-01,1,Jun,16,0,Fri,1,36,186,222
2012-06-01,1,Jun,17,0,Fri,1,25,202,227
2012-06-01,1,Jun,18,0,Fri,1,10,100,110
2012-06-01,1,Jun,19,0,Fri,1,4,41,45
2012-06-01,1,Jun,20,0,Fri,1,1,38,39
2012-06-01,1,Jun,21,0,Fri,1,12,73,85
2012-06-01,1,Jun,22,0,Fri,1,1,22,23
2012-06-01,1,Jun,23,0,Fri,1,6,67,73
2012-06-02,1,Jun,0,0,Sat,0,5,81,86
2012-06-02,1,Jun,1,0,Sat,0,15,61,76
2012-06-02,1,Jun,2,0,Sat,0,3,38,41
2012-06-02,1,Jun,3,0,Sat,0,8,18,26
2012-06-02,1,Jun,4,0,Sat,0,2,11,13
2012-06-02,1,Jun,5,0,Sat,0,1,11,12
2012-06-02,1,Jun,6,0,Sat,0,5,31,36
2012-06-02,1,Jun,7,0,Sat,0,9,77,86
2012-06-02,1,Jun,8,0,Sat,0,30,180,210
2012-06-02,1,Jun,9,0,Sat,0,89,243,332
2012-06-02,1,Jun,10,0,Sat,0,145,348,493
2012-06-02,1,Jun,11,0,Sat,0,179,357,536
2012-06-02,1,Jun,12,0,Sat,0,250,418,668
2012-06-02,1,Jun,13,0,Sat,0,279,400,679
2012-06-02,1,Jun,14,0,Sat,0,259,388,647
2012-06-02,1,Jun,15,0,Sat,0,297,405,702
2012-06-02,1,Jun,16,0,Sat,0,275,369,644
2012-06-02,1,Jun,17,0,Sat,0,248,338,586
2012-06-02,1,Jun,18,0,Sat,0,171,341,512
2012-06-02,1,Jun,19,0,Sat,0,185,369,554
2012-06-02,1,Jun,20,0,Sat,0,139,260,399
2012-06-02,1,Jun,21,0,Sat,0,96,220,316
2012-06-02,1,Jun,22,0,Sat,0,52,176,228
2012-06-02,1,Jun,23,0,Sat,0,53,185,238
2012-06-03,1,Jun,0,0,Sun,0,27,142,169
2012-06-03,1,Jun,1,0,Sun,0,21,100,121
2012-06-03,1,Jun,2,0,Sun,0,22,67,89
2012-06-03,1,Jun,3,0,Sun,0,16,34,50
2012-06-03,1,Jun,4,0,Sun,0,1,12,13
2012-06-03,1,Jun,5,0,Sun,0,1,11,12
2012-06-03,1,Jun,6,0,Sun,0,6,16,22
2012-06-03,1,Jun,7,0,Sun,0,6,29,35
2012-06-03,1,Jun,8,0,Sun,0,30,110,140
2012-06-03,1,Jun,9,0,Sun,0,70,230,300
2012-06-03,1,Jun,10,0,Sun,0,127,277,404
2012-06-03,1,Jun,11,0,Sun,0,199,312,511
2012-06-03,1,Jun,12,0,Sun,0,276,408,684
2012-06-03,1,Jun,13,0,Sun,0,265,421,686
2012-06-03,1,Jun,14,0,Sun,0,267,411,678
2012-06-03,1,Jun,15,0,Sun,0,236,408,644
2012-06-03,1,Jun,16,0,Sun,0,226,436,662
2012-06-03,1,Jun,17,0,Sun,0,192,386,578
2012-06-03,1,Jun,18,0,Sun,0,153,343,496
2012-06-03,1,Jun,19,0,Sun,0,116,337,453
2012-06-03,1,Jun,20,0,Sun,0,84,230,314
2012-06-03,1,Jun,21,0,Sun,0,66,180,246
2012-06-03,1,Jun,22,0,Sun,0,61,165,226
2012-06-03,1,Jun,23,0,Sun,0,26,82,108
2012-06-04,1,Jun,0,0,Mon,1,11,38,49
2012-06-04,1,Jun,1,0,Mon,1,4,10,14
2012-06-04,1,Jun,2,0,Mon,1,1,10,11
2012-06-04,1,Jun,3,0,Mon,1,0,5,5
2012-06-04,1,Jun,4,0,Mon,1,2,6,8
2012-06-04,1,Jun,5,0,Mon,1,2,33,35
2012-06-04,1,Jun,6,0,Mon,1,4,135,139
2012-06-04,1,Jun,7,0,Mon,1,13,504,517
2012-06-04,1,Jun,8,0,Mon,1,22,643,665
2012-06-04,1,Jun,9,0,Mon,1,38,244,282
2012-06-04,1,Jun,10,0,Mon,1,67,120,187
2012-06-04,1,Jun,11,0,Mon,1,71,168,239
2012-06-04,1,Jun,12,0,Mon,1,62,220,282
2012-06-04,1,Jun,13,0,Mon,1,85,189,274
2012-06-04,1,Jun,14,0,Mon,1,84,186,270
2012-06-04,1,Jun,15,0,Mon,1,77,215,292
2012-06-04,1,Jun,16,0,Mon,1,73,375,448
2012-06-04,1,Jun,17,0,Mon,1,101,733,834
2012-06-04,1,Jun,18,0,Mon,1,103,719,822
2012-06-04,1,Jun,19,0,Mon,1,91,554,645
2012-06-04,1,Jun,20,0,Mon,1,71,390,461
2012-06-04,1,Jun,21,0,Mon,1,40,225,265
2012-06-04,1,Jun,22,0,Mon,1,41,127,168
2012-06-04,1,Jun,23,0,Mon,1,8,78,86
2012-06-05,1,Jun,0,0,Tue,1,6,28,34
2012-06-05,1,Jun,1,0,Tue,1,2,18,20
2012-06-05,1,Jun,2,0,Tue,1,0,8,8
2012-06-05,1,Jun,3,0,Tue,1,0,5,5
2012-06-05,1,Jun,4,0,Tue,1,1,4,5
2012-06-05,1,Jun,5,0,Tue,1,1,35,36
2012-06-05,1,Jun,6,0,Tue,1,7,177,184
2012-06-05,1,Jun,7,0,Tue,1,29,540,569
2012-06-05,1,Jun,8,0,Tue,1,30,680,710
2012-06-05,1,Jun,9,0,Tue,1,50,285,335
2012-06-05,1,Jun,10,0,Tue,1,58,118,176
2012-06-05,1,Jun,11,0,Tue,1,65,162,227
2012-06-05,1,Jun,12,0,Tue,1,45,202,247
2012-06-05,1,Jun,13,0,Tue,1,66,201,267
2012-06-05,1,Jun,14,0,Tue,1,82,194,276
2012-06-05,1,Jun,15,0,Tue,1,54,218,272
2012-06-05,1,Jun,16,0,Tue,1,91,382,473
2012-06-05,1,Jun,17,0,Tue,1,86,764,850
2012-06-05,1,Jun,18,0,Tue,1,111,679,790
2012-06-05,1,Jun,19,0,Tue,1,68,445,513
2012-06-05,1,Jun,20,0,Tue,1,44,371,415
2012-06-05,1,Jun,21,0,Tue,1,30,253,283
2012-06-05,1,Jun,22,0,Tue,1,22,171,193
2012-06-05,1,Jun,23,0,Tue,1,20,93,113
2012-06-06,1,Jun,0,0,Wed,1,3,46,49
2012-06-06,1,Jun,1,0,Wed,1,6,21,27
2012-06-06,1,Jun,2,0,Wed,1,4,7,11
2012-06-06,1,Jun,3,0,Wed,1,0,8,8
2012-06-06,1,Jun,4,0,Wed,1,3,7,10
2012-06-06,1,Jun,5,0,Wed,1,1,37,38
2012-06-06,1,Jun,6,0,Wed,1,7,165,172
2012-06-06,1,Jun,7,0,Wed,1,16,531,547
2012-06-06,1,Jun,8,0,Wed,1,31,637,668
2012-06-06,1,Jun,9,0,Wed,1,35,268,303
2012-06-06,1,Jun,10,0,Wed,1,55,148,203
2012-06-06,1,Jun,11,0,Wed,1,65,161,226
2012-06-06,1,Jun,12,0,Wed,1,80,235,315
2012-06-06,1,Jun,13,0,Wed,1,73,230,303
2012-06-06,1,Jun,14,0,Wed,1,111,191,302
2012-06-06,1,Jun,15,0,Wed,1,75,225,300
2012-06-06,1,Jun,16,0,Wed,1,107,345,452
2012-06-06,1,Jun,17,0,Wed,1,72,652,724
2012-06-06,1,Jun,18,0,Wed,1,94,688,782
2012-06-06,1,Jun,19,0,Wed,1,52,486,538
2012-06-06,1,Jun,20,0,Wed,1,59,349,408
2012-06-06,1,Jun,21,0,Wed,1,38,260,298
2012-06-06,1,Jun,22,0,Wed,1,27,221,248
2012-06-06,1,Jun,23,0,Wed,1,13,110,123
2012-06-07,1,Jun,0,0,Thur,1,9,50,59
2012-06-07,1,Jun,1,0,Thur,1,5,17,22
2012-06-07,1,Jun,2,0,Thur,1,0,12,12
2012-06-07,1,Jun,3,0,Thur,1,0,5,5
2012-06-07,1,Jun,4,0,Thur,1,0,6,6
2012-06-07,1,Jun,5,0,Thur,1,0,34,34
2012-06-07,1,Jun,6,0,Thur,1,5,165,170
2012-06-07,1,Jun,7,0,Thur,1,20,506,526
2012-06-07,1,Jun,8,0,Thur,1,20,661,681
2012-06-07,1,Jun,9,0,Thur,1,37,300,337
2012-06-07,1,Jun,10,0,Thur,1,56,154,210
2012-06-07,1,Jun,11,0,Thur,1,67,170,237
2012-06-07,1,Jun,12,0,Thur,1,62,274,336
2012-06-07,1,Jun,13,0,Thur,1,65,250,315
2012-06-07,1,Jun,14,0,Thur,1,67,198,265
2012-06-07,1,Jun,15,0,Thur,1,99,234,333
2012-06-07,1,Jun,16,0,Thur,1,77,389,466
2012-06-07,1,Jun,17,0,Thur,1,91,778,869
2012-06-07,1,Jun,18,0,Thur,1,110,703,813
2012-06-07,1,Jun,19,0,Thur,1,65,537,602
2012-06-07,1,Jun,20,0,Thur,1,76,402,478
2012-06-07,1,Jun,21,0,Thur,1,30,283,313
2012-06-07,1,Jun,22,0,Thur,1,35,193,228
2012-06-07,1,Jun,23,0,Thur,1,42,135,177
2012-06-08,1,Jun,0,0,Fri,1,18,59,77
2012-06-08,1,Jun,1,0,Fri,1,4,25,29
2012-06-08,1,Jun,2,0,Fri,1,2,17,19
2012-06-08,1,Jun,3,0,Fri,1,0,8,8
2012-06-08,1,Jun,4,0,Fri,1,1,9,10
2012-06-08,1,Jun,5,0,Fri,1,1,28,29
2012-06-08,1,Jun,6,0,Fri,1,8,131,139
2012-06-08,1,Jun,7,0,Fri,1,19,409,428
2012-06-08,1,Jun,8,0,Fri,1,37,663,700
2012-06-08,1,Jun,9,0,Fri,1,47,335,382
2012-06-08,1,Jun,10,0,Fri,1,62,187,249
2012-06-08,1,Jun,11,0,Fri,1,65,199,264
2012-06-08,1,Jun,12,0,Fri,1,89,280,369
2012-06-08,1,Jun,13,0,Fri,1,129,287,416
2012-06-08,1,Jun,14,0,Fri,1,128,245,373
2012-06-08,1,Jun,15,0,Fri,1,98,299,397
2012-06-08,1,Jun,16,0,Fri,1,111,412,523
2012-06-08,1,Jun,17,0,Fri,1,114,679,793
2012-06-08,1,Jun,18,0,Fri,1,147,576,723
2012-06-08,1,Jun,19,0,Fri,1,95,460,555
2012-06-08,1,Jun,20,0,Fri,1,117,291,408
2012-06-08,1,Jun,21,0,Fri,1,83,256,339
2012-06-08,1,Jun,22,0,Fri,1,61,230,291
2012-06-08,1,Jun,23,0,Fri,1,52,163,215
2012-06-09,1,Jun,0,0,Sat,0,54,152,206
2012-06-09,1,Jun,1,0,Sat,0,34,89,123
2012-06-09,1,Jun,2,0,Sat,0,21,68,89
2012-06-09,1,Jun,3,0,Sat,0,12,28,40
2012-06-09,1,Jun,4,0,Sat,0,2,6,8
2012-06-09,1,Jun,5,0,Sat,0,4,15,19
2012-06-09,1,Jun,6,0,Sat,0,17,63,80
2012-06-09,1,Jun,7,0,Sat,0,26,61,87
2012-06-09,1,Jun,8,0,Sat,0,42,202,244
2012-06-09,1,Jun,9,0,Sat,0,99,241,340
2012-06-09,1,Jun,10,0,Sat,0,168,298,466
2012-06-09,1,Jun,11,0,Sat,0,218,351,569
2012-06-09,1,Jun,12,0,Sat,0,196,335,531
2012-06-09,1,Jun,13,0,Sat,0,236,349,585
2012-06-09,1,Jun,14,0,Sat,0,239,354,593
2012-06-09,1,Jun,15,0,Sat,0,218,337,555
2012-06-09,1,Jun,16,0,Sat,0,219,315,534
2012-06-09,1,Jun,17,0,Sat,0,238,257,495
2012-06-09,1,Jun,18,0,Sat,0,175,276,451
2012-06-09,1,Jun,19,0,Sat,0,128,232,360
2012-06-09,1,Jun,20,0,Sat,0,125,238,363
2012-06-09,1,Jun,21,0,Sat,0,105,211,316
2012-06-09,1,Jun,22,0,Sat,0,63,151,214
2012-06-09,1,Jun,23,0,Sat,0,69,161,230
2012-06-10,1,Jun,0,0,Sun,0,33,125,158
2012-06-10,1,Jun,1,0,Sun,0,32,84,116
2012-06-10,1,Jun,2,0,Sun,0,17,56,73
2012-06-10,1,Jun,3,0,Sun,0,6,23,29
2012-06-10,1,Jun,4,0,Sun,0,1,9,10
2012-06-10,1,Jun,5,0,Sun,0,3,10,13
2012-06-10,1,Jun,6,0,Sun,0,3,27,30
2012-06-10,1,Jun,7,0,Sun,0,21,41,62
2012-06-10,1,Jun,8,0,Sun,0,59,122,181
2012-06-10,1,Jun,9,0,Sun,0,91,175,266
2012-06-10,1,Jun,10,0,Sun,0,148,265,413
2012-06-10,1,Jun,11,0,Sun,0,184,315,499
2012-06-10,1,Jun,12,0,Sun,0,173,329,502
2012-06-10,1,Jun,13,0,Sun,0,204,288,492
2012-06-10,1,Jun,14,0,Sun,0,186,314,500
2012-06-10,1,Jun,15,0,Sun,0,159,316,475
2012-06-10,1,Jun,16,0,Sun,0,173,335,508
2012-06-10,1,Jun,17,0,Sun,0,184,337,521
2012-06-10,1,Jun,18,0,Sun,0,164,326,490
2012-06-10,1,Jun,19,0,Sun,0,115,260,375
2012-06-10,1,Jun,20,0,Sun,0,113,250,363
2012-06-10,1,Jun,21,0,Sun,0,83,170,253
2012-06-10,1,Jun,22,0,Sun,0,42,117,159
2012-06-10,1,Jun,23,0,Sun,0,30,80,110
2012-06-11,1,Jun,0,0,Mon,1,8,33,41
2012-06-11,1,Jun,1,0,Mon,1,9,15,24
2012-06-11,1,Jun,2,0,Mon,1,5,12,17
2012-06-11,1,Jun,3,0,Mon,1,2,4,6
2012-06-11,1,Jun,4,0,Mon,1,0,7,7
2012-06-11,1,Jun,5,0,Mon,1,1,36,37
2012-06-11,1,Jun,6,0,Mon,1,8,136,144
2012-06-11,1,Jun,7,0,Mon,1,25,478,503
2012-06-11,1,Jun,8,0,Mon,1,38,613,651
2012-06-11,1,Jun,9,0,Mon,1,57,259,316
2012-06-11,1,Jun,10,0,Mon,1,52,95,147
2012-06-11,1,Jun,11,0,Mon,1,59,143,202
2012-06-11,1,Jun,12,0,Mon,1,63,198,261
2012-06-11,1,Jun,13,0,Mon,1,63,185,248
2012-06-11,1,Jun,14,0,Mon,1,66,193,259
2012-06-11,1,Jun,15,0,Mon,1,72,187,259
2012-06-11,1,Jun,16,0,Mon,1,87,340,427
2012-06-11,1,Jun,17,0,Mon,1,85,715,800
2012-06-11,1,Jun,18,0,Mon,1,105,726,831
2012-06-11,1,Jun,19,0,Mon,1,89,507,596
2012-06-11,1,Jun,20,0,Mon,1,61,333,394
2012-06-11,1,Jun,21,0,Mon,1,32,218,250
2012-06-11,1,Jun,22,0,Mon,1,22,142,164
2012-06-11,1,Jun,23,0,Mon,1,8,72,80
2012-06-12,1,Jun,0,0,Tue,1,2,26,28
2012-06-12,1,Jun,1,0,Tue,1,5,11,16
2012-06-12,1,Jun,2,0,Tue,1,0,6,6
2012-06-12,1,Jun,3,0,Tue,1,3,9,12
2012-06-12,1,Jun,4,0,Tue,1,0,4,4
2012-06-12,1,Jun,5,0,Tue,1,1,28,29
2012-06-12,1,Jun,6,0,Tue,1,6,130,136
2012-06-12,1,Jun,7,0,Tue,1,16,287,303
2012-06-12,1,Jun,8,0,Tue,1,15,598,613
2012-06-12,1,Jun,9,0,Tue,1,31,254,285
2012-06-12,1,Jun,10,0,Tue,1,29,96,125
2012-06-12,1,Jun,11,0,Tue,1,8,57,65
2012-06-12,1,Jun,12,0,Tue,1,19,76,95
2012-06-12,1,Jun,13,0,Tue,1,11,48,59
2012-06-12,1,Jun,14,0,Tue,1,12,48,60
2012-06-12,1,Jun,15,0,Tue,1,22,94,116
2012-06-12,1,Jun,16,0,Tue,1,30,209,239
2012-06-12,1,Jun,17,0,Tue,1,56,625,681
2012-06-12,1,Jun,18,0,Tue,1,57,596,653
2012-06-12,1,Jun,19,0,Tue,1,47,444,491
2012-06-12,1,Jun,20,0,Tue,1,36,350,386
2012-06-12,1,Jun,21,0,Tue,1,41,233,274
2012-06-12,1,Jun,22,0,Tue,1,19,188,207
2012-06-12,1,Jun,23,0,Tue,1,11,78,89
2012-06-13,1,Jun,0,0,Wed,1,7,27,34
2012-06-13,1,Jun,1,0,Wed,1,7,21,28
2012-06-13,1,Jun,2,0,Wed,1,0,4,4
2012-06-13,1,Jun,3,0,Wed,1,1,7,8
2012-06-13,1,Jun,4,0,Wed,1,1,9,10
2012-06-13,1,Jun,5,0,Wed,1,2,38,40
2012-06-13,1,Jun,6,0,Wed,1,6,188,194
2012-06-13,1,Jun,7,0,Wed,1,25,480,505
2012-06-13,1,Jun,8,0,Wed,1,41,672,713
2012-06-13,1,Jun,9,0,Wed,1,54,298,352
2012-06-13,1,Jun,10,0,Wed,1,64,134,198
2012-06-13,1,Jun,11,0,Wed,1,64,182,246
2012-06-13,1,Jun,12,0,Wed,1,93,241,334
2012-06-13,1,Jun,13,0,Wed,1,52,203,255
2012-06-13,1,Jun,14,0,Wed,1,98,222,320
2012-06-13,1,Jun,15,0,Wed,1,65,216,281
2012-06-13,1,Jun,16,0,Wed,1,72,320,392
2012-06-13,1,Jun,17,0,Wed,1,75,782,857
2012-06-13,1,Jun,18,0,Wed,1,104,640,744
2012-06-13,1,Jun,19,0,Wed,1,123,548,671
2012-06-13,1,Jun,20,0,Wed,1,86,362,448
2012-06-13,1,Jun,21,0,Wed,1,79,317,396
2012-06-13,1,Jun,22,0,Wed,1,29,209,238
2012-06-13,1,Jun,23,0,Wed,1,25,128,153
2012-06-14,1,Jun,0,0,Thur,1,3,45,48
2012-06-14,1,Jun,1,0,Thur,1,4,17,21
2012-06-14,1,Jun,2,0,Thur,1,1,8,9
2012-06-14,1,Jun,3,0,Thur,1,1,4,5
2012-06-14,1,Jun,4,0,Thur,1,0,6,6
2012-06-14,1,Jun,5,0,Thur,1,0,40,40
2012-06-14,1,Jun,6,0,Thur,1,12,169,181
2012-06-14,1,Jun,7,0,Thur,1,26,480,506
2012-06-14,1,Jun,8,0,Thur,1,37,682,719
2012-06-14,1,Jun,9,0,Thur,1,45,312,357
2012-06-14,1,Jun,10,0,Thur,1,47,132,179
2012-06-14,1,Jun,11,0,Thur,1,60,168,228
2012-06-14,1,Jun,12,0,Thur,1,55,210,265
2012-06-14,1,Jun,13,0,Thur,1,71,213,284
2012-06-14,1,Jun,14,0,Thur,1,84,214,298
2012-06-14,1,Jun,15,0,Thur,1,111,213,324
2012-06-14,1,Jun,16,0,Thur,1,70,368,438
2012-06-14,1,Jun,17,0,Thur,1,117,750,867
2012-06-14,1,Jun,18,0,Thur,1,107,716,823
2012-06-14,1,Jun,19,0,Thur,1,96,483,579
2012-06-14,1,Jun,20,0,Thur,1,84,351,435
2012-06-14,1,Jun,21,0,Thur,1,67,270,337
2012-06-14,1,Jun,22,0,Thur,1,46,196,242
2012-06-14,1,Jun,23,0,Thur,1,36,136,172
2012-06-15,1,Jun,0,0,Fri,1,26,68,94
2012-06-15,1,Jun,1,0,Fri,1,9,42,51
2012-06-15,1,Jun,2,0,Fri,1,0,15,15
2012-06-15,1,Jun,3,0,Fri,1,2,3,5
2012-06-15,1,Jun,4,0,Fri,1,1,13,14
2012-06-15,1,Jun,5,0,Fri,1,2,31,33
2012-06-15,1,Jun,6,0,Fri,1,9,142,151
2012-06-15,1,Jun,7,0,Fri,1,17,413,430
2012-06-15,1,Jun,8,0,Fri,1,44,609,653
2012-06-15,1,Jun,9,0,Fri,1,58,308,366
2012-06-15,1,Jun,10,0,Fri,1,56,160,216
2012-06-15,1,Jun,11,0,Fri,1,106,180,286
2012-06-15,1,Jun,12,0,Fri,1,111,292,403
2012-06-15,1,Jun,13,0,Fri,1,121,272,393
2012-06-15,1,Jun,14,0,Fri,1,121,255,376
2012-06-15,1,Jun,15,0,Fri,1,107,270,377
2012-06-15,1,Jun,16,0,Fri,1,132,426,558
2012-06-15,1,Jun,17,0,Fri,1,125,698,823
2012-06-15,1,Jun,18,0,Fri,1,121,572,693
2012-06-15,1,Jun,19,0,Fri,1,98,369,467
2012-06-15,1,Jun,20,0,Fri,1,89,296,385
2012-06-15,1,Jun,21,0,Fri,1,83,250,333
2012-06-15,1,Jun,22,0,Fri,1,79,242,321
2012-06-15,1,Jun,23,0,Fri,1,46,176,222
2012-06-16,1,Jun,0,0,Sat,0,25,112,137
2012-06-16,1,Jun,1,0,Sat,0,16,79,95
2012-06-16,1,Jun,2,0,Sat,0,12,55,67
2012-06-16,1,Jun,3,0,Sat,0,8,19,27
2012-06-16,1,Jun,4,0,Sat,0,3,5,8
2012-06-16,1,Jun,5,0,Sat,0,2,21,23
2012-06-16,1,Jun,6,0,Sat,0,11,36,47
2012-06-16,1,Jun,7,0,Sat,0,10,68,78
2012-06-16,1,Jun,8,0,Sat,0,47,157,204
2012-06-16,1,Jun,9,0,Sat,0,88,279,367
2012-06-16,1,Jun,10,0,Sat,0,139,296,435
2012-06-16,1,Jun,11,0,Sat,0,213,353,566
2012-06-16,1,Jun,12,0,Sat,0,254,349,603
2012-06-16,1,Jun,13,0,Sat,0,293,324,617
2012-06-16,1,Jun,14,0,Sat,0,264,309,573
2012-06-16,1,Jun,15,0,Sat,0,295,288,583
2012-06-16,1,Jun,16,0,Sat,0,238,304,542
2012-06-16,1,Jun,17,0,Sat,0,244,349,593
2012-06-16,1,Jun,18,0,Sat,0,256,315,571
2012-06-16,1,Jun,19,0,Sat,0,184,277,461
2012-06-16,1,Jun,20,0,Sat,0,123,229,352
2012-06-16,1,Jun,21,0,Sat,0,98,192,290
2012-06-16,1,Jun,22,0,Sat,0,91,189,280
2012-06-16,1,Jun,23,0,Sat,0,49,134,183
2012-06-17,1,Jun,0,0,Sun,0,31,117,148
2012-06-17,1,Jun,1,0,Sun,0,21,67,88
2012-06-17,1,Jun,2,0,Sun,0,19,55,74
2012-06-17,1,Jun,3,0,Sun,0,6,22,28
2012-06-17,1,Jun,4,0,Sun,0,2,16,18
2012-06-17,1,Jun,5,0,Sun,0,4,13,17
2012-06-17,1,Jun,6,0,Sun,0,7,16,23
2012-06-17,1,Jun,7,0,Sun,0,18,30,48
2012-06-17,1,Jun,8,0,Sun,0,24,95,119
2012-06-17,1,Jun,9,0,Sun,0,91,183,274
2012-06-17,1,Jun,10,0,Sun,0,148,288,436
2012-06-17,1,Jun,11,0,Sun,0,196,350,546
2012-06-17,1,Jun,12,0,Sun,0,260,355,615
2012-06-17,1,Jun,13,0,Sun,0,267,347,614
2012-06-17,1,Jun,14,0,Sun,0,255,327,582
2012-06-17,1,Jun,15,0,Sun,0,203,260,463
2012-06-17,1,Jun,16,0,Sun,0,240,340,580
2012-06-17,1,Jun,17,0,Sun,0,232,361,593
2012-06-17,1,Jun,18,0,Sun,0,203,310,513
2012-06-17,1,Jun,19,0,Sun,0,146,244,390
2012-06-17,1,Jun,20,0,Sun,0,101,201,302
2012-06-17,1,Jun,21,0,Sun,0,76,170,246
2012-06-17,1,Jun,22,0,Sun,0,55,98,153
2012-06-17,1,Jun,23,0,Sun,0,29,79,108
2012-06-18,1,Jun,0,0,Mon,1,12,28,40
2012-06-18,1,Jun,1,0,Mon,1,9,5,14
2012-06-18,1,Jun,2,0,Mon,1,3,6,9
2012-06-18,1,Jun,3,0,Mon,1,1,3,4
2012-06-18,1,Jun,4,0,Mon,1,0,9,9
2012-06-18,1,Jun,5,0,Mon,1,1,22,23
2012-06-18,1,Jun,6,0,Mon,1,0,37,37
2012-06-18,1,Jun,7,0,Mon,1,10,135,145
2012-06-18,1,Jun,8,0,Mon,1,27,447,474
2012-06-18,1,Jun,9,0,Mon,1,28,222,250
2012-06-18,1,Jun,10,0,Mon,1,13,78,91
2012-06-18,1,Jun,11,0,Mon,1,25,96,121
2012-06-18,1,Jun,12,0,Mon,1,29,139,168
2012-06-18,1,Jun,13,0,Mon,1,51,174,225
2012-06-18,1,Jun,14,0,Mon,1,59,160,219
2012-06-18,1,Jun,15,0,Mon,1,61,176,237
2012-06-18,1,Jun,16,0,Mon,1,53,279,332
2012-06-18,1,Jun,17,0,Mon,1,54,669,723
2012-06-18,1,Jun,18,0,Mon,1,47,595,642
2012-06-18,1,Jun,19,0,Mon,1,52,411,463
2012-06-18,1,Jun,20,0,Mon,1,45,317,362
2012-06-18,1,Jun,21,0,Mon,1,35,238,273
2012-06-18,1,Jun,22,0,Mon,1,21,143,164
2012-06-18,1,Jun,23,0,Mon,1,17,57,74
2012-06-19,1,Jun,0,0,Tue,1,5,30,35
2012-06-19,1,Jun,1,0,Tue,1,1,13,14
2012-06-19,1,Jun,2,0,Tue,1,1,14,15
2012-06-19,1,Jun,3,0,Tue,1,1,7,8
2012-06-19,1,Jun,4,0,Tue,1,1,9,10
2012-06-19,1,Jun,5,0,Tue,1,3,34,37
2012-06-19,1,Jun,6,0,Tue,1,9,152,161
2012-06-19,1,Jun,7,0,Tue,1,18,462,480
2012-06-19,1,Jun,8,0,Tue,1,40,633,673
2012-06-19,1,Jun,9,0,Tue,1,40,288,328
2012-06-19,1,Jun,10,0,Tue,1,44,136,180
2012-06-19,1,Jun,11,0,Tue,1,56,174,230
2012-06-19,1,Jun,12,0,Tue,1,70,222,292
2012-06-19,1,Jun,13,0,Tue,1,69,203,272
2012-06-19,1,Jun,14,0,Tue,1,61,166,227
2012-06-19,1,Jun,15,0,Tue,1,72,187,259
2012-06-19,1,Jun,16,0,Tue,1,48,286,334
2012-06-19,1,Jun,17,0,Tue,1,86,725,811
2012-06-19,1,Jun,18,0,Tue,1,91,704,795
2012-06-19,1,Jun,19,0,Tue,1,82,432,514
2012-06-19,1,Jun,20,0,Tue,1,59,399,458
2012-06-19,1,Jun,21,0,Tue,1,37,239,276
2012-06-19,1,Jun,22,0,Tue,1,51,240,291
2012-06-19,1,Jun,23,0,Tue,1,23,102,125
2012-06-20,1,Jun,0,0,Wed,1,5,48,53
2012-06-20,1,Jun,1,0,Wed,1,7,20,27
2012-06-20,1,Jun,2,0,Wed,1,1,5,6
2012-06-20,1,Jun,3,0,Wed,1,2,6,8
2012-06-20,1,Jun,4,0,Wed,1,1,6,7
2012-06-20,1,Jun,5,0,Wed,1,2,37,39
2012-06-20,1,Jun,6,0,Wed,1,9,156,165
2012-06-20,1,Jun,7,0,Wed,1,20,444,464
2012-06-20,1,Jun,8,0,Wed,1,43,600,643
2012-06-20,1,Jun,9,0,Wed,1,40,276,316
2012-06-20,1,Jun,10,0,Wed,1,41,126,167
2012-06-20,1,Jun,11,0,Wed,1,54,134,188
2012-06-20,1,Jun,12,0,Wed,1,30,150,180
2012-06-20,1,Jun,13,0,Wed,1,48,163,211
2012-06-20,1,Jun,14,0,Wed,1,56,134,190
2012-06-20,1,Jun,15,0,Wed,1,36,143,179
2012-06-20,1,Jun,16,0,Wed,1,51,284,335
2012-06-20,1,Jun,17,0,Wed,1,80,611,691
2012-06-20,1,Jun,18,0,Wed,1,81,591,672
2012-06-20,1,Jun,19,0,Wed,1,90,449,539
2012-06-20,1,Jun,20,0,Wed,1,81,326,407
2012-06-20,1,Jun,21,0,Wed,1,42,302,344
2012-06-20,1,Jun,22,0,Wed,1,31,226,257
2012-06-20,1,Jun,23,0,Wed,1,21,102,123
2012-06-21,1,Jun,0,0,Thur,1,16,53,69
2012-06-21,1,Jun,1,0,Thur,1,2,16,18
2012-06-21,1,Jun,2,0,Thur,1,11,7,18
2012-06-21,1,Jun,3,0,Thur,1,3,8,11
2012-06-21,1,Jun,4,0,Thur,1,1,11,12
2012-06-21,1,Jun,5,0,Thur,1,3,37,40
2012-06-21,1,Jun,6,0,Thur,1,3,147,150
2012-06-21,1,Jun,7,0,Thur,1,26,437,463
2012-06-21,1,Jun,8,0,Thur,1,27,563,590
2012-06-21,1,Jun,9,0,Thur,1,32,224,256
2012-06-21,1,Jun,10,0,Thur,1,36,114,150
2012-06-21,1,Jun,11,0,Thur,1,40,121,161
2012-06-21,1,Jun,12,0,Thur,1,33,182,215
2012-06-21,1,Jun,13,0,Thur,1,31,141,172
2012-06-21,1,Jun,14,0,Thur,1,27,149,176
2012-06-21,1,Jun,15,0,Thur,1,40,154,194
2012-06-21,1,Jun,16,0,Thur,1,37,283,320
2012-06-21,1,Jun,17,0,Thur,1,80,535,615
2012-06-21,1,Jun,18,0,Thur,1,78,562,640
2012-06-21,1,Jun,19,0,Thur,1,84,415,499
2012-06-21,1,Jun,20,0,Thur,1,79,357,436
2012-06-21,1,Jun,21,0,Thur,1,55,256,311
2012-06-21,1,Jun,22,0,Thur,1,22,221,243
2012-06-21,1,Jun,23,0,Thur,1,12,134,146
2012-06-22,1,Jun,0,0,Fri,1,16,77,93
2012-06-22,1,Jun,1,0,Fri,1,3,28,31
2012-06-22,1,Jun,2,0,Fri,1,0,12,12
2012-06-22,1,Jun,3,0,Fri,1,1,6,7
2012-06-22,1,Jun,4,0,Fri,1,3,7,10
2012-06-22,1,Jun,5,0,Fri,1,3,35,38
2012-06-22,1,Jun,6,0,Fri,1,4,118,122
2012-06-22,1,Jun,7,0,Fri,1,19,340,359
2012-06-22,1,Jun,8,0,Fri,1,49,564,613
2012-06-22,1,Jun,9,0,Fri,1,55,278,333
2012-06-22,1,Jun,10,0,Fri,1,52,133,185
2012-06-22,1,Jun,11,0,Fri,1,76,160,236
2012-06-22,1,Jun,12,0,Fri,1,63,191,254
2012-06-22,1,Jun,13,0,Fri,1,72,228,300
2012-06-22,1,Jun,14,0,Fri,1,65,198,263
2012-06-22,1,Jun,15,0,Fri,1,72,212,284
2012-06-22,1,Jun,16,0,Fri,1,67,313,380
2012-06-22,1,Jun,17,0,Fri,1,95,551,646
2012-06-22,1,Jun,18,0,Fri,1,62,443,505
2012-06-22,1,Jun,19,0,Fri,1,45,317,362
2012-06-22,1,Jun,20,0,Fri,1,31,171,202
2012-06-22,1,Jun,21,0,Fri,1,40,177,217
2012-06-22,1,Jun,22,0,Fri,1,42,155,197
2012-06-22,1,Jun,23,0,Fri,1,29,145,174
2012-06-23,1,Jun,0,0,Sat,0,14,102,116
2012-06-23,1,Jun,1,0,Sat,0,16,107,123
2012-06-23,1,Jun,2,0,Sat,0,18,75,93
2012-06-23,1,Jun,3,0,Sat,0,10,32,42
2012-06-23,1,Jun,4,0,Sat,0,6,13,19
2012-06-23,1,Jun,5,0,Sat,0,1,11,12
2012-06-23,1,Jun,6,0,Sat,0,10,37,47
2012-06-23,1,Jun,7,0,Sat,0,19,59,78
2012-06-23,1,Jun,8,0,Sat,0,34,133,167
2012-06-23,1,Jun,9,0,Sat,0,85,247,332
2012-06-23,1,Jun,10,0,Sat,0,177,317,494
2012-06-23,1,Jun,11,0,Sat,0,167,349,516
2012-06-23,1,Jun,12,0,Sat,0,203,399,602
2012-06-23,1,Jun,13,0,Sat,0,226,338,564
2012-06-23,1,Jun,14,0,Sat,0,238,371,609
2012-06-23,1,Jun,15,0,Sat,0,217,266,483
2012-06-23,1,Jun,16,0,Sat,0,196,317,513
2012-06-23,1,Jun,17,0,Sat,0,214,316,530
2012-06-23,1,Jun,18,0,Sat,0,194,287,481
2012-06-23,1,Jun,19,0,Sat,0,185,240,425
2012-06-23,1,Jun,20,0,Sat,0,158,228,386
2012-06-23,1,Jun,21,0,Sat,0,99,223,322
2012-06-23,1,Jun,22,0,Sat,0,101,178,279
2012-06-23,1,Jun,23,0,Sat,0,69,156,225
2012-06-24,1,Jun,0,0,Sun,0,31,132,163
2012-06-24,1,Jun,1,0,Sun,0,39,88,127
2012-06-24,1,Jun,2,0,Sun,0,34,80,114
2012-06-24,1,Jun,3,0,Sun,0,19,41,60
2012-06-24,1,Jun,4,0,Sun,0,4,9,13
2012-06-24,1,Jun,5,0,Sun,0,1,7,8
2012-06-24,1,Jun,6,0,Sun,0,6,19,25
2012-06-24,1,Jun,7,0,Sun,0,23,48,71
2012-06-24,1,Jun,8,0,Sun,0,38,103,141
2012-06-24,1,Jun,9,0,Sun,0,63,169,232
2012-06-24,1,Jun,10,0,Sun,0,161,291,452
2012-06-24,1,Jun,11,0,Sun,0,215,291,506
2012-06-24,1,Jun,12,0,Sun,0,227,329,556
2012-06-24,1,Jun,13,0,Sun,0,237,348,585
2012-06-24,1,Jun,14,0,Sun,0,253,298,551
2012-06-24,1,Jun,15,0,Sun,0,197,290,487
2012-06-24,1,Jun,16,0,Sun,0,181,280,461
2012-06-24,1,Jun,17,0,Sun,0,203,329,532
2012-06-24,1,Jun,18,0,Sun,0,186,348,534
2012-06-24,1,Jun,19,0,Sun,0,176,247,423
2012-06-24,1,Jun,20,0,Sun,0,108,224,332
2012-06-24,1,Jun,21,0,Sun,0,76,177,253
2012-06-24,1,Jun,22,0,Sun,0,53,125,178
2012-06-24,1,Jun,23,0,Sun,0,20,67,87
2012-06-25,1,Jun,0,0,Mon,1,31,37,68
2012-06-25,1,Jun,1,0,Mon,1,11,20,31
2012-06-25,1,Jun,2,0,Mon,1,4,10,14
2012-06-25,1,Jun,3,0,Mon,1,1,4,5
2012-06-25,1,Jun,4,0,Mon,1,0,4,4
2012-06-25,1,Jun,5,0,Mon,1,1,42,43
2012-06-25,1,Jun,6,0,Mon,1,11,147,158
2012-06-25,1,Jun,7,0,Mon,1,30,455,485
2012-06-25,1,Jun,8,0,Mon,1,53,555,608
2012-06-25,1,Jun,9,0,Mon,1,37,231,268
2012-06-25,1,Jun,10,0,Mon,1,58,126,184
2012-06-25,1,Jun,11,0,Mon,1,54,127,181
2012-06-25,1,Jun,12,0,Mon,1,74,196,270
2012-06-25,1,Jun,13,0,Mon,1,79,181,260
2012-06-25,1,Jun,14,0,Mon,1,90,161,251
2012-06-25,1,Jun,15,0,Mon,1,65,168,233
2012-06-25,1,Jun,16,0,Mon,1,104,310,414
2012-06-25,1,Jun,17,0,Mon,1,76,757,833
2012-06-25,1,Jun,18,0,Mon,1,100,691,791
2012-06-25,1,Jun,19,0,Mon,1,74,508,582
2012-06-25,1,Jun,20,0,Mon,1,100,375,475
2012-06-25,1,Jun,21,0,Mon,1,50,281,331
2012-06-25,1,Jun,22,0,Mon,1,21,166,187
2012-06-25,1,Jun,23,0,Mon,1,15,88,103
2012-06-26,1,Jun,0,0,Tue,1,8,29,37
2012-06-26,1,Jun,1,0,Tue,1,11,19,30
2012-06-26,1,Jun,2,0,Tue,1,2,7,9
2012-06-26,1,Jun,3,0,Tue,1,2,7,9
2012-06-26,1,Jun,4,0,Tue,1,1,9,10
2012-06-26,1,Jun,5,0,Tue,1,3,36,39
2012-06-26,1,Jun,6,0,Tue,1,12,176,188
2012-06-26,1,Jun,7,0,Tue,1,21,531,552
2012-06-26,1,Jun,8,0,Tue,1,34,622,656
2012-06-26,1,Jun,9,0,Tue,1,30,298,328
2012-06-26,1,Jun,10,0,Tue,1,37,153,190
2012-06-26,1,Jun,11,0,Tue,1,46,189,235
2012-06-26,1,Jun,12,0,Tue,1,80,228,308
2012-06-26,1,Jun,13,0,Tue,1,74,232,306
2012-06-26,1,Jun,14,0,Tue,1,81,186,267
2012-06-26,1,Jun,15,0,Tue,1,88,229,317
2012-06-26,1,Jun,16,0,Tue,1,67,349,416
2012-06-26,1,Jun,17,0,Tue,1,104,796,900
2012-06-26,1,Jun,18,0,Tue,1,105,719,824
2012-06-26,1,Jun,19,0,Tue,1,83,529,612
2012-06-26,1,Jun,20,0,Tue,1,88,417,505
2012-06-26,1,Jun,21,0,Tue,1,61,267,328
2012-06-26,1,Jun,22,0,Tue,1,26,219,245
2012-06-26,1,Jun,23,0,Tue,1,13,118,131
2012-06-27,1,Jun,0,0,Wed,1,15,39,54
2012-06-27,1,Jun,1,0,Wed,1,5,18,23
2012-06-27,1,Jun,2,0,Wed,1,2,12,14
2012-06-27,1,Jun,3,0,Wed,1,1,7,8
2012-06-27,1,Jun,4,0,Wed,1,0,11,11
2012-06-27,1,Jun,5,0,Wed,1,2,34,36
2012-06-27,1,Jun,6,0,Wed,1,7,193,200
2012-06-27,1,Jun,7,0,Wed,1,29,498,527
2012-06-27,1,Jun,8,0,Wed,1,49,638,687
2012-06-27,1,Jun,9,0,Wed,1,29,253,282
2012-06-27,1,Jun,10,0,Wed,1,34,138,172
2012-06-27,1,Jun,11,0,Wed,1,64,145,209
2012-06-27,1,Jun,12,0,Wed,1,77,245,322
2012-06-27,1,Jun,13,0,Wed,1,77,244,321
2012-06-27,1,Jun,14,0,Wed,1,78,192,270
2012-06-27,1,Jun,15,0,Wed,1,61,188,249
2012-06-27,1,Jun,16,0,Wed,1,55,337,392
2012-06-27,1,Jun,17,0,Wed,1,113,730,843
2012-06-27,1,Jun,18,0,Wed,1,85,719,804
2012-06-27,1,Jun,19,0,Wed,1,101,542,643
2012-06-27,1,Jun,20,0,Wed,1,76,369,445
2012-06-27,1,Jun,21,0,Wed,1,54,313,367
2012-06-27,1,Jun,22,0,Wed,1,52,245,297
2012-06-27,1,Jun,23,0,Wed,1,11,148,159
2012-06-28,1,Jun,0,0,Thur,1,2,52,54
2012-06-28,1,Jun,1,0,Thur,1,11,14,25
2012-06-28,1,Jun,2,0,Thur,1,1,12,13
2012-06-28,1,Jun,3,0,Thur,1,1,6,7
2012-06-28,1,Jun,4,0,Thur,1,0,11,11
2012-06-28,1,Jun,5,0,Thur,1,8,39,47
2012-06-28,1,Jun,6,0,Thur,1,8,185,193
2012-06-28,1,Jun,7,0,Thur,1,24,484,508
2012-06-28,1,Jun,8,0,Thur,1,40,577,617
2012-06-28,1,Jun,9,0,Thur,1,33,318,351
2012-06-28,1,Jun,10,0,Thur,1,40,144,184
2012-06-28,1,Jun,11,0,Thur,1,41,170,211
2012-06-28,1,Jun,12,0,Thur,1,49,227,276
2012-06-28,1,Jun,13,0,Thur,1,31,205,236
2012-06-28,1,Jun,14,0,Thur,1,66,188,254
2012-06-28,1,Jun,15,0,Thur,1,24,195,219
2012-06-28,1,Jun,16,0,Thur,1,56,331,387
2012-06-28,1,Jun,17,0,Thur,1,71,634,705
2012-06-28,1,Jun,18,0,Thur,1,100,597,697
2012-06-28,1,Jun,19,0,Thur,1,79,492,571
2012-06-28,1,Jun,20,0,Thur,1,71,399,470
2012-06-28,1,Jun,21,0,Thur,1,89,309,398
2012-06-28,1,Jun,22,0,Thur,1,50,224,274
2012-06-28,1,Jun,23,0,Thur,1,26,145,171
2012-06-29,1,Jun,0,0,Fri,1,24,90,114
2012-06-29,1,Jun,1,0,Fri,1,9,33,42
2012-06-29,1,Jun,2,0,Fri,1,3,15,18
2012-06-29,1,Jun,3,0,Fri,1,3,5,8
2012-06-29,1,Jun,4,0,Fri,1,1,9,10
2012-06-29,1,Jun,5,0,Fri,1,6,39,45
2012-06-29,1,Jun,6,0,Fri,1,15,148,163
2012-06-29,1,Jun,7,0,Fri,1,19,361,380
2012-06-29,1,Jun,8,0,Fri,1,48,576,624
2012-06-29,1,Jun,9,0,Fri,1,39,261,300
2012-06-29,1,Jun,10,0,Fri,1,32,139,171
2012-06-29,1,Jun,11,0,Fri,1,51,137,188
2012-06-29,1,Jun,12,0,Fri,1,53,173,226
2012-06-29,1,Jun,13,0,Fri,1,45,194,239
2012-06-29,1,Jun,14,0,Fri,1,49,184,233
2012-06-29,1,Jun,15,0,Fri,1,47,183,230
2012-06-29,1,Jun,16,0,Fri,1,59,292,351
2012-06-29,1,Jun,17,0,Fri,1,82,457,539
2012-06-29,1,Jun,18,0,Fri,1,50,414,464
2012-06-29,1,Jun,19,0,Fri,1,60,303,363
2012-06-29,1,Jun,20,0,Fri,1,53,255,308
2012-06-29,1,Jun,21,0,Fri,1,41,195,236
2012-06-29,1,Jun,22,0,Fri,1,34,129,163
2012-06-29,1,Jun,23,0,Fri,1,6,42,48
2012-06-30,1,Jun,0,0,Sat,0,4,65,69
2012-06-30,1,Jun,1,0,Sat,0,3,55,58
2012-06-30,1,Jun,2,0,Sat,0,7,54,61
2012-06-30,1,Jun,3,0,Sat,0,3,20,23
2012-06-30,1,Jun,4,0,Sat,0,3,15,18
2012-06-30,1,Jun,5,0,Sat,0,3,7,10
2012-06-30,1,Jun,6,0,Sat,0,6,36,42
2012-06-30,1,Jun,7,0,Sat,0,10,82,92
2012-06-30,1,Jun,8,0,Sat,0,26,168,194
2012-06-30,1,Jun,9,0,Sat,0,41,234,275
2012-06-30,1,Jun,10,0,Sat,0,96,308,404
2012-06-30,1,Jun,11,0,Sat,0,102,350,452
2012-06-30,1,Jun,12,0,Sat,0,143,328,471
2012-06-30,1,Jun,13,0,Sat,0,105,323,428
2012-06-30,1,Jun,14,0,Sat,0,114,295,409
2012-06-30,1,Jun,15,0,Sat,0,117,287,404
2012-06-30,1,Jun,16,0,Sat,0,109,264,373
2012-06-30,1,Jun,17,0,Sat,0,131,231,362
2012-06-30,1,Jun,18,0,Sat,0,91,248,339
2012-06-30,1,Jun,19,0,Sat,0,134,240,374
2012-06-30,1,Jun,20,0,Sat,0,88,204,292
2012-06-30,1,Jun,21,0,Sat,0,48,165,213
2012-06-30,1,Jun,22,0,Sat,0,38,134,172
2012-06-30,1,Jun,23,0,Sat,0,33,119,152
2012-07-01,1,Jul,0,0,Sun,0,27,122,149
2012-07-01,1,Jul,1,0,Sun,0,12,81,93
2012-07-01,1,Jul,2,0,Sun,0,21,69,90
2012-07-01,1,Jul,3,0,Sun,0,6,27,33
2012-07-01,1,Jul,4,0,Sun,0,0,4,4
2012-07-01,1,Jul,5,0,Sun,0,3,7,10
2012-07-01,1,Jul,6,0,Sun,0,8,19,27
2012-07-01,1,Jul,7,0,Sun,0,13,37,50
2012-07-01,1,Jul,8,0,Sun,0,36,106,142
2012-07-01,1,Jul,9,0,Sun,0,51,168,219
2012-07-01,1,Jul,10,0,Sun,0,98,268,366
2012-07-01,1,Jul,11,0,Sun,0,121,256,377
2012-07-01,1,Jul,12,0,Sun,0,114,319,433
2012-07-01,1,Jul,13,0,Sun,0,111,309,420
2012-07-01,1,Jul,14,0,Sun,0,98,346,444
2012-07-01,1,Jul,15,0,Sun,0,101,244,345
2012-07-01,1,Jul,16,0,Sun,0,85,228,313
2012-07-01,1,Jul,17,0,Sun,0,90,323,413
2012-07-01,1,Jul,18,0,Sun,0,95,275,370
2012-07-01,1,Jul,19,0,Sun,0,103,279,382
2012-07-01,1,Jul,20,0,Sun,0,88,244,332
2012-07-01,1,Jul,21,0,Sun,0,77,181,258
2012-07-01,1,Jul,22,0,Sun,0,41,110,151
2012-07-01,1,Jul,23,0,Sun,0,22,88,110
2012-07-02,1,Jul,0,0,Mon,1,12,31,43
2012-07-02,1,Jul,1,0,Mon,1,3,14,17
2012-07-02,1,Jul,2,0,Mon,1,1,14,15
2012-07-02,1,Jul,3,0,Mon,1,0,5,5
2012-07-02,1,Jul,4,0,Mon,1,2,10,12
2012-07-02,1,Jul,5,0,Mon,1,3,37,40
2012-07-02,1,Jul,6,0,Mon,1,4,132,136
2012-07-02,1,Jul,7,0,Mon,1,8,390,398
2012-07-02,1,Jul,8,0,Mon,1,20,548,568
2012-07-02,1,Jul,9,0,Mon,1,56,239,295
2012-07-02,1,Jul,10,0,Mon,1,70,104,174
2012-07-02,1,Jul,11,0,Mon,1,67,134,201
2012-07-02,1,Jul,12,0,Mon,1,74,183,257
2012-07-02,1,Jul,13,0,Mon,1,74,162,236
2012-07-02,1,Jul,14,0,Mon,1,79,151,230
2012-07-02,1,Jul,15,0,Mon,1,59,175,234
2012-07-02,1,Jul,16,0,Mon,1,61,304,365
2012-07-02,1,Jul,17,0,Mon,1,82,665,747
2012-07-02,1,Jul,18,0,Mon,1,72,658,730
2012-07-02,1,Jul,19,0,Mon,1,71,510,581
2012-07-02,1,Jul,20,0,Mon,1,38,357,395
2012-07-02,1,Jul,21,0,Mon,1,17,241,258
2012-07-02,1,Jul,22,0,Mon,1,19,169,188
2012-07-02,1,Jul,23,0,Mon,1,12,90,102
2012-07-03,1,Jul,0,0,Tue,1,9,44,53
2012-07-03,1,Jul,1,0,Tue,1,5,9,14
2012-07-03,1,Jul,2,0,Tue,1,2,8,10
2012-07-03,1,Jul,3,0,Tue,1,0,2,2
2012-07-03,1,Jul,4,0,Tue,1,0,6,6
2012-07-03,1,Jul,5,0,Tue,1,2,33,35
2012-07-03,1,Jul,6,0,Tue,1,5,149,154
2012-07-03,1,Jul,7,0,Tue,1,21,462,483
2012-07-03,1,Jul,8,0,Tue,1,42,604,646
2012-07-03,1,Jul,9,0,Tue,1,46,226,272
2012-07-03,1,Jul,10,0,Tue,1,56,153,209
2012-07-03,1,Jul,11,0,Tue,1,66,151,217
2012-07-03,1,Jul,12,0,Tue,1,74,198,272
2012-07-03,1,Jul,13,0,Tue,1,80,203,283
2012-07-03,1,Jul,14,0,Tue,1,69,241,310
2012-07-03,1,Jul,15,0,Tue,1,71,330,401
2012-07-03,1,Jul,16,0,Tue,1,90,437,527
2012-07-03,1,Jul,17,0,Tue,1,102,620,722
2012-07-03,1,Jul,18,0,Tue,1,85,542,627
2012-07-03,1,Jul,19,0,Tue,1,66,431,497
2012-07-03,1,Jul,20,0,Tue,1,80,296,376
2012-07-03,1,Jul,21,0,Tue,1,36,160,196
2012-07-03,1,Jul,22,0,Tue,1,26,151,177
2012-07-03,1,Jul,23,0,Tue,1,19,152,171
2012-07-04,1,Jul,0,1,Wed,0,19,140,159
2012-07-04,1,Jul,1,1,Wed,0,27,96,123
2012-07-04,1,Jul,2,1,Wed,0,27,66,93
2012-07-04,1,Jul,3,1,Wed,0,9,23,32
2012-07-04,1,Jul,4,1,Wed,0,5,11,16
2012-07-04,1,Jul,5,1,Wed,0,5,14,19
2012-07-04,1,Jul,6,1,Wed,0,9,23,32
2012-07-04,1,Jul,7,1,Wed,0,10,62,72
2012-07-04,1,Jul,8,1,Wed,0,43,110,153
2012-07-04,1,Jul,9,1,Wed,0,90,203,293
2012-07-04,1,Jul,10,1,Wed,0,143,304,447
2012-07-04,1,Jul,11,1,Wed,0,164,321,485
2012-07-04,1,Jul,12,1,Wed,0,164,330,494
2012-07-04,1,Jul,13,1,Wed,0,177,322,499
2012-07-04,1,Jul,14,1,Wed,0,190,357,547
2012-07-04,1,Jul,15,1,Wed,0,155,299,454
2012-07-04,1,Jul,16,1,Wed,0,163,226,389
2012-07-04,1,Jul,17,1,Wed,0,161,253,414
2012-07-04,1,Jul,18,1,Wed,0,159,271,430
2012-07-04,1,Jul,19,1,Wed,0,177,255,432
2012-07-04,1,Jul,20,1,Wed,0,237,314,551
2012-07-04,1,Jul,21,1,Wed,0,222,362,584
2012-07-04,1,Jul,22,1,Wed,0,175,327,502
2012-07-04,1,Jul,23,1,Wed,0,31,152,183
2012-07-05,1,Jul,0,0,Thur,1,17,71,88
2012-07-05,1,Jul,1,0,Thur,1,6,24,30
2012-07-05,1,Jul,2,0,Thur,1,4,14,18
2012-07-05,1,Jul,3,0,Thur,1,2,5,7
2012-07-05,1,Jul,4,0,Thur,1,0,7,7
2012-07-05,1,Jul,5,0,Thur,1,1,28,29
2012-07-05,1,Jul,6,0,Thur,1,3,130,133
2012-07-05,1,Jul,7,0,Thur,1,27,316,343
2012-07-05,1,Jul,8,0,Thur,1,36,514,550
2012-07-05,1,Jul,9,0,Thur,1,47,246,293
2012-07-05,1,Jul,10,0,Thur,1,69,117,186
2012-07-05,1,Jul,11,0,Thur,1,107,137,244
2012-07-05,1,Jul,12,0,Thur,1,88,188,276
2012-07-05,1,Jul,13,0,Thur,1,129,181,310
2012-07-05,1,Jul,14,0,Thur,1,87,154,241
2012-07-05,1,Jul,15,0,Thur,1,71,183,254
2012-07-05,1,Jul,16,0,Thur,1,109,324,433
2012-07-05,1,Jul,17,0,Thur,1,114,575,689
2012-07-05,1,Jul,18,0,Thur,1,96,511,607
2012-07-05,1,Jul,19,0,Thur,1,128,375,503
2012-07-05,1,Jul,20,0,Thur,1,78,243,321
2012-07-05,1,Jul,21,0,Thur,1,91,232,323
2012-07-05,1,Jul,22,0,Thur,1,63,162,225
2012-07-05,1,Jul,23,0,Thur,1,32,99,131
2012-07-06,1,Jul,0,0,Fri,1,39,63,102
2012-07-06,1,Jul,1,0,Fri,1,7,22,29
2012-07-06,1,Jul,2,0,Fri,1,4,13,17
2012-07-06,1,Jul,3,0,Fri,1,1,6,7
2012-07-06,1,Jul,4,0,Fri,1,2,4,6
2012-07-06,1,Jul,5,0,Fri,1,4,31,35
2012-07-06,1,Jul,6,0,Fri,1,4,127,131
2012-07-06,1,Jul,7,0,Fri,1,20,333,353
2012-07-06,1,Jul,8,0,Fri,1,28,557,585
2012-07-06,1,Jul,9,0,Fri,1,55,249,304
2012-07-06,1,Jul,10,0,Fri,1,80,130,210
2012-07-06,1,Jul,11,0,Fri,1,92,141,233
2012-07-06,1,Jul,12,0,Fri,1,111,220,331
2012-07-06,1,Jul,13,0,Fri,1,99,194,293
2012-07-06,1,Jul,14,0,Fri,1,91,184,275
2012-07-06,1,Jul,15,0,Fri,1,79,206,285
2012-07-06,1,Jul,16,0,Fri,1,69,300,369
2012-07-06,1,Jul,17,0,Fri,1,90,486,576
2012-07-06,1,Jul,18,0,Fri,1,106,454,560
2012-07-06,1,Jul,19,0,Fri,1,112,306,418
2012-07-06,1,Jul,20,0,Fri,1,91,245,336
2012-07-06,1,Jul,21,0,Fri,1,77,223,300
2012-07-06,1,Jul,22,0,Fri,1,78,210,288
2012-07-06,1,Jul,23,0,Fri,1,27,137,164
2012-07-07,1,Jul,0,0,Sat,0,35,115,150
2012-07-07,1,Jul,1,0,Sat,0,16,55,71
2012-07-07,1,Jul,2,0,Sat,0,11,47,58
2012-07-07,1,Jul,3,0,Sat,0,12,19,31
2012-07-07,1,Jul,4,0,Sat,0,3,13,16
2012-07-07,1,Jul,5,0,Sat,0,2,12,14
2012-07-07,1,Jul,6,0,Sat,0,4,27,31
2012-07-07,1,Jul,7,0,Sat,0,8,63,71
2012-07-07,1,Jul,8,0,Sat,0,32,120,152
2012-07-07,1,Jul,9,0,Sat,0,69,187,256
2012-07-07,1,Jul,10,0,Sat,0,100,225,325
2012-07-07,1,Jul,11,0,Sat,0,122,245,367
2012-07-07,1,Jul,12,0,Sat,0,124,218,342
2012-07-07,1,Jul,13,0,Sat,0,116,244,360
2012-07-07,1,Jul,14,0,Sat,0,105,203,308
2012-07-07,1,Jul,15,0,Sat,0,113,193,306
2012-07-07,1,Jul,16,0,Sat,0,102,192,294
2012-07-07,1,Jul,17,0,Sat,0,103,176,279
2012-07-07,1,Jul,18,0,Sat,0,83,194,277
2012-07-07,1,Jul,19,0,Sat,0,68,219,287
2012-07-07,1,Jul,20,0,Sat,0,79,197,276
2012-07-07,1,Jul,21,0,Sat,0,51,150,201
2012-07-07,1,Jul,22,0,Sat,0,56,164,220
2012-07-07,1,Jul,23,0,Sat,0,34,114,148
2012-07-08,1,Jul,0,0,Sun,0,22,125,147
2012-07-08,1,Jul,1,0,Sun,0,25,99,124
2012-07-08,1,Jul,2,0,Sun,0,11,59,70
2012-07-08,1,Jul,3,0,Sun,0,1,34,35
2012-07-08,1,Jul,4,0,Sun,0,2,11,13
2012-07-08,1,Jul,5,0,Sun,0,1,5,6
2012-07-08,1,Jul,6,0,Sun,0,5,16,21
2012-07-08,1,Jul,7,0,Sun,0,19,33,52
2012-07-08,1,Jul,8,0,Sun,0,35,95,130
2012-07-08,1,Jul,9,0,Sun,0,70,172,242
2012-07-08,1,Jul,10,0,Sun,0,85,234,319
2012-07-08,1,Jul,11,0,Sun,0,120,269,389
2012-07-08,1,Jul,12,0,Sun,0,105,271,376
2012-07-08,1,Jul,13,0,Sun,0,118,219,337
2012-07-08,1,Jul,14,0,Sun,0,77,235,312
2012-07-08,1,Jul,15,0,Sun,0,80,218,298
2012-07-08,1,Jul,16,0,Sun,0,65,226,291
2012-07-08,1,Jul,17,0,Sun,0,68,202,270
2012-07-08,1,Jul,18,0,Sun,0,54,199,253
2012-07-08,1,Jul,19,0,Sun,0,66,184,250
2012-07-08,1,Jul,20,0,Sun,0,79,206,285
2012-07-08,1,Jul,21,0,Sun,0,58,149,207
2012-07-08,1,Jul,22,0,Sun,0,12,110,122
2012-07-08,1,Jul,23,0,Sun,0,25,98,123
2012-07-09,1,Jul,0,0,Mon,1,6,33,39
2012-07-09,1,Jul,1,0,Mon,1,5,13,18
2012-07-09,1,Jul,2,0,Mon,1,1,4,5
2012-07-09,1,Jul,3,0,Mon,1,0,5,5
2012-07-09,1,Jul,4,0,Mon,1,1,1,2
2012-07-09,1,Jul,5,0,Mon,1,1,27,28
2012-07-09,1,Jul,6,0,Mon,1,6,86,92
2012-07-09,1,Jul,7,0,Mon,1,7,223,230
2012-07-09,1,Jul,8,0,Mon,1,26,429,455
2012-07-09,1,Jul,9,0,Mon,1,38,325,363
2012-07-09,1,Jul,10,0,Mon,1,58,117,175
2012-07-09,1,Jul,11,0,Mon,1,72,144,216
2012-07-09,1,Jul,12,0,Mon,1,61,205,266
2012-07-09,1,Jul,13,0,Mon,1,67,188,255
2012-07-09,1,Jul,14,0,Mon,1,58,184,242
2012-07-09,1,Jul,15,0,Mon,1,66,214,280
2012-07-09,1,Jul,16,0,Mon,1,88,325,413
2012-07-09,1,Jul,17,0,Mon,1,108,741,849
2012-07-09,1,Jul,18,0,Mon,1,82,790,872
2012-07-09,1,Jul,19,0,Mon,1,88,543,631
2012-07-09,1,Jul,20,0,Mon,1,69,378,447
2012-07-09,1,Jul,21,0,Mon,1,33,298,331
2012-07-09,1,Jul,22,0,Mon,1,35,189,224
2012-07-09,1,Jul,23,0,Mon,1,22,109,131
2012-07-10,1,Jul,0,0,Tue,1,16,53,69
2012-07-10,1,Jul,1,0,Tue,1,0,15,15
2012-07-10,1,Jul,2,0,Tue,1,1,15,16
2012-07-10,1,Jul,3,0,Tue,1,0,3,3
2012-07-10,1,Jul,4,0,Tue,1,0,4,4
2012-07-10,1,Jul,5,0,Tue,1,3,39,42
2012-07-10,1,Jul,6,0,Tue,1,4,183,187
2012-07-10,1,Jul,7,0,Tue,1,31,489,520
2012-07-10,1,Jul,8,0,Tue,1,34,615,649
2012-07-10,1,Jul,9,0,Tue,1,47,284,331
2012-07-10,1,Jul,10,0,Tue,1,56,134,190
2012-07-10,1,Jul,11,0,Tue,1,92,157,249
2012-07-10,1,Jul,12,0,Tue,1,69,203,272
2012-07-10,1,Jul,13,0,Tue,1,77,203,280
2012-07-10,1,Jul,14,0,Tue,1,71,171,242
2012-07-10,1,Jul,15,0,Tue,1,77,188,265
2012-07-10,1,Jul,16,0,Tue,1,89,346,435
2012-07-10,1,Jul,17,0,Tue,1,103,769,872
2012-07-10,1,Jul,18,0,Tue,1,70,749,819
2012-07-10,1,Jul,19,0,Tue,1,55,359,414
2012-07-10,1,Jul,20,0,Tue,1,9,75,84
2012-07-10,1,Jul,21,0,Tue,1,7,83,90
2012-07-10,1,Jul,22,0,Tue,1,14,125,139
2012-07-10,1,Jul,23,0,Tue,1,29,74,103
2012-07-11,1,Jul,0,0,Wed,1,6,38,44
2012-07-11,1,Jul,1,0,Wed,1,3,11,14
2012-07-11,1,Jul,2,0,Wed,1,0,5,5
2012-07-11,1,Jul,3,0,Wed,1,0,5,5
2012-07-11,1,Jul,4,0,Wed,1,1,6,7
2012-07-11,1,Jul,5,0,Wed,1,5,36,41
2012-07-11,1,Jul,6,0,Wed,1,17,168,185
2012-07-11,1,Jul,7,0,Wed,1,26,471,497
2012-07-11,1,Jul,8,0,Wed,1,30,644,674
2012-07-11,1,Jul,9,0,Wed,1,30,298,328
2012-07-11,1,Jul,10,0,Wed,1,47,148,195
2012-07-11,1,Jul,11,0,Wed,1,56,173,229
2012-07-11,1,Jul,12,0,Wed,1,69,223,292
2012-07-11,1,Jul,13,0,Wed,1,65,208,273
2012-07-11,1,Jul,14,0,Wed,1,66,175,241
2012-07-11,1,Jul,15,0,Wed,1,56,220,276
2012-07-11,1,Jul,16,0,Wed,1,53,358,411
2012-07-11,1,Jul,17,0,Wed,1,90,740,830
2012-07-11,1,Jul,18,0,Wed,1,79,735,814
2012-07-11,1,Jul,19,0,Wed,1,73,560,633
2012-07-11,1,Jul,20,0,Wed,1,73,410,483
2012-07-11,1,Jul,21,0,Wed,1,69,322,391
2012-07-11,1,Jul,22,0,Wed,1,41,203,244
2012-07-11,1,Jul,23,0,Wed,1,20,132,152
2012-07-12,1,Jul,0,0,Thur,1,1,55,56
2012-07-12,1,Jul,1,0,Thur,1,0,21,21
2012-07-12,1,Jul,2,0,Thur,1,0,9,9
2012-07-12,1,Jul,3,0,Thur,1,0,10,10
2012-07-12,1,Jul,4,0,Thur,1,0,5,5
2012-07-12,1,Jul,5,0,Thur,1,4,40,44
2012-07-12,1,Jul,6,0,Thur,1,7,171,178
2012-07-12,1,Jul,7,0,Thur,1,32,480,512
2012-07-12,1,Jul,8,0,Thur,1,49,653,702
2012-07-12,1,Jul,9,0,Thur,1,42,285,327
2012-07-12,1,Jul,10,0,Thur,1,69,145,214
2012-07-12,1,Jul,11,0,Thur,1,49,166,215
2012-07-12,1,Jul,12,0,Thur,1,71,221,292
2012-07-12,1,Jul,13,0,Thur,1,52,225,277
2012-07-12,1,Jul,14,0,Thur,1,42,167,209
2012-07-12,1,Jul,15,0,Thur,1,63,208,271
2012-07-12,1,Jul,16,0,Thur,1,69,370,439
2012-07-12,1,Jul,17,0,Thur,1,91,704,795
2012-07-12,1,Jul,18,0,Thur,1,86,739,825
2012-07-12,1,Jul,19,0,Thur,1,97,532,629
2012-07-12,1,Jul,20,0,Thur,1,75,439,514
2012-07-12,1,Jul,21,0,Thur,1,44,329,373
2012-07-12,1,Jul,22,0,Thur,1,56,262,318
2012-07-12,1,Jul,23,0,Thur,1,33,178,211
2012-07-13,1,Jul,0,0,Fri,1,19,76,95
2012-07-13,1,Jul,1,0,Fri,1,17,42,59
2012-07-13,1,Jul,2,0,Fri,1,2,15,17
2012-07-13,1,Jul,3,0,Fri,1,2,7,9
2012-07-13,1,Jul,4,0,Fri,1,0,11,11
2012-07-13,1,Jul,5,0,Fri,1,4,30,34
2012-07-13,1,Jul,6,0,Fri,1,7,120,127
2012-07-13,1,Jul,7,0,Fri,1,27,353,380
2012-07-13,1,Jul,8,0,Fri,1,53,660,713
2012-07-13,1,Jul,9,0,Fri,1,70,344,414
2012-07-13,1,Jul,10,0,Fri,1,78,190,268
2012-07-13,1,Jul,11,0,Fri,1,68,220,288
2012-07-13,1,Jul,12,0,Fri,1,125,254,379
2012-07-13,1,Jul,13,0,Fri,1,100,274,374
2012-07-13,1,Jul,14,0,Fri,1,120,249,369
2012-07-13,1,Jul,15,0,Fri,1,92,261,353
2012-07-13,1,Jul,16,0,Fri,1,111,381,492
2012-07-13,1,Jul,17,0,Fri,1,138,697,835
2012-07-13,1,Jul,18,0,Fri,1,108,523,631
2012-07-13,1,Jul,19,0,Fri,1,103,385,488
2012-07-13,1,Jul,20,0,Fri,1,95,294,389
2012-07-13,1,Jul,21,0,Fri,1,76,223,299
2012-07-13,1,Jul,22,0,Fri,1,59,204,263
2012-07-13,1,Jul,23,0,Fri,1,37,175,212
2012-07-14,1,Jul,0,0,Sat,0,35,156,191
2012-07-14,1,Jul,1,0,Sat,0,13,105,118
2012-07-14,1,Jul,2,0,Sat,0,10,91,101
2012-07-14,1,Jul,3,0,Sat,0,9,31,40
2012-07-14,1,Jul,4,0,Sat,0,3,6,9
2012-07-14,1,Jul,5,0,Sat,0,0,5,5
2012-07-14,1,Jul,6,0,Sat,0,6,29,35
2012-07-14,1,Jul,7,0,Sat,0,7,41,48
2012-07-14,1,Jul,8,0,Sat,0,33,118,151
2012-07-14,1,Jul,9,0,Sat,0,82,200,282
2012-07-14,1,Jul,10,0,Sat,0,123,278,401
2012-07-14,1,Jul,11,0,Sat,0,143,296,439
2012-07-14,1,Jul,12,0,Sat,0,181,318,499
2012-07-14,1,Jul,13,0,Sat,0,219,372,591
2012-07-14,1,Jul,14,0,Sat,0,269,363,632
2012-07-14,1,Jul,15,0,Sat,0,243,317,560
2012-07-14,1,Jul,16,0,Sat,0,226,340,566
2012-07-14,1,Jul,17,0,Sat,0,199,259,458
2012-07-14,1,Jul,18,0,Sat,0,108,243,351
2012-07-14,1,Jul,19,0,Sat,0,156,275,431
2012-07-14,1,Jul,20,0,Sat,0,101,255,356
2012-07-14,1,Jul,21,0,Sat,0,69,200,269
2012-07-14,1,Jul,22,0,Sat,0,65,160,225
2012-07-14,1,Jul,23,0,Sat,0,55,156,211
2012-07-15,1,Jul,0,0,Sun,0,40,147,187
2012-07-15,1,Jul,1,0,Sun,0,49,119,168
2012-07-15,1,Jul,2,0,Sun,0,29,86,115
2012-07-15,1,Jul,3,0,Sun,0,15,42,57
2012-07-15,1,Jul,4,0,Sun,0,8,11,19
2012-07-15,1,Jul,5,0,Sun,0,2,7,9
2012-07-15,1,Jul,6,0,Sun,0,6,9,15
2012-07-15,1,Jul,7,0,Sun,0,17,30,47
2012-07-15,1,Jul,8,0,Sun,0,37,96,133
2012-07-15,1,Jul,9,0,Sun,0,58,163,221
2012-07-15,1,Jul,10,0,Sun,0,141,241,382
2012-07-15,1,Jul,11,0,Sun,0,170,281,451
2012-07-15,1,Jul,12,0,Sun,0,153,336,489
2012-07-15,1,Jul,13,0,Sun,0,171,309,480
2012-07-15,1,Jul,14,0,Sun,0,162,314,476
2012-07-15,1,Jul,15,0,Sun,0,182,307,489
2012-07-15,1,Jul,16,0,Sun,0,152,343,495
2012-07-15,1,Jul,17,0,Sun,0,122,314,436
2012-07-15,1,Jul,18,0,Sun,0,84,228,312
2012-07-15,1,Jul,19,0,Sun,0,109,203,312
2012-07-15,1,Jul,20,0,Sun,0,95,199,294
2012-07-15,1,Jul,21,0,Sun,0,59,164,223
2012-07-15,1,Jul,22,0,Sun,0,34,96,130
2012-07-15,1,Jul,23,0,Sun,0,25,66,91
2012-07-16,1,Jul,0,0,Mon,1,11,32,43
2012-07-16,1,Jul,1,0,Mon,1,1,10,11
2012-07-16,1,Jul,2,0,Mon,1,4,11,15
2012-07-16,1,Jul,3,0,Mon,1,2,4,6
2012-07-16,1,Jul,4,0,Mon,1,1,11,12
2012-07-16,1,Jul,5,0,Mon,1,10,40,50
2012-07-16,1,Jul,6,0,Mon,1,8,132,140
2012-07-16,1,Jul,7,0,Mon,1,24,459,483
2012-07-16,1,Jul,8,0,Mon,1,48,619,667
2012-07-16,1,Jul,9,0,Mon,1,51,297,348
2012-07-16,1,Jul,10,0,Mon,1,69,117,186
2012-07-16,1,Jul,11,0,Mon,1,57,125,182
2012-07-16,1,Jul,12,0,Mon,1,79,158,237
2012-07-16,1,Jul,13,0,Mon,1,63,176,239
2012-07-16,1,Jul,14,0,Mon,1,53,159,212
2012-07-16,1,Jul,15,0,Mon,1,61,176,237
2012-07-16,1,Jul,16,0,Mon,1,77,309,386
2012-07-16,1,Jul,17,0,Mon,1,86,669,755
2012-07-16,1,Jul,18,0,Mon,1,97,697,794
2012-07-16,1,Jul,19,0,Mon,1,92,503,595
2012-07-16,1,Jul,20,0,Mon,1,66,388,454
2012-07-16,1,Jul,21,0,Mon,1,45,283,328
2012-07-16,1,Jul,22,0,Mon,1,56,228,284
2012-07-16,1,Jul,23,0,Mon,1,27,139,166
2012-07-17,1,Jul,0,0,Tue,1,10,43,53
2012-07-17,1,Jul,1,0,Tue,1,4,21,25
2012-07-17,1,Jul,2,0,Tue,1,1,6,7
2012-07-17,1,Jul,3,0,Tue,1,0,3,3
2012-07-17,1,Jul,4,0,Tue,1,0,7,7
2012-07-17,1,Jul,5,0,Tue,1,7,31,38
2012-07-17,1,Jul,6,0,Tue,1,16,197,213
2012-07-17,1,Jul,7,0,Tue,1,26,500,526
2012-07-17,1,Jul,8,0,Tue,1,43,618,661
2012-07-17,1,Jul,9,0,Tue,1,32,288,320
2012-07-17,1,Jul,10,0,Tue,1,37,122,159
2012-07-17,1,Jul,11,0,Tue,1,60,146,206
2012-07-17,1,Jul,12,0,Tue,1,80,174,254
2012-07-17,1,Jul,13,0,Tue,1,53,168,221
2012-07-17,1,Jul,14,0,Tue,1,54,160,214
2012-07-17,1,Jul,15,0,Tue,1,57,187,244
2012-07-17,1,Jul,16,0,Tue,1,64,317,381
2012-07-17,1,Jul,17,0,Tue,1,95,675,770
2012-07-17,1,Jul,18,0,Tue,1,60,712,772
2012-07-17,1,Jul,19,0,Tue,1,69,478,547
2012-07-17,1,Jul,20,0,Tue,1,52,375,427
2012-07-17,1,Jul,21,0,Tue,1,50,283,333
2012-07-17,1,Jul,22,0,Tue,1,29,215,244
2012-07-17,1,Jul,23,0,Tue,1,22,139,161
2012-07-18,1,Jul,0,0,Wed,1,8,45,53
2012-07-18,1,Jul,1,0,Wed,1,2,14,16
2012-07-18,1,Jul,2,0,Wed,1,3,5,8
2012-07-18,1,Jul,3,0,Wed,1,2,2,4
2012-07-18,1,Jul,4,0,Wed,1,0,6,6
2012-07-18,1,Jul,5,0,Wed,1,5,41,46
2012-07-18,1,Jul,6,0,Wed,1,10,152,162
2012-07-18,1,Jul,7,0,Wed,1,23,472,495
2012-07-18,1,Jul,8,0,Wed,1,55,624,679
2012-07-18,1,Jul,9,0,Wed,1,44,253,297
2012-07-18,1,Jul,10,0,Wed,1,39,99,138
2012-07-18,1,Jul,11,0,Wed,1,47,136,183
2012-07-18,1,Jul,12,0,Wed,1,36,166,202
2012-07-18,1,Jul,13,0,Wed,1,49,154,203
2012-07-18,1,Jul,14,0,Wed,1,54,116,170
2012-07-18,1,Jul,15,0,Wed,1,42,152,194
2012-07-18,1,Jul,16,0,Wed,1,34,190,224
2012-07-18,1,Jul,17,0,Wed,1,35,335,370
2012-07-18,1,Jul,18,0,Wed,1,63,580,643
2012-07-18,1,Jul,19,0,Wed,1,78,438,516
2012-07-18,1,Jul,20,0,Wed,1,56,310,366
2012-07-18,1,Jul,21,0,Wed,1,53,266,319
2012-07-18,1,Jul,22,0,Wed,1,42,246,288
2012-07-18,1,Jul,23,0,Wed,1,19,112,131
2012-07-19,1,Jul,0,0,Thur,1,16,50,66
2012-07-19,1,Jul,1,0,Thur,1,6,19,25
2012-07-19,1,Jul,2,0,Thur,1,0,7,7
2012-07-19,1,Jul,3,0,Thur,1,1,4,5
2012-07-19,1,Jul,4,0,Thur,1,0,8,8
2012-07-19,1,Jul,5,0,Thur,1,5,35,40
2012-07-19,1,Jul,6,0,Thur,1,8,144,152
2012-07-19,1,Jul,7,0,Thur,1,23,450,473
2012-07-19,1,Jul,8,0,Thur,1,32,625,657
2012-07-19,1,Jul,9,0,Thur,1,36,282,318
2012-07-19,1,Jul,10,0,Thur,1,41,157,198
2012-07-19,1,Jul,11,0,Thur,1,54,162,216
2012-07-19,1,Jul,12,0,Thur,1,59,215,274
2012-07-19,1,Jul,13,0,Thur,1,74,180,254
2012-07-19,1,Jul,14,0,Thur,1,46,151,197
2012-07-19,1,Jul,15,0,Thur,1,66,226,292
2012-07-19,1,Jul,16,0,Thur,1,70,288,358
2012-07-19,1,Jul,17,0,Thur,1,93,678,771
2012-07-19,1,Jul,18,0,Thur,1,93,684,777
2012-07-19,1,Jul,19,0,Thur,1,53,480,533
2012-07-19,1,Jul,20,0,Thur,1,65,440,505
2012-07-19,1,Jul,21,0,Thur,1,38,294,332
2012-07-19,1,Jul,22,0,Thur,1,6,62,68
2012-07-19,1,Jul,23,0,Thur,1,3,62,65
2012-07-20,1,Jul,0,0,Fri,1,2,32,34
2012-07-20,1,Jul,1,0,Fri,1,2,9,11
2012-07-20,1,Jul,2,0,Fri,1,5,14,19
2012-07-20,1,Jul,3,0,Fri,1,7,29,36
2012-07-20,1,Jul,4,0,Fri,1,3,6,9
2012-07-20,1,Jul,5,0,Fri,1,2,40,42
2012-07-20,1,Jul,6,0,Fri,1,3,123,126
2012-07-20,1,Jul,7,0,Fri,1,14,346,360
2012-07-20,1,Jul,8,0,Fri,1,39,652,691
2012-07-20,1,Jul,9,0,Fri,1,45,328,373
2012-07-20,1,Jul,10,0,Fri,1,51,182,233
2012-07-20,1,Jul,11,0,Fri,1,51,161,212
2012-07-20,1,Jul,12,0,Fri,1,41,233,274
2012-07-20,1,Jul,13,0,Fri,1,20,136,156
2012-07-20,1,Jul,14,0,Fri,1,53,176,229
2012-07-20,1,Jul,15,0,Fri,1,47,169,216
2012-07-20,1,Jul,16,0,Fri,1,70,366,436
2012-07-20,1,Jul,17,0,Fri,1,95,620,715
2012-07-20,1,Jul,18,0,Fri,1,73,549,622
2012-07-20,1,Jul,19,0,Fri,1,44,358,402
2012-07-20,1,Jul,20,0,Fri,1,35,216,251
2012-07-20,1,Jul,21,0,Fri,1,14,108,122
2012-07-20,1,Jul,22,0,Fri,1,13,122,135
2012-07-20,1,Jul,23,0,Fri,1,18,148,166
2012-07-21,1,Jul,0,0,Sat,0,11,92,103
2012-07-21,1,Jul,1,0,Sat,0,10,62,72
2012-07-21,1,Jul,2,0,Sat,0,5,55,60
2012-07-21,1,Jul,3,0,Sat,0,7,18,25
2012-07-21,1,Jul,4,0,Sat,0,11,5,16
2012-07-21,1,Jul,5,0,Sat,0,7,10,17
2012-07-21,1,Jul,6,0,Sat,0,3,12,15
2012-07-21,1,Jul,7,0,Sat,0,8,29,37
2012-07-21,1,Jul,8,0,Sat,0,18,94,112
2012-07-21,1,Jul,9,0,Sat,0,32,175,207
2012-07-21,1,Jul,10,0,Sat,0,49,219,268
2012-07-21,1,Jul,11,0,Sat,0,80,225,305
2012-07-21,1,Jul,12,0,Sat,0,156,301,457
2012-07-21,1,Jul,13,0,Sat,0,106,248,354
2012-07-21,1,Jul,14,0,Sat,0,121,222,343
2012-07-21,1,Jul,15,0,Sat,0,148,232,380
2012-07-21,1,Jul,16,0,Sat,0,130,196,326
2012-07-21,1,Jul,17,0,Sat,0,92,149,241
2012-07-21,1,Jul,18,0,Sat,0,51,126,177
2012-07-21,1,Jul,19,0,Sat,0,67,171,238
2012-07-21,1,Jul,20,0,Sat,0,51,163,214
2012-07-21,1,Jul,21,0,Sat,0,29,134,163
2012-07-21,1,Jul,22,0,Sat,0,40,140,180
2012-07-21,1,Jul,23,0,Sat,0,32,117,149
2012-07-22,1,Jul,0,0,Sun,0,17,96,113
2012-07-22,1,Jul,1,0,Sun,0,31,99,130
2012-07-22,1,Jul,2,0,Sun,0,32,90,122
2012-07-22,1,Jul,3,0,Sun,0,13,30,43
2012-07-22,1,Jul,4,0,Sun,0,6,10,16
2012-07-22,1,Jul,5,0,Sun,0,0,6,6
2012-07-22,1,Jul,6,0,Sun,0,5,14,19
2012-07-22,1,Jul,7,0,Sun,0,13,25,38
2012-07-22,1,Jul,8,0,Sun,0,31,122,153
2012-07-22,1,Jul,9,0,Sun,0,79,179,258
2012-07-22,1,Jul,10,0,Sun,0,114,265,379
2012-07-22,1,Jul,11,0,Sun,0,191,314,505
2012-07-22,1,Jul,12,0,Sun,0,178,326,504
2012-07-22,1,Jul,13,0,Sun,0,238,388,626
2012-07-22,1,Jul,14,0,Sun,0,256,360,616
2012-07-22,1,Jul,15,0,Sun,0,254,370,624
2012-07-22,1,Jul,16,0,Sun,0,245,383,628
2012-07-22,1,Jul,17,0,Sun,0,188,368,556
2012-07-22,1,Jul,18,0,Sun,0,173,342,515
2012-07-22,1,Jul,19,0,Sun,0,180,342,522
2012-07-22,1,Jul,20,0,Sun,0,124,254,378
2012-07-22,1,Jul,21,0,Sun,0,88,257,345
2012-07-22,1,Jul,22,0,Sun,0,55,136,191
2012-07-22,1,Jul,23,0,Sun,0,33,90,123
2012-07-23,1,Jul,0,0,Mon,1,11,36,47
2012-07-23,1,Jul,1,0,Mon,1,7,20,27
2012-07-23,1,Jul,2,0,Mon,1,3,14,17
2012-07-23,1,Jul,3,0,Mon,1,0,2,2
2012-07-23,1,Jul,4,0,Mon,1,0,8,8
2012-07-23,1,Jul,5,0,Mon,1,3,48,51
2012-07-23,1,Jul,6,0,Mon,1,9,148,157
2012-07-23,1,Jul,7,0,Mon,1,17,404,421
2012-07-23,1,Jul,8,0,Mon,1,47,691,738
2012-07-23,1,Jul,9,0,Mon,1,57,288,345
2012-07-23,1,Jul,10,0,Mon,1,63,137,200
2012-07-23,1,Jul,11,0,Mon,1,69,129,198
2012-07-23,1,Jul,12,0,Mon,1,109,205,314
2012-07-23,1,Jul,13,0,Mon,1,64,176,240
2012-07-23,1,Jul,14,0,Mon,1,82,189,271
2012-07-23,1,Jul,15,0,Mon,1,76,205,281
2012-07-23,1,Jul,16,0,Mon,1,111,346,457
2012-07-23,1,Jul,17,0,Mon,1,87,760,847
2012-07-23,1,Jul,18,0,Mon,1,69,672,741
2012-07-23,1,Jul,19,0,Mon,1,94,488,582
2012-07-23,1,Jul,20,0,Mon,1,56,347,403
2012-07-23,1,Jul,21,0,Mon,1,45,251,296
2012-07-23,1,Jul,22,0,Mon,1,40,169,209
2012-07-23,1,Jul,23,0,Mon,1,16,98,114
2012-07-24,1,Jul,0,0,Tue,1,12,52,64
2012-07-24,1,Jul,1,0,Tue,1,7,10,17
2012-07-24,1,Jul,2,0,Tue,1,6,10,16
2012-07-24,1,Jul,3,0,Tue,1,1,5,6
2012-07-24,1,Jul,4,0,Tue,1,0,6,6
2012-07-24,1,Jul,5,0,Tue,1,5,45,50
2012-07-24,1,Jul,6,0,Tue,1,17,173,190
2012-07-24,1,Jul,7,0,Tue,1,24,492,516
2012-07-24,1,Jul,8,0,Tue,1,49,694,743
2012-07-24,1,Jul,9,0,Tue,1,40,299,339
2012-07-24,1,Jul,10,0,Tue,1,62,156,218
2012-07-24,1,Jul,11,0,Tue,1,45,156,201
2012-07-24,1,Jul,12,0,Tue,1,60,169,229
2012-07-24,1,Jul,13,0,Tue,1,73,200,273
2012-07-24,1,Jul,14,0,Tue,1,48,196,244
2012-07-24,1,Jul,15,0,Tue,1,73,212,285
2012-07-24,1,Jul,16,0,Tue,1,86,369,455
2012-07-24,1,Jul,17,0,Tue,1,94,775,869
2012-07-24,1,Jul,18,0,Tue,1,110,767,877
2012-07-24,1,Jul,19,0,Tue,1,109,523,632
2012-07-24,1,Jul,20,0,Tue,1,85,438,523
2012-07-24,1,Jul,21,0,Tue,1,53,325,378
2012-07-24,1,Jul,22,0,Tue,1,43,226,269
2012-07-24,1,Jul,23,0,Tue,1,38,154,192
2012-07-25,1,Jul,0,0,Wed,1,9,57,66
2012-07-25,1,Jul,1,0,Wed,1,2,26,28
2012-07-25,1,Jul,2,0,Wed,1,1,11,12
2012-07-25,1,Jul,3,0,Wed,1,1,11,12
2012-07-25,1,Jul,4,0,Wed,1,0,4,4
2012-07-25,1,Jul,5,0,Wed,1,5,54,59
2012-07-25,1,Jul,6,0,Wed,1,11,179,190
2012-07-25,1,Jul,7,0,Wed,1,34,473,507
2012-07-25,1,Jul,8,0,Wed,1,43,745,788
2012-07-25,1,Jul,9,0,Wed,1,65,277,342
2012-07-25,1,Jul,10,0,Wed,1,68,163,231
2012-07-25,1,Jul,11,0,Wed,1,79,202,281
2012-07-25,1,Jul,12,0,Wed,1,77,233,310
2012-07-25,1,Jul,13,0,Wed,1,81,231,312
2012-07-25,1,Jul,14,0,Wed,1,88,159,247
2012-07-25,1,Jul,15,0,Wed,1,94,223,317
2012-07-25,1,Jul,16,0,Wed,1,91,393,484
2012-07-25,1,Jul,17,0,Wed,1,130,783,913
2012-07-25,1,Jul,18,0,Wed,1,104,787,891
2012-07-25,1,Jul,19,0,Wed,1,116,582,698
2012-07-25,1,Jul,20,0,Wed,1,106,461,567
2012-07-25,1,Jul,21,0,Wed,1,71,326,397
2012-07-25,1,Jul,22,0,Wed,1,55,223,278
2012-07-25,1,Jul,23,0,Wed,1,52,187,239
2012-07-26,1,Jul,0,0,Thur,1,27,65,92
2012-07-26,1,Jul,1,0,Thur,1,6,23,29
2012-07-26,1,Jul,2,0,Thur,1,5,16,21
2012-07-26,1,Jul,3,0,Thur,1,0,8,8
2012-07-26,1,Jul,4,0,Thur,1,0,4,4
2012-07-26,1,Jul,5,0,Thur,1,2,40,42
2012-07-26,1,Jul,6,0,Thur,1,16,165,181
2012-07-26,1,Jul,7,0,Thur,1,17,478,495
2012-07-26,1,Jul,8,0,Thur,1,49,680,729
2012-07-26,1,Jul,9,0,Thur,1,55,289,344
2012-07-26,1,Jul,10,0,Thur,1,79,143,222
2012-07-26,1,Jul,11,0,Thur,1,69,143,212
2012-07-26,1,Jul,12,0,Thur,1,73,206,279
2012-07-26,1,Jul,13,0,Thur,1,53,189,242
2012-07-26,1,Jul,14,0,Thur,1,62,151,213
2012-07-26,1,Jul,15,0,Thur,1,65,173,238
2012-07-26,1,Jul,16,0,Thur,1,62,312,374
2012-07-26,1,Jul,17,0,Thur,1,110,628,738
2012-07-26,1,Jul,18,0,Thur,1,73,615,688
2012-07-26,1,Jul,19,0,Thur,1,80,534,614
2012-07-26,1,Jul,20,0,Thur,1,47,399,446
2012-07-26,1,Jul,21,0,Thur,1,35,236,271
2012-07-26,1,Jul,22,0,Thur,1,33,201,234
2012-07-26,1,Jul,23,0,Thur,1,18,127,145
2012-07-27,1,Jul,0,0,Fri,1,14,83,97
2012-07-27,1,Jul,1,0,Fri,1,12,42,54
2012-07-27,1,Jul,2,0,Fri,1,8,18,26
2012-07-27,1,Jul,3,0,Fri,1,3,9,12
2012-07-27,1,Jul,4,0,Fri,1,3,5,8
2012-07-27,1,Jul,5,0,Fri,1,3,34,37
2012-07-27,1,Jul,6,0,Fri,1,10,129,139
2012-07-27,1,Jul,7,0,Fri,1,13,397,410
2012-07-27,1,Jul,8,0,Fri,1,34,642,676
2012-07-27,1,Jul,9,0,Fri,1,34,329,363
2012-07-27,1,Jul,10,0,Fri,1,85,146,231
2012-07-27,1,Jul,11,0,Fri,1,67,184,251
2012-07-27,1,Jul,12,0,Fri,1,92,207,299
2012-07-27,1,Jul,13,0,Fri,1,83,231,314
2012-07-27,1,Jul,14,0,Fri,1,105,221,326
2012-07-27,1,Jul,15,0,Fri,1,81,242,323
2012-07-27,1,Jul,16,0,Fri,1,80,419,499
2012-07-27,1,Jul,17,0,Fri,1,101,598,699
2012-07-27,1,Jul,18,0,Fri,1,100,522,622
2012-07-27,1,Jul,19,0,Fri,1,93,423,516
2012-07-27,1,Jul,20,0,Fri,1,85,269,354
2012-07-27,1,Jul,21,0,Fri,1,71,189,260
2012-07-27,1,Jul,22,0,Fri,1,48,151,199
2012-07-27,1,Jul,23,0,Fri,1,34,155,189
2012-07-28,1,Jul,0,0,Sat,0,21,170,191
2012-07-28,1,Jul,1,0,Sat,0,11,69,80
2012-07-28,1,Jul,2,0,Sat,0,14,76,90
2012-07-28,1,Jul,3,0,Sat,0,10,33,43
2012-07-28,1,Jul,4,0,Sat,0,1,10,11
2012-07-28,1,Jul,5,0,Sat,0,4,10,14
2012-07-28,1,Jul,6,0,Sat,0,10,40,50
2012-07-28,1,Jul,7,0,Sat,0,18,58,76
2012-07-28,1,Jul,8,0,Sat,0,36,127,163
2012-07-28,1,Jul,9,0,Sat,0,110,227,337
2012-07-28,1,Jul,10,0,Sat,0,129,266,395
2012-07-28,1,Jul,11,0,Sat,0,162,295,457
2012-07-28,1,Jul,12,0,Sat,0,157,330,487
2012-07-28,1,Jul,13,0,Sat,0,173,325,498
2012-07-28,1,Jul,14,0,Sat,0,186,308,494
2012-07-28,1,Jul,15,0,Sat,0,206,291,497
2012-07-28,1,Jul,16,0,Sat,0,208,279,487
2012-07-28,1,Jul,17,0,Sat,0,199,280,479
2012-07-28,1,Jul,18,0,Sat,0,151,330,481
2012-07-28,1,Jul,19,0,Sat,0,115,223,338
2012-07-28,1,Jul,20,0,Sat,0,79,154,233
2012-07-28,1,Jul,21,0,Sat,0,94,206,300
2012-07-28,1,Jul,22,0,Sat,0,88,188,276
2012-07-28,1,Jul,23,0,Sat,0,52,156,208
2012-07-29,1,Jul,0,0,Sun,0,59,129,188
2012-07-29,1,Jul,1,0,Sun,0,49,109,158
2012-07-29,1,Jul,2,0,Sun,0,33,79,112
2012-07-29,1,Jul,3,0,Sun,0,18,37,55
2012-07-29,1,Jul,4,0,Sun,0,2,11,13
2012-07-29,1,Jul,5,0,Sun,0,3,14,17
2012-07-29,1,Jul,6,0,Sun,0,6,12,18
2012-07-29,1,Jul,7,0,Sun,0,4,36,40
2012-07-29,1,Jul,8,0,Sun,0,37,90,127
2012-07-29,1,Jul,9,0,Sun,0,64,162,226
2012-07-29,1,Jul,10,0,Sun,0,123,258,381
2012-07-29,1,Jul,11,0,Sun,0,183,326,509
2012-07-29,1,Jul,12,0,Sun,0,154,357,511
2012-07-29,1,Jul,13,0,Sun,0,181,302,483
2012-07-29,1,Jul,14,0,Sun,0,231,291,522
2012-07-29,1,Jul,15,0,Sun,0,195,306,501
2012-07-29,1,Jul,16,0,Sun,0,191,330,521
2012-07-29,1,Jul,17,0,Sun,0,164,367,531
2012-07-29,1,Jul,18,0,Sun,0,117,302,419
2012-07-29,1,Jul,19,0,Sun,0,143,300,443
2012-07-29,1,Jul,20,0,Sun,0,75,228,303
2012-07-29,1,Jul,21,0,Sun,0,72,199,271
2012-07-29,1,Jul,22,0,Sun,0,31,117,148
2012-07-29,1,Jul,23,0,Sun,0,18,82,100
2012-07-30,1,Jul,0,0,Mon,1,12,46,58
2012-07-30,1,Jul,1,0,Mon,1,4,15,19
2012-07-30,1,Jul,2,0,Mon,1,2,6,8
2012-07-30,1,Jul,3,0,Mon,1,0,3,3
2012-07-30,1,Jul,4,0,Mon,1,0,5,5
2012-07-30,1,Jul,5,0,Mon,1,4,43,47
2012-07-30,1,Jul,6,0,Mon,1,6,155,161
2012-07-30,1,Jul,7,0,Mon,1,14,455,469
2012-07-30,1,Jul,8,0,Mon,1,31,720,751
2012-07-30,1,Jul,9,0,Mon,1,34,259,293
2012-07-30,1,Jul,10,0,Mon,1,54,135,189
2012-07-30,1,Jul,11,0,Mon,1,69,146,215
2012-07-30,1,Jul,12,0,Mon,1,77,201,278
2012-07-30,1,Jul,13,0,Mon,1,57,169,226
2012-07-30,1,Jul,14,0,Mon,1,87,167,254
2012-07-30,1,Jul,15,0,Mon,1,51,185,236
2012-07-30,1,Jul,16,0,Mon,1,88,337,425
2012-07-30,1,Jul,17,0,Mon,1,62,765,827
2012-07-30,1,Jul,18,0,Mon,1,77,735,812
2012-07-30,1,Jul,19,0,Mon,1,81,584,665
2012-07-30,1,Jul,20,0,Mon,1,78,384,462
2012-07-30,1,Jul,21,0,Mon,1,71,251,322
2012-07-30,1,Jul,22,0,Mon,1,47,183,230
2012-07-30,1,Jul,23,0,Mon,1,34,116,150
2012-07-31,1,Jul,0,0,Tue,1,11,27,38
2012-07-31,1,Jul,1,0,Tue,1,3,18,21
2012-07-31,1,Jul,2,0,Tue,1,0,8,8
2012-07-31,1,Jul,3,0,Tue,1,1,5,6
2012-07-31,1,Jul,4,0,Tue,1,0,6,6
2012-07-31,1,Jul,5,0,Tue,1,5,40,45
2012-07-31,1,Jul,6,0,Tue,1,2,192,194
2012-07-31,1,Jul,7,0,Tue,1,21,492,513
2012-07-31,1,Jul,8,0,Tue,1,30,730,760
2012-07-31,1,Jul,9,0,Tue,1,31,302,333
2012-07-31,1,Jul,10,0,Tue,1,73,154,227
2012-07-31,1,Jul,11,0,Tue,1,54,170,224
2012-07-31,1,Jul,12,0,Tue,1,50,198,248
2012-07-31,1,Jul,13,0,Tue,1,69,219,288
2012-07-31,1,Jul,14,0,Tue,1,72,188,260
2012-07-31,1,Jul,15,0,Tue,1,29,115,144
2012-07-31,1,Jul,16,0,Tue,1,66,336,402
2012-07-31,1,Jul,17,0,Tue,1,94,726,820
2012-07-31,1,Jul,18,0,Tue,1,99,758,857
2012-07-31,1,Jul,19,0,Tue,1,90,524,614
2012-07-31,1,Jul,20,0,Tue,1,55,397,452
2012-07-31,1,Jul,21,0,Tue,1,60,292,352
2012-07-31,1,Jul,22,0,Tue,1,33,224,257
2012-07-31,1,Jul,23,0,Tue,1,20,127,147
2012-08-01,1,Aug,0,0,Wed,1,3,44,47
2012-08-01,1,Aug,1,0,Wed,1,5,28,33
2012-08-01,1,Aug,2,0,Wed,1,0,13,13
2012-08-01,1,Aug,3,0,Wed,1,0,7,7
2012-08-01,1,Aug,4,0,Wed,1,1,3,4
2012-08-01,1,Aug,5,0,Wed,1,3,46,49
2012-08-01,1,Aug,6,0,Wed,1,6,179,185
2012-08-01,1,Aug,7,0,Wed,1,19,468,487
2012-08-01,1,Aug,8,0,Wed,1,32,649,681
2012-08-01,1,Aug,9,0,Wed,1,34,316,350
2012-08-01,1,Aug,10,0,Wed,1,61,175,236
2012-08-01,1,Aug,11,0,Wed,1,54,180,234
2012-08-01,1,Aug,12,0,Wed,1,75,209,284
2012-08-01,1,Aug,13,0,Wed,1,59,221,280
2012-08-01,1,Aug,14,0,Wed,1,88,175,263
2012-08-01,1,Aug,15,0,Wed,1,89,206,295
2012-08-01,1,Aug,16,0,Wed,1,93,386,479
2012-08-01,1,Aug,17,0,Wed,1,103,734,837
2012-08-01,1,Aug,18,0,Wed,1,105,786,891
2012-08-01,1,Aug,19,0,Wed,1,88,564,652
2012-08-01,1,Aug,20,0,Wed,1,65,448,513
2012-08-01,1,Aug,21,0,Wed,1,36,284,320
2012-08-01,1,Aug,22,0,Wed,1,37,251,288
2012-08-01,1,Aug,23,0,Wed,1,18,134,152
2012-08-02,1,Aug,0,0,Thur,1,8,55,63
2012-08-02,1,Aug,1,0,Thur,1,6,36,42
2012-08-02,1,Aug,2,0,Thur,1,3,8,11
2012-08-02,1,Aug,3,0,Thur,1,0,6,6
2012-08-02,1,Aug,4,0,Thur,1,0,9,9
2012-08-02,1,Aug,5,0,Thur,1,4,37,41
2012-08-02,1,Aug,6,0,Thur,1,6,177,183
2012-08-02,1,Aug,7,0,Thur,1,21,452,473
2012-08-02,1,Aug,8,0,Thur,1,21,718,739
2012-08-02,1,Aug,9,0,Thur,1,31,312,343
2012-08-02,1,Aug,10,0,Thur,1,51,130,181
2012-08-02,1,Aug,11,0,Thur,1,59,167,226
2012-08-02,1,Aug,12,0,Thur,1,56,230,286
2012-08-02,1,Aug,13,0,Thur,1,98,212,310
2012-08-02,1,Aug,14,0,Thur,1,54,171,225
2012-08-02,1,Aug,15,0,Thur,1,68,202,270
2012-08-02,1,Aug,16,0,Thur,1,71,335,406
2012-08-02,1,Aug,17,0,Thur,1,90,775,865
2012-08-02,1,Aug,18,0,Thur,1,86,681,767
2012-08-02,1,Aug,19,0,Thur,1,98,509,607
2012-08-02,1,Aug,20,0,Thur,1,51,376,427
2012-08-02,1,Aug,21,0,Thur,1,41,301,342
2012-08-02,1,Aug,22,0,Thur,1,35,227,262
2012-08-02,1,Aug,23,0,Thur,1,25,152,177
2012-08-03,1,Aug,0,0,Fri,1,15,56,71
2012-08-03,1,Aug,1,0,Fri,1,11,32,43
2012-08-03,1,Aug,2,0,Fri,1,0,14,14
2012-08-03,1,Aug,3,0,Fri,1,1,5,6
2012-08-03,1,Aug,4,0,Fri,1,1,11,12
2012-08-03,1,Aug,5,0,Fri,1,2,35,37
2012-08-03,1,Aug,6,0,Fri,1,5,158,163
2012-08-03,1,Aug,7,0,Fri,1,25,396,421
2012-08-03,1,Aug,8,0,Fri,1,32,636,668
2012-08-03,1,Aug,9,0,Fri,1,69,327,396
2012-08-03,1,Aug,10,0,Fri,1,82,167,249
2012-08-03,1,Aug,11,0,Fri,1,77,186,263
2012-08-03,1,Aug,12,0,Fri,1,95,243,338
2012-08-03,1,Aug,13,0,Fri,1,98,247,345
2012-08-03,1,Aug,14,0,Fri,1,102,229,331
2012-08-03,1,Aug,15,0,Fri,1,112,268,380
2012-08-03,1,Aug,16,0,Fri,1,112,380,492
2012-08-03,1,Aug,17,0,Fri,1,95,646,741
2012-08-03,1,Aug,18,0,Fri,1,98,573,671
2012-08-03,1,Aug,19,0,Fri,1,81,388,469
2012-08-03,1,Aug,20,0,Fri,1,89,300,389
2012-08-03,1,Aug,21,0,Fri,1,54,224,278
2012-08-03,1,Aug,22,0,Fri,1,46,156,202
2012-08-03,1,Aug,23,0,Fri,1,26,170,196
2012-08-04,1,Aug,0,0,Sat,0,24,137,161
2012-08-04,1,Aug,1,0,Sat,0,23,99,122
2012-08-04,1,Aug,2,0,Sat,0,20,64,84
2012-08-04,1,Aug,3,0,Sat,0,11,19,30
2012-08-04,1,Aug,4,0,Sat,0,2,11,13
2012-08-04,1,Aug,5,0,Sat,0,1,16,17
2012-08-04,1,Aug,6,0,Sat,0,12,37,49
2012-08-04,1,Aug,7,0,Sat,0,18,49,67
2012-08-04,1,Aug,8,0,Sat,0,49,132,181
2012-08-04,1,Aug,9,0,Sat,0,61,217,278
2012-08-04,1,Aug,10,0,Sat,0,108,288,396
2012-08-04,1,Aug,11,0,Sat,0,155,315,470
2012-08-04,1,Aug,12,0,Sat,0,222,325,547
2012-08-04,1,Aug,13,0,Sat,0,195,332,527
2012-08-04,1,Aug,14,0,Sat,0,183,289,472
2012-08-04,1,Aug,15,0,Sat,0,205,284,489
2012-08-04,1,Aug,16,0,Sat,0,197,253,450
2012-08-04,1,Aug,17,0,Sat,0,179,313,492
2012-08-04,1,Aug,18,0,Sat,0,169,321,490
2012-08-04,1,Aug,19,0,Sat,0,133,264,397
2012-08-04,1,Aug,20,0,Sat,0,117,195,312
2012-08-04,1,Aug,21,0,Sat,0,96,193,289
2012-08-04,1,Aug,22,0,Sat,0,104,165,269
2012-08-04,1,Aug,23,0,Sat,0,61,161,222
2012-08-05,1,Aug,0,0,Sun,0,32,121,153
2012-08-05,1,Aug,1,0,Sun,0,8,79,87
2012-08-05,1,Aug,2,0,Sun,0,5,68,73
2012-08-05,1,Aug,3,0,Sun,0,9,32,41
2012-08-05,1,Aug,4,0,Sun,0,3,11,14
2012-08-05,1,Aug,5,0,Sun,0,1,18,19
2012-08-05,1,Aug,6,0,Sun,0,7,12,19
2012-08-05,1,Aug,7,0,Sun,0,18,50,68
2012-08-05,1,Aug,8,0,Sun,0,27,81,108
2012-08-05,1,Aug,9,0,Sun,0,61,168,229
2012-08-05,1,Aug,10,0,Sun,0,111,253,364
2012-08-05,1,Aug,11,0,Sun,0,155,282,437
2012-08-05,1,Aug,12,0,Sun,0,161,330,491
2012-08-05,1,Aug,13,0,Sun,0,208,315,523
2012-08-05,1,Aug,14,0,Sun,0,161,365,526
2012-08-05,1,Aug,15,0,Sun,0,164,286,450
2012-08-05,1,Aug,16,0,Sun,0,143,278,421
2012-08-05,1,Aug,17,0,Sun,0,122,260,382
2012-08-05,1,Aug,18,0,Sun,0,75,154,229
2012-08-05,1,Aug,19,0,Sun,0,46,139,185
2012-08-05,1,Aug,20,0,Sun,0,53,140,193
2012-08-05,1,Aug,21,0,Sun,0,51,157,208
2012-08-05,1,Aug,22,0,Sun,0,57,100,157
2012-08-05,1,Aug,23,0,Sun,0,29,58,87
2012-08-06,1,Aug,0,0,Mon,1,9,24,33
2012-08-06,1,Aug,1,0,Mon,1,1,10,11
2012-08-06,1,Aug,2,0,Mon,1,0,5,5
2012-08-06,1,Aug,3,0,Mon,1,0,5,5
2012-08-06,1,Aug,4,0,Mon,1,3,8,11
2012-08-06,1,Aug,5,0,Mon,1,2,23,25
2012-08-06,1,Aug,6,0,Mon,1,4,137,141
2012-08-06,1,Aug,7,0,Mon,1,14,393,407
2012-08-06,1,Aug,8,0,Mon,1,27,578,605
2012-08-06,1,Aug,9,0,Mon,1,28,248,276
2012-08-06,1,Aug,10,0,Mon,1,54,159,213
2012-08-06,1,Aug,11,0,Mon,1,108,152,260
2012-08-06,1,Aug,12,0,Mon,1,72,213,285
2012-08-06,1,Aug,13,0,Mon,1,85,204,289
2012-08-06,1,Aug,14,0,Mon,1,99,188,287
2012-08-06,1,Aug,15,0,Mon,1,91,183,274
2012-08-06,1,Aug,16,0,Mon,1,88,363,451
2012-08-06,1,Aug,17,0,Mon,1,112,746,858
2012-08-06,1,Aug,18,0,Mon,1,100,743,843
2012-08-06,1,Aug,19,0,Mon,1,109,531,640
2012-08-06,1,Aug,20,0,Mon,1,89,368,457
2012-08-06,1,Aug,21,0,Mon,1,72,245,317
2012-08-06,1,Aug,22,0,Mon,1,50,157,207
2012-08-06,1,Aug,23,0,Mon,1,16,97,113
2012-08-07,1,Aug,0,0,Tue,1,15,32,47
2012-08-07,1,Aug,1,0,Tue,1,2,16,18
2012-08-07,1,Aug,2,0,Tue,1,6,7,13
2012-08-07,1,Aug,3,0,Tue,1,0,6,6
2012-08-07,1,Aug,4,0,Tue,1,2,7,9
2012-08-07,1,Aug,5,0,Tue,1,3,33,36
2012-08-07,1,Aug,6,0,Tue,1,3,176,179
2012-08-07,1,Aug,7,0,Tue,1,21,481,502
2012-08-07,1,Aug,8,0,Tue,1,41,664,705
2012-08-07,1,Aug,9,0,Tue,1,44,283,327
2012-08-07,1,Aug,10,0,Tue,1,89,161,250
2012-08-07,1,Aug,11,0,Tue,1,84,130,214
2012-08-07,1,Aug,12,0,Tue,1,86,197,283
2012-08-07,1,Aug,13,0,Tue,1,68,185,253
2012-08-07,1,Aug,14,0,Tue,1,76,185,261
2012-08-07,1,Aug,15,0,Tue,1,100,206,306
2012-08-07,1,Aug,16,0,Tue,1,101,344,445
2012-08-07,1,Aug,17,0,Tue,1,125,743,868
2012-08-07,1,Aug,18,0,Tue,1,103,711,814
2012-08-07,1,Aug,19,0,Tue,1,104,506,610
2012-08-07,1,Aug,20,0,Tue,1,74,374,448
2012-08-07,1,Aug,21,0,Tue,1,70,247,317
2012-08-07,1,Aug,22,0,Tue,1,43,181,224
2012-08-07,1,Aug,23,0,Tue,1,18,120,138
2012-08-08,1,Aug,0,0,Wed,1,12,46,58
2012-08-08,1,Aug,1,0,Wed,1,3,20,23
2012-08-08,1,Aug,2,0,Wed,1,1,5,6
2012-08-08,1,Aug,3,0,Wed,1,1,6,7
2012-08-08,1,Aug,4,0,Wed,1,1,6,7
2012-08-08,1,Aug,5,0,Wed,1,3,40,43
2012-08-08,1,Aug,6,0,Wed,1,4,169,173
2012-08-08,1,Aug,7,0,Wed,1,24,458,482
2012-08-08,1,Aug,8,0,Wed,1,48,689,737
2012-08-08,1,Aug,9,0,Wed,1,33,308,341
2012-08-08,1,Aug,10,0,Wed,1,63,151,214
2012-08-08,1,Aug,11,0,Wed,1,80,159,239
2012-08-08,1,Aug,12,0,Wed,1,63,217,280
2012-08-08,1,Aug,13,0,Wed,1,101,212,313
2012-08-08,1,Aug,14,0,Wed,1,63,173,236
2012-08-08,1,Aug,15,0,Wed,1,110,168,278
2012-08-08,1,Aug,16,0,Wed,1,113,328,441
2012-08-08,1,Aug,17,0,Wed,1,107,751,858
2012-08-08,1,Aug,18,0,Wed,1,117,745,862
2012-08-08,1,Aug,19,0,Wed,1,119,567,686
2012-08-08,1,Aug,20,0,Wed,1,76,424,500
2012-08-08,1,Aug,21,0,Wed,1,70,311,381
2012-08-08,1,Aug,22,0,Wed,1,35,198,233
2012-08-08,1,Aug,23,0,Wed,1,16,120,136
2012-08-09,1,Aug,0,0,Thur,1,16,51,67
2012-08-09,1,Aug,1,0,Thur,1,5,23,28
2012-08-09,1,Aug,2,0,Thur,1,2,12,14
2012-08-09,1,Aug,3,0,Thur,1,1,5,6
2012-08-09,1,Aug,4,0,Thur,1,0,10,10
2012-08-09,1,Aug,5,0,Thur,1,4,37,41
2012-08-09,1,Aug,6,0,Thur,1,5,162,167
2012-08-09,1,Aug,7,0,Thur,1,24,451,475
2012-08-09,1,Aug,8,0,Thur,1,28,670,698
2012-08-09,1,Aug,9,0,Thur,1,54,299,353
2012-08-09,1,Aug,10,0,Thur,1,72,133,205
2012-08-09,1,Aug,11,0,Thur,1,94,166,260
2012-08-09,1,Aug,12,0,Thur,1,85,192,277
2012-08-09,1,Aug,13,0,Thur,1,80,201,281
2012-08-09,1,Aug,14,0,Thur,1,86,161,247
2012-08-09,1,Aug,15,0,Thur,1,63,204,267
2012-08-09,1,Aug,16,0,Thur,1,97,320,417
2012-08-09,1,Aug,17,0,Thur,1,111,699,810
2012-08-09,1,Aug,18,0,Thur,1,78,733,811
2012-08-09,1,Aug,19,0,Thur,1,90,533,623
2012-08-09,1,Aug,20,0,Thur,1,91,387,478
2012-08-09,1,Aug,21,0,Thur,1,50,286,336
2012-08-09,1,Aug,22,0,Thur,1,41,218,259
2012-08-09,1,Aug,23,0,Thur,1,19,137,156
2012-08-10,1,Aug,0,0,Fri,1,17,68,85
2012-08-10,1,Aug,1,0,Fri,1,6,35,41
2012-08-10,1,Aug,2,0,Fri,1,6,14,20
2012-08-10,1,Aug,3,0,Fri,1,3,6,9
2012-08-10,1,Aug,4,0,Fri,1,0,7,7
2012-08-10,1,Aug,5,0,Fri,1,4,29,33
2012-08-10,1,Aug,6,0,Fri,1,3,41,44
2012-08-10,1,Aug,7,0,Fri,1,5,128,133
2012-08-10,1,Aug,8,0,Fri,1,7,112,119
2012-08-10,1,Aug,9,0,Fri,1,21,199,220
2012-08-10,1,Aug,10,0,Fri,1,27,166,193
2012-08-10,1,Aug,11,0,Fri,1,73,178,251
2012-08-10,1,Aug,12,0,Fri,1,75,240,315
2012-08-10,1,Aug,13,0,Fri,1,66,224,290
2012-08-10,1,Aug,14,0,Fri,1,71,236,307
2012-08-10,1,Aug,15,0,Fri,1,100,224,324
2012-08-10,1,Aug,16,0,Fri,1,96,371,467
2012-08-10,1,Aug,17,0,Fri,1,111,619,730
2012-08-10,1,Aug,18,0,Fri,1,88,552,640
2012-08-10,1,Aug,19,0,Fri,1,98,394,492
2012-08-10,1,Aug,20,0,Fri,1,55,315,370
2012-08-10,1,Aug,21,0,Fri,1,50,236,286
2012-08-10,1,Aug,22,0,Fri,1,50,168,218
2012-08-10,1,Aug,23,0,Fri,1,33,159,192
2012-08-11,1,Aug,0,0,Sat,0,38,142,180
2012-08-11,1,Aug,1,0,Sat,0,32,84,116
2012-08-11,1,Aug,2,0,Sat,0,19,66,85
2012-08-11,1,Aug,3,0,Sat,0,2,19,21
2012-08-11,1,Aug,4,0,Sat,0,3,7,10
2012-08-11,1,Aug,5,0,Sat,0,2,9,11
2012-08-11,1,Aug,6,0,Sat,0,5,18,23
2012-08-11,1,Aug,7,0,Sat,0,8,54,62
2012-08-11,1,Aug,8,0,Sat,0,30,132,162
2012-08-11,1,Aug,9,0,Sat,0,54,217,271
2012-08-11,1,Aug,10,0,Sat,0,125,282,407
2012-08-11,1,Aug,11,0,Sat,0,203,296,499
2012-08-11,1,Aug,12,0,Sat,0,214,332,546
2012-08-11,1,Aug,13,0,Sat,0,228,341,569
2012-08-11,1,Aug,14,0,Sat,0,248,290,538
2012-08-11,1,Aug,15,0,Sat,0,246,316,562
2012-08-11,1,Aug,16,0,Sat,0,227,304,531
2012-08-11,1,Aug,17,0,Sat,0,220,292,512
2012-08-11,1,Aug,18,0,Sat,0,107,193,300
2012-08-11,1,Aug,19,0,Sat,0,97,178,275
2012-08-11,1,Aug,20,0,Sat,0,31,129,160
2012-08-11,1,Aug,21,0,Sat,0,26,102,128
2012-08-11,1,Aug,22,0,Sat,0,40,128,168
2012-08-11,1,Aug,23,0,Sat,0,42,121,163
2012-08-12,1,Aug,0,0,Sun,0,24,96,120
2012-08-12,1,Aug,1,0,Sun,0,21,92,113
2012-08-12,1,Aug,2,0,Sun,0,19,67,86
2012-08-12,1,Aug,3,0,Sun,0,11,37,48
2012-08-12,1,Aug,4,0,Sun,0,2,8,10
2012-08-12,1,Aug,5,0,Sun,0,1,9,10
2012-08-12,1,Aug,6,0,Sun,0,2,14,16
2012-08-12,1,Aug,7,0,Sun,0,9,30,39
2012-08-12,1,Aug,8,0,Sun,0,35,84,119
2012-08-12,1,Aug,9,0,Sun,0,64,153,217
2012-08-12,1,Aug,10,0,Sun,0,88,240,328
2012-08-12,1,Aug,11,0,Sun,0,167,282,449
2012-08-12,1,Aug,12,0,Sun,0,163,342,505
2012-08-12,1,Aug,13,0,Sun,0,178,365,543
2012-08-12,1,Aug,14,0,Sun,0,213,366,579
2012-08-12,1,Aug,15,0,Sun,0,235,342,577
2012-08-12,1,Aug,16,0,Sun,0,213,300,513
2012-08-12,1,Aug,17,0,Sun,0,186,319,505
2012-08-12,1,Aug,18,0,Sun,0,164,327,491
2012-08-12,1,Aug,19,0,Sun,0,148,317,465
2012-08-12,1,Aug,20,0,Sun,0,96,204,300
2012-08-12,1,Aug,21,0,Sun,0,78,142,220
2012-08-12,1,Aug,22,0,Sun,0,40,141,181
2012-08-12,1,Aug,23,0,Sun,0,25,85,110
2012-08-13,1,Aug,0,0,Mon,1,14,33,47
2012-08-13,1,Aug,1,0,Mon,1,3,11,14
2012-08-13,1,Aug,2,0,Mon,1,1,8,9
2012-08-13,1,Aug,3,0,Mon,1,1,5,6
2012-08-13,1,Aug,4,0,Mon,1,0,11,11
2012-08-13,1,Aug,5,0,Mon,1,3,33,36
2012-08-13,1,Aug,6,0,Mon,1,4,155,159
2012-08-13,1,Aug,7,0,Mon,1,11,425,436
2012-08-13,1,Aug,8,0,Mon,1,25,648,673
2012-08-13,1,Aug,9,0,Mon,1,40,265,305
2012-08-13,1,Aug,10,0,Mon,1,88,111,199
2012-08-13,1,Aug,11,0,Mon,1,94,151,245
2012-08-13,1,Aug,12,0,Mon,1,96,180,276
2012-08-13,1,Aug,13,0,Mon,1,79,175,254
2012-08-13,1,Aug,14,0,Mon,1,85,163,248
2012-08-13,1,Aug,15,0,Mon,1,80,194,274
2012-08-13,1,Aug,16,0,Mon,1,116,348,464
2012-08-13,1,Aug,17,0,Mon,1,102,716,818
2012-08-13,1,Aug,18,0,Mon,1,103,709,812
2012-08-13,1,Aug,19,0,Mon,1,88,467,555
2012-08-13,1,Aug,20,0,Mon,1,58,374,432
2012-08-13,1,Aug,21,0,Mon,1,44,246,290
2012-08-13,1,Aug,22,0,Mon,1,44,148,192
2012-08-13,1,Aug,23,0,Mon,1,28,100,128
2012-08-14,1,Aug,0,0,Tue,1,12,48,60
2012-08-14,1,Aug,1,0,Tue,1,8,19,27
2012-08-14,1,Aug,2,0,Tue,1,2,9,11
2012-08-14,1,Aug,3,0,Tue,1,0,3,3
2012-08-14,1,Aug,4,0,Tue,1,0,5,5
2012-08-14,1,Aug,5,0,Tue,1,1,35,36
2012-08-14,1,Aug,6,0,Tue,1,1,63,64
2012-08-14,1,Aug,7,0,Tue,1,1,178,179
2012-08-14,1,Aug,8,0,Tue,1,27,591,618
2012-08-14,1,Aug,9,0,Tue,1,48,354,402
2012-08-14,1,Aug,10,0,Tue,1,53,155,208
2012-08-14,1,Aug,11,0,Tue,1,69,127,196
2012-08-14,1,Aug,12,0,Tue,1,93,207,300
2012-08-14,1,Aug,13,0,Tue,1,83,203,286
2012-08-14,1,Aug,14,0,Tue,1,80,175,255
2012-08-14,1,Aug,15,0,Tue,1,84,199,283
2012-08-14,1,Aug,16,0,Tue,1,95,363,458
2012-08-14,1,Aug,17,0,Tue,1,78,734,812
2012-08-14,1,Aug,18,0,Tue,1,97,757,854
2012-08-14,1,Aug,19,0,Tue,1,94,533,627
2012-08-14,1,Aug,20,0,Tue,1,65,371,436
2012-08-14,1,Aug,21,0,Tue,1,56,252,308
2012-08-14,1,Aug,22,0,Tue,1,28,161,189
2012-08-14,1,Aug,23,0,Tue,1,53,114,167
2012-08-15,1,Aug,0,0,Wed,1,8,52,60
2012-08-15,1,Aug,1,0,Wed,1,6,31,37
2012-08-15,1,Aug,2,0,Wed,1,1,7,8
2012-08-15,1,Aug,3,0,Wed,1,1,10,11
2012-08-15,1,Aug,4,0,Wed,1,0,4,4
2012-08-15,1,Aug,5,0,Wed,1,4,35,39
2012-08-15,1,Aug,6,0,Wed,1,12,160,172
2012-08-15,1,Aug,7,0,Wed,1,25,467,492
2012-08-15,1,Aug,8,0,Wed,1,40,642,682
2012-08-15,1,Aug,9,0,Wed,1,57,310,367
2012-08-15,1,Aug,10,0,Wed,1,70,163,233
2012-08-15,1,Aug,11,0,Wed,1,80,155,235
2012-08-15,1,Aug,12,0,Wed,1,77,230,307
2012-08-15,1,Aug,13,0,Wed,1,88,206,294
2012-08-15,1,Aug,14,0,Wed,1,94,161,255
2012-08-15,1,Aug,15,0,Wed,1,70,196,266
2012-08-15,1,Aug,16,0,Wed,1,91,340,431
2012-08-15,1,Aug,17,0,Wed,1,102,749,851
2012-08-15,1,Aug,18,0,Wed,1,80,768,848
2012-08-15,1,Aug,19,0,Wed,1,124,525,649
2012-08-15,1,Aug,20,0,Wed,1,72,355,427
2012-08-15,1,Aug,21,0,Wed,1,49,266,315
2012-08-15,1,Aug,22,0,Wed,1,29,197,226
2012-08-15,1,Aug,23,0,Wed,1,18,120,138
2012-08-16,1,Aug,0,0,Thur,1,13,63,76
2012-08-16,1,Aug,1,0,Thur,1,3,18,21
2012-08-16,1,Aug,2,0,Thur,1,0,15,15
2012-08-16,1,Aug,3,0,Thur,1,0,4,4
2012-08-16,1,Aug,4,0,Thur,1,2,3,5
2012-08-16,1,Aug,5,0,Thur,1,7,30,37
2012-08-16,1,Aug,6,0,Thur,1,3,162,165
2012-08-16,1,Aug,7,0,Thur,1,16,448,464
2012-08-16,1,Aug,8,0,Thur,1,33,649,682
2012-08-16,1,Aug,9,0,Thur,1,41,296,337
2012-08-16,1,Aug,10,0,Thur,1,78,121,199
2012-08-16,1,Aug,11,0,Thur,1,83,191,274
2012-08-16,1,Aug,12,0,Thur,1,96,247,343
2012-08-16,1,Aug,13,0,Thur,1,81,219,300
2012-08-16,1,Aug,14,0,Thur,1,72,176,248
2012-08-16,1,Aug,15,0,Thur,1,63,197,260
2012-08-16,1,Aug,16,0,Thur,1,79,340,419
2012-08-16,1,Aug,17,0,Thur,1,130,767,897
2012-08-16,1,Aug,18,0,Thur,1,109,723,832
2012-08-16,1,Aug,19,0,Thur,1,119,558,677
2012-08-16,1,Aug,20,0,Thur,1,100,414,514
2012-08-16,1,Aug,21,0,Thur,1,83,273,356
2012-08-16,1,Aug,22,0,Thur,1,69,185,254
2012-08-16,1,Aug,23,0,Thur,1,58,168,226
2012-08-17,1,Aug,0,0,Fri,1,21,67,88
2012-08-17,1,Aug,1,0,Fri,1,16,38,54
2012-08-17,1,Aug,2,0,Fri,1,4,15,19
2012-08-17,1,Aug,3,0,Fri,1,0,6,6
2012-08-17,1,Aug,4,0,Fri,1,0,9,9
2012-08-17,1,Aug,5,0,Fri,1,2,34,36
2012-08-17,1,Aug,6,0,Fri,1,6,151,157
2012-08-17,1,Aug,7,0,Fri,1,11,368,379
2012-08-17,1,Aug,8,0,Fri,1,43,625,668
2012-08-17,1,Aug,9,0,Fri,1,58,320,378
2012-08-17,1,Aug,10,0,Fri,1,82,149,231
2012-08-17,1,Aug,11,0,Fri,1,98,205,303
2012-08-17,1,Aug,12,0,Fri,1,110,255,365
2012-08-17,1,Aug,13,0,Fri,1,103,254,357
2012-08-17,1,Aug,14,0,Fri,1,128,200,328
2012-08-17,1,Aug,15,0,Fri,1,127,256,383
2012-08-17,1,Aug,16,0,Fri,1,116,372,488
2012-08-17,1,Aug,17,0,Fri,1,144,647,791
2012-08-17,1,Aug,18,0,Fri,1,108,561,669
2012-08-17,1,Aug,19,0,Fri,1,88,403,491
2012-08-17,1,Aug,20,0,Fri,1,97,262,359
2012-08-17,1,Aug,21,0,Fri,1,57,198,255
2012-08-17,1,Aug,22,0,Fri,1,43,170,213
2012-08-17,1,Aug,23,0,Fri,1,21,100,121
2012-08-18,1,Aug,0,0,Sat,0,6,99,105
2012-08-18,1,Aug,1,0,Sat,0,14,78,92
2012-08-18,1,Aug,2,0,Sat,0,4,39,43
2012-08-18,1,Aug,3,0,Sat,0,7,23,30
2012-08-18,1,Aug,4,0,Sat,0,5,8,13
2012-08-18,1,Aug,5,0,Sat,0,2,7,9
2012-08-18,1,Aug,6,0,Sat,0,4,23,27
2012-08-18,1,Aug,7,0,Sat,0,12,52,64
2012-08-18,1,Aug,8,0,Sat,0,28,161,189
2012-08-18,1,Aug,9,0,Sat,0,81,211,292
2012-08-18,1,Aug,10,0,Sat,0,166,314,480
2012-08-18,1,Aug,11,0,Sat,0,180,356,536
2012-08-18,1,Aug,12,0,Sat,0,266,388,654
2012-08-18,1,Aug,13,0,Sat,0,289,355,644
2012-08-18,1,Aug,14,0,Sat,0,242,356,598
2012-08-18,1,Aug,15,0,Sat,0,250,346,596
2012-08-18,1,Aug,16,0,Sat,0,287,354,641
2012-08-18,1,Aug,17,0,Sat,0,256,379,635
2012-08-18,1,Aug,18,0,Sat,0,225,329,554
2012-08-18,1,Aug,19,0,Sat,0,164,324,488
2012-08-18,1,Aug,20,0,Sat,0,99,242,341
2012-08-18,1,Aug,21,0,Sat,0,90,248,338
2012-08-18,1,Aug,22,0,Sat,0,90,171,261
2012-08-18,1,Aug,23,0,Sat,0,60,175,235
2012-08-19,1,Aug,0,0,Sun,0,44,143,187
2012-08-19,1,Aug,1,0,Sun,0,29,102,131
2012-08-19,1,Aug,2,0,Sun,0,16,103,119
2012-08-19,1,Aug,3,0,Sun,0,21,34,55
2012-08-19,1,Aug,4,0,Sun,0,4,22,26
2012-08-19,1,Aug,5,0,Sun,0,3,8,11
2012-08-19,1,Aug,6,0,Sun,0,5,15,20
2012-08-19,1,Aug,7,0,Sun,0,12,29,41
2012-08-19,1,Aug,8,0,Sun,0,34,90,124
2012-08-19,1,Aug,9,0,Sun,0,86,184,270
2012-08-19,1,Aug,10,0,Sun,0,138,287,425
2012-08-19,1,Aug,11,0,Sun,0,83,189,272
2012-08-19,1,Aug,12,0,Sun,0,112,186,298
2012-08-19,1,Aug,13,0,Sun,0,50,112,162
2012-08-19,1,Aug,14,0,Sun,0,41,108,149
2012-08-19,1,Aug,15,0,Sun,0,89,187,276
2012-08-19,1,Aug,16,0,Sun,0,97,259,356
2012-08-19,1,Aug,17,0,Sun,0,76,267,343
2012-08-19,1,Aug,18,0,Sun,0,86,291,377
2012-08-19,1,Aug,19,0,Sun,0,72,269,341
2012-08-19,1,Aug,20,0,Sun,0,61,213,274
2012-08-19,1,Aug,21,0,Sun,0,36,154,190
2012-08-19,1,Aug,22,0,Sun,0,6,50,56
2012-08-19,1,Aug,23,0,Sun,0,7,39,46
2012-08-20,1,Aug,0,0,Mon,1,1,25,26
2012-08-20,1,Aug,1,0,Mon,1,0,10,10
2012-08-20,1,Aug,2,0,Mon,1,0,5,5
2012-08-20,1,Aug,3,0,Mon,1,0,3,3
2012-08-20,1,Aug,4,0,Mon,1,0,7,7
2012-08-20,1,Aug,5,0,Mon,1,2,35,37
2012-08-20,1,Aug,6,0,Mon,1,6,155,161
2012-08-20,1,Aug,7,0,Mon,1,15,427,442
2012-08-20,1,Aug,8,0,Mon,1,37,618,655
2012-08-20,1,Aug,9,0,Mon,1,55,302,357
2012-08-20,1,Aug,10,0,Mon,1,69,124,193
2012-08-20,1,Aug,11,0,Mon,1,90,151,241
2012-08-20,1,Aug,12,0,Mon,1,66,216,282
2012-08-20,1,Aug,13,0,Mon,1,97,194,291
2012-08-20,1,Aug,14,0,Mon,1,87,188,275
2012-08-20,1,Aug,15,0,Mon,1,102,207,309
2012-08-20,1,Aug,16,0,Mon,1,103,357,460
2012-08-20,1,Aug,17,0,Mon,1,83,810,893
2012-08-20,1,Aug,18,0,Mon,1,89,726,815
2012-08-20,1,Aug,19,0,Mon,1,33,266,299
2012-08-20,1,Aug,20,0,Mon,1,30,231,261
2012-08-20,1,Aug,21,0,Mon,1,26,219,245
2012-08-20,1,Aug,22,0,Mon,1,25,136,161
2012-08-20,1,Aug,23,0,Mon,1,10,92,102
2012-08-21,1,Aug,0,0,Tue,1,7,52,59
2012-08-21,1,Aug,1,0,Tue,1,11,22,33
2012-08-21,1,Aug,2,0,Tue,1,1,7,8
2012-08-21,1,Aug,3,0,Tue,1,0,3,3
2012-08-21,1,Aug,4,0,Tue,1,0,4,4
2012-08-21,1,Aug,5,0,Tue,1,4,30,34
2012-08-21,1,Aug,6,0,Tue,1,5,164,169
2012-08-21,1,Aug,7,0,Tue,1,19,500,519
2012-08-21,1,Aug,8,0,Tue,1,27,696,723
2012-08-21,1,Aug,9,0,Tue,1,47,281,328
2012-08-21,1,Aug,10,0,Tue,1,58,120,178
2012-08-21,1,Aug,11,0,Tue,1,61,195,256
2012-08-21,1,Aug,12,0,Tue,1,79,226,305
2012-08-21,1,Aug,13,0,Tue,1,76,255,331
2012-08-21,1,Aug,14,0,Tue,1,110,192,302
2012-08-21,1,Aug,15,0,Tue,1,76,226,302
2012-08-21,1,Aug,16,0,Tue,1,109,358,467
2012-08-21,1,Aug,17,0,Tue,1,92,786,878
2012-08-21,1,Aug,18,0,Tue,1,93,532,625
2012-08-21,1,Aug,19,0,Tue,1,56,420,476
2012-08-21,1,Aug,20,0,Tue,1,62,296,358
2012-08-21,1,Aug,21,0,Tue,1,41,239,280
2012-08-21,1,Aug,22,0,Tue,1,24,208,232
2012-08-21,1,Aug,23,0,Tue,1,23,113,136
2012-08-22,1,Aug,0,0,Wed,1,9,46,55
2012-08-22,1,Aug,1,0,Wed,1,1,20,21
2012-08-22,1,Aug,2,0,Wed,1,7,10,17
2012-08-22,1,Aug,3,0,Wed,1,0,7,7
2012-08-22,1,Aug,4,0,Wed,1,1,7,8
2012-08-22,1,Aug,5,0,Wed,1,2,38,40
2012-08-22,1,Aug,6,0,Wed,1,12,175,187
2012-08-22,1,Aug,7,0,Wed,1,16,537,553
2012-08-22,1,Aug,8,0,Wed,1,37,703,740
2012-08-22,1,Aug,9,0,Wed,1,41,335,376
2012-08-22,1,Aug,10,0,Wed,1,66,159,225
2012-08-22,1,Aug,11,0,Wed,1,71,196,267
2012-08-22,1,Aug,12,0,Wed,1,59,253,312
2012-08-22,1,Aug,13,0,Wed,1,74,242,316
2012-08-22,1,Aug,14,0,Wed,1,82,184,266
2012-08-22,1,Aug,15,0,Wed,1,94,222,316
2012-08-22,1,Aug,16,0,Wed,1,102,358,460
2012-08-22,1,Aug,17,0,Wed,1,72,711,783
2012-08-22,1,Aug,18,0,Wed,1,91,592,683
2012-08-22,1,Aug,19,0,Wed,1,56,524,580
2012-08-22,1,Aug,20,0,Wed,1,59,332,391
2012-08-22,1,Aug,21,0,Wed,1,60,291,351
2012-08-22,1,Aug,22,0,Wed,1,55,226,281
2012-08-22,1,Aug,23,0,Wed,1,27,113,140
2012-08-23,1,Aug,0,0,Thur,1,9,51,60
2012-08-23,1,Aug,1,0,Thur,1,10,15,25
2012-08-23,1,Aug,2,0,Thur,1,9,11,20
2012-08-23,1,Aug,3,0,Thur,1,3,6,9
2012-08-23,1,Aug,4,0,Thur,1,0,6,6
2012-08-23,1,Aug,5,0,Thur,1,1,36,37
2012-08-23,1,Aug,6,0,Thur,1,14,178,192
2012-08-23,1,Aug,7,0,Thur,1,18,463,481
2012-08-23,1,Aug,8,0,Thur,1,45,662,707
2012-08-23,1,Aug,9,0,Thur,1,58,354,412
2012-08-23,1,Aug,10,0,Thur,1,76,157,233
2012-08-23,1,Aug,11,0,Thur,1,86,192,278
2012-08-23,1,Aug,12,0,Thur,1,97,235,332
2012-08-23,1,Aug,13,0,Thur,1,93,253,346
2012-08-23,1,Aug,14,0,Thur,1,114,191,305
2012-08-23,1,Aug,15,0,Thur,1,104,201,305
2012-08-23,1,Aug,16,0,Thur,1,121,344,465
2012-08-23,1,Aug,17,0,Thur,1,111,709,820
2012-08-23,1,Aug,18,0,Thur,1,130,811,941
2012-08-23,1,Aug,19,0,Thur,1,96,537,633
2012-08-23,1,Aug,20,0,Thur,1,70,404,474
2012-08-23,1,Aug,21,0,Thur,1,53,276,329
2012-08-23,1,Aug,22,0,Thur,1,21,177,198
2012-08-23,1,Aug,23,0,Thur,1,24,133,157
2012-08-24,1,Aug,0,0,Fri,1,27,84,111
2012-08-24,1,Aug,1,0,Fri,1,5,37,42
2012-08-24,1,Aug,2,0,Fri,1,1,15,16
2012-08-24,1,Aug,3,0,Fri,1,2,6,8
2012-08-24,1,Aug,4,0,Fri,1,2,6,8
2012-08-24,1,Aug,5,0,Fri,1,1,37,38
2012-08-24,1,Aug,6,0,Fri,1,9,142,151
2012-08-24,1,Aug,7,0,Fri,1,13,412,425
2012-08-24,1,Aug,8,0,Fri,1,41,703,744
2012-08-24,1,Aug,9,0,Fri,1,58,331,389
2012-08-24,1,Aug,10,0,Fri,1,78,184,262
2012-08-24,1,Aug,11,0,Fri,1,69,212,281
2012-08-24,1,Aug,12,0,Fri,1,95,276,371
2012-08-24,1,Aug,13,0,Fri,1,79,272,351
2012-08-24,1,Aug,14,0,Fri,1,109,229,338
2012-08-24,1,Aug,15,0,Fri,1,99,251,350
2012-08-24,1,Aug,16,0,Fri,1,101,414,515
2012-08-24,1,Aug,17,0,Fri,1,117,695,812
2012-08-24,1,Aug,18,0,Fri,1,109,627,736
2012-08-24,1,Aug,19,0,Fri,1,106,430,536
2012-08-24,1,Aug,20,0,Fri,1,66,297,363
2012-08-24,1,Aug,21,0,Fri,1,58,248,306
2012-08-24,1,Aug,22,0,Fri,1,42,209,251
2012-08-24,1,Aug,23,0,Fri,1,38,140,178
2012-08-25,1,Aug,0,0,Sat,0,21,114,135
2012-08-25,1,Aug,1,0,Sat,0,15,100,115
2012-08-25,1,Aug,2,0,Sat,0,18,61,79
2012-08-25,1,Aug,3,0,Sat,0,7,31,38
2012-08-25,1,Aug,4,0,Sat,0,3,9,12
2012-08-25,1,Aug,5,0,Sat,0,4,10,14
2012-08-25,1,Aug,6,0,Sat,0,5,25,30
2012-08-25,1,Aug,7,0,Sat,0,14,88,102
2012-08-25,1,Aug,8,0,Sat,0,29,133,162
2012-08-25,1,Aug,9,0,Sat,0,60,228,288
2012-08-25,1,Aug,10,0,Sat,0,148,294,442
2012-08-25,1,Aug,11,0,Sat,0,143,314,457
2012-08-25,1,Aug,12,0,Sat,0,217,367,584
2012-08-25,1,Aug,13,0,Sat,0,186,331,517
2012-08-25,1,Aug,14,0,Sat,0,150,332,482
2012-08-25,1,Aug,15,0,Sat,0,79,154,233
2012-08-25,1,Aug,16,0,Sat,0,174,260,434
2012-08-25,1,Aug,17,0,Sat,0,132,271,403
2012-08-25,1,Aug,18,0,Sat,0,122,261,383
2012-08-25,1,Aug,19,0,Sat,0,97,257,354
2012-08-25,1,Aug,20,0,Sat,0,65,176,241
2012-08-25,1,Aug,21,0,Sat,0,60,148,208
2012-08-25,1,Aug,22,0,Sat,0,46,136,182
2012-08-25,1,Aug,23,0,Sat,0,34,124,158
2012-08-26,1,Aug,0,0,Sun,0,23,111,134
2012-08-26,1,Aug,1,0,Sun,0,18,116,134
2012-08-26,1,Aug,2,0,Sun,0,12,104,116
2012-08-26,1,Aug,3,0,Sun,0,11,42,53
2012-08-26,1,Aug,4,0,Sun,0,5,11,16
2012-08-26,1,Aug,5,0,Sun,0,3,13,16
2012-08-26,1,Aug,6,0,Sun,0,5,16,21
2012-08-26,1,Aug,7,0,Sun,0,11,23,34
2012-08-26,1,Aug,8,0,Sun,0,21,112,133
2012-08-26,1,Aug,9,0,Sun,0,67,196,263
2012-08-26,1,Aug,10,0,Sun,0,127,258,385
2012-08-26,1,Aug,11,0,Sun,0,150,332,482
2012-08-26,1,Aug,12,0,Sun,0,225,401,626
2012-08-26,1,Aug,13,0,Sun,0,166,375,541
2012-08-26,1,Aug,14,0,Sun,0,125,252,377
2012-08-26,1,Aug,15,0,Sun,0,132,259,391
2012-08-26,1,Aug,16,0,Sun,0,57,116,173
2012-08-26,1,Aug,17,0,Sun,0,61,172,233
2012-08-26,1,Aug,18,0,Sun,0,77,187,264
2012-08-26,1,Aug,19,0,Sun,0,80,212,292
2012-08-26,1,Aug,20,0,Sun,0,40,171,211
2012-08-26,1,Aug,21,0,Sun,0,26,140,166
2012-08-26,1,Aug,22,0,Sun,0,20,94,114
2012-08-26,1,Aug,23,0,Sun,0,21,59,80
2012-08-27,1,Aug,0,0,Mon,1,4,28,32
2012-08-27,1,Aug,1,0,Mon,1,3,4,7
2012-08-27,1,Aug,2,0,Mon,1,0,8,8
2012-08-27,1,Aug,3,0,Mon,1,1,3,4
2012-08-27,1,Aug,4,0,Mon,1,1,11,12
2012-08-27,1,Aug,5,0,Mon,1,4,32,36
2012-08-27,1,Aug,6,0,Mon,1,4,141,145
2012-08-27,1,Aug,7,0,Mon,1,15,418,433
2012-08-27,1,Aug,8,0,Mon,1,29,670,699
2012-08-27,1,Aug,9,0,Mon,1,40,302,342
2012-08-27,1,Aug,10,0,Mon,1,63,143,206
2012-08-27,1,Aug,11,0,Mon,1,47,182,229
2012-08-27,1,Aug,12,0,Mon,1,69,214,283
2012-08-27,1,Aug,13,0,Mon,1,77,211,288
2012-08-27,1,Aug,14,0,Mon,1,66,180,246
2012-08-27,1,Aug,15,0,Mon,1,77,205,282
2012-08-27,1,Aug,16,0,Mon,1,77,367,444
2012-08-27,1,Aug,17,0,Mon,1,101,744,845
2012-08-27,1,Aug,18,0,Mon,1,83,751,834
2012-08-27,1,Aug,19,0,Mon,1,74,499,573
2012-08-27,1,Aug,20,0,Mon,1,50,366,416
2012-08-27,1,Aug,21,0,Mon,1,39,239,278
2012-08-27,1,Aug,22,0,Mon,1,30,131,161
2012-08-27,1,Aug,23,0,Mon,1,35,79,114
2012-08-28,1,Aug,0,0,Tue,1,9,29,38
2012-08-28,1,Aug,1,0,Tue,1,4,17,21
2012-08-28,1,Aug,2,0,Tue,1,2,13,15
2012-08-28,1,Aug,3,0,Tue,1,0,4,4
2012-08-28,1,Aug,4,0,Tue,1,2,6,8
2012-08-28,1,Aug,5,0,Tue,1,3,39,42
2012-08-28,1,Aug,6,0,Tue,1,3,144,147
2012-08-28,1,Aug,7,0,Tue,1,14,255,269
2012-08-28,1,Aug,8,0,Tue,1,25,668,693
2012-08-28,1,Aug,9,0,Tue,1,44,351,395
2012-08-28,1,Aug,10,0,Tue,1,39,165,204
2012-08-28,1,Aug,11,0,Tue,1,47,171,218
2012-08-28,1,Aug,12,0,Tue,1,56,241,297
2012-08-28,1,Aug,13,0,Tue,1,56,232,288
2012-08-28,1,Aug,14,0,Tue,1,72,179,251
2012-08-28,1,Aug,15,0,Tue,1,59,258,317
2012-08-28,1,Aug,16,0,Tue,1,84,396,480
2012-08-28,1,Aug,17,0,Tue,1,90,774,864
2012-08-28,1,Aug,18,0,Tue,1,82,736,818
2012-08-28,1,Aug,19,0,Tue,1,82,515,597
2012-08-28,1,Aug,20,0,Tue,1,87,348,435
2012-08-28,1,Aug,21,0,Tue,1,38,276,314
2012-08-28,1,Aug,22,0,Tue,1,20,196,216
2012-08-28,1,Aug,23,0,Tue,1,17,92,109
2012-08-29,1,Aug,0,0,Wed,1,8,39,47
2012-08-29,1,Aug,1,0,Wed,1,2,12,14
2012-08-29,1,Aug,2,0,Wed,1,2,4,6
2012-08-29,1,Aug,3,0,Wed,1,0,9,9
2012-08-29,1,Aug,4,0,Wed,1,2,8,10
2012-08-29,1,Aug,5,0,Wed,1,3,37,40
2012-08-29,1,Aug,6,0,Wed,1,6,175,181
2012-08-29,1,Aug,7,0,Wed,1,23,531,554
2012-08-29,1,Aug,8,0,Wed,1,28,780,808
2012-08-29,1,Aug,9,0,Wed,1,40,308,348
2012-08-29,1,Aug,10,0,Wed,1,34,144,178
2012-08-29,1,Aug,11,0,Wed,1,67,186,253
2012-08-29,1,Aug,12,0,Wed,1,79,281,360
2012-08-29,1,Aug,13,0,Wed,1,68,232,300
2012-08-29,1,Aug,14,0,Wed,1,87,214,301
2012-08-29,1,Aug,15,0,Wed,1,96,242,338
2012-08-29,1,Aug,16,0,Wed,1,104,389,493
2012-08-29,1,Aug,17,0,Wed,1,108,762,870
2012-08-29,1,Aug,18,0,Wed,1,119,693,812
2012-08-29,1,Aug,19,0,Wed,1,120,523,643
2012-08-29,1,Aug,20,0,Wed,1,49,378,427
2012-08-29,1,Aug,21,0,Wed,1,48,265,313
2012-08-29,1,Aug,22,0,Wed,1,50,185,235
2012-08-29,1,Aug,23,0,Wed,1,34,123,157
2012-08-30,1,Aug,0,0,Thur,1,14,51,65
2012-08-30,1,Aug,1,0,Thur,1,6,17,23
2012-08-30,1,Aug,2,0,Thur,1,3,14,17
2012-08-30,1,Aug,3,0,Thur,1,0,5,5
2012-08-30,1,Aug,4,0,Thur,1,4,4,8
2012-08-30,1,Aug,5,0,Thur,1,2,33,35
2012-08-30,1,Aug,6,0,Thur,1,8,155,163
2012-08-30,1,Aug,7,0,Thur,1,31,501,532
2012-08-30,1,Aug,8,0,Thur,1,53,701,754
2012-08-30,1,Aug,9,0,Thur,1,57,339,396
2012-08-30,1,Aug,10,0,Thur,1,73,161,234
2012-08-30,1,Aug,11,0,Thur,1,85,191,276
2012-08-30,1,Aug,12,0,Thur,1,73,221,294
2012-08-30,1,Aug,13,0,Thur,1,76,214,290
2012-08-30,1,Aug,14,0,Thur,1,74,199,273
2012-08-30,1,Aug,15,0,Thur,1,99,239,338
2012-08-30,1,Aug,16,0,Thur,1,77,405,482
2012-08-30,1,Aug,17,0,Thur,1,93,751,844
2012-08-30,1,Aug,18,0,Thur,1,109,744,853
2012-08-30,1,Aug,19,0,Thur,1,78,532,610
2012-08-30,1,Aug,20,0,Thur,1,68,403,471
2012-08-30,1,Aug,21,0,Thur,1,32,275,307
2012-08-30,1,Aug,22,0,Thur,1,38,253,291
2012-08-30,1,Aug,23,0,Thur,1,19,133,152
2012-08-31,1,Aug,0,0,Fri,1,13,69,82
2012-08-31,1,Aug,1,0,Fri,1,8,24,32
2012-08-31,1,Aug,2,0,Fri,1,9,11,20
2012-08-31,1,Aug,3,0,Fri,1,3,2,5
2012-08-31,1,Aug,4,0,Fri,1,0,7,7
2012-08-31,1,Aug,5,0,Fri,1,2,27,29
2012-08-31,1,Aug,6,0,Fri,1,7,101,108
2012-08-31,1,Aug,7,0,Fri,1,21,400,421
2012-08-31,1,Aug,8,0,Fri,1,36,654,690
2012-08-31,1,Aug,9,0,Fri,1,61,337,398
2012-08-31,1,Aug,10,0,Fri,1,59,197,256
2012-08-31,1,Aug,11,0,Fri,1,88,221,309
2012-08-31,1,Aug,12,0,Fri,1,120,290,410
2012-08-31,1,Aug,13,0,Fri,1,97,271,368
2012-08-31,1,Aug,14,0,Fri,1,112,324,436
2012-08-31,1,Aug,15,0,Fri,1,109,417,526
2012-08-31,1,Aug,16,0,Fri,1,111,417,528
2012-08-31,1,Aug,17,0,Fri,1,129,488,617
2012-08-31,1,Aug,18,0,Fri,1,87,459,546
2012-08-31,1,Aug,19,0,Fri,1,91,361,452
2012-08-31,1,Aug,20,0,Fri,1,102,254,356
2012-08-31,1,Aug,21,0,Fri,1,71,232,303
2012-08-31,1,Aug,22,0,Fri,1,65,212,277
2012-08-31,1,Aug,23,0,Fri,1,32,142,174
2012-09-01,1,Sep,0,0,Sat,0,22,146,168
2012-09-01,1,Sep,1,0,Sat,0,11,68,79
2012-09-01,1,Sep,2,0,Sat,0,8,61,69
2012-09-01,1,Sep,3,0,Sat,0,6,29,35
2012-09-01,1,Sep,4,0,Sat,0,3,9,12
2012-09-01,1,Sep,5,0,Sat,0,2,20,22
2012-09-01,1,Sep,6,0,Sat,0,13,23,36
2012-09-01,1,Sep,7,0,Sat,0,8,58,66
2012-09-01,1,Sep,8,0,Sat,0,28,134,162
2012-09-01,1,Sep,9,0,Sat,0,62,175,237
2012-09-01,1,Sep,10,0,Sat,0,128,289,417
2012-09-01,1,Sep,11,0,Sat,0,219,273,492
2012-09-01,1,Sep,12,0,Sat,0,187,284,471
2012-09-01,1,Sep,13,0,Sat,0,237,267,504
2012-09-01,1,Sep,14,0,Sat,0,240,274,514
2012-09-01,1,Sep,15,0,Sat,0,257,306,563
2012-09-01,1,Sep,16,0,Sat,0,209,253,462
2012-09-01,1,Sep,17,0,Sat,0,205,258,463
2012-09-01,1,Sep,18,0,Sat,0,184,258,442
2012-09-01,1,Sep,19,0,Sat,0,157,235,392
2012-09-01,1,Sep,20,0,Sat,0,67,140,207
2012-09-01,1,Sep,21,0,Sat,0,21,83,104
2012-09-01,1,Sep,22,0,Sat,0,21,57,78
2012-09-01,1,Sep,23,0,Sat,0,57,88,145
2012-09-02,1,Sep,0,0,Sun,0,27,72,99
2012-09-02,1,Sep,1,0,Sun,0,15,58,73
2012-09-02,1,Sep,2,0,Sun,0,28,56,84
2012-09-02,1,Sep,3,0,Sun,0,9,33,42
2012-09-02,1,Sep,4,0,Sun,0,7,15,22
2012-09-02,1,Sep,5,0,Sun,0,2,10,12
2012-09-02,1,Sep,6,0,Sun,0,2,13,15
2012-09-02,1,Sep,7,0,Sun,0,13,29,42
2012-09-02,1,Sep,8,0,Sun,0,30,99,129
2012-09-02,1,Sep,9,0,Sun,0,88,144,232
2012-09-02,1,Sep,10,0,Sun,0,158,230,388
2012-09-02,1,Sep,11,0,Sun,0,226,263,489
2012-09-02,1,Sep,12,0,Sun,0,248,297,545
2012-09-02,1,Sep,13,0,Sun,0,263,230,493
2012-09-02,1,Sep,14,0,Sun,0,249,208,457
2012-09-02,1,Sep,15,0,Sun,0,179,176,355
2012-09-02,1,Sep,16,0,Sun,0,222,252,474
2012-09-02,1,Sep,17,0,Sun,0,219,284,503
2012-09-02,1,Sep,18,0,Sun,0,227,273,500
2012-09-02,1,Sep,19,0,Sun,0,140,152,292
2012-09-02,1,Sep,20,0,Sun,0,63,41,104
2012-09-02,1,Sep,21,0,Sun,0,79,92,171
2012-09-02,1,Sep,22,0,Sun,0,66,100,166
2012-09-02,1,Sep,23,0,Sun,0,53,70,123
2012-09-03,1,Sep,0,1,Mon,0,42,62,104
2012-09-03,1,Sep,1,1,Mon,0,18,37,55
2012-09-03,1,Sep,2,1,Mon,0,10,30,40
2012-09-03,1,Sep,3,1,Mon,0,6,22,28
2012-09-03,1,Sep,4,1,Mon,0,6,5,11
2012-09-03,1,Sep,5,1,Mon,0,1,3,4
2012-09-03,1,Sep,6,1,Mon,0,3,12,15
2012-09-03,1,Sep,7,1,Mon,0,6,37,43
2012-09-03,1,Sep,8,1,Mon,0,36,91,127
2012-09-03,1,Sep,9,1,Mon,0,71,158,229
2012-09-03,1,Sep,10,1,Mon,0,135,224,359
2012-09-03,1,Sep,11,1,Mon,0,187,272,459
2012-09-03,1,Sep,12,1,Mon,0,191,352,543
2012-09-03,1,Sep,13,1,Mon,0,209,357,566
2012-09-03,1,Sep,14,1,Mon,0,163,349,512
2012-09-03,1,Sep,15,1,Mon,0,168,281,449
2012-09-03,1,Sep,16,1,Mon,0,165,335,500
2012-09-03,1,Sep,17,1,Mon,0,181,317,498
2012-09-03,1,Sep,18,1,Mon,0,145,337,482
2012-09-03,1,Sep,19,1,Mon,0,73,301,374
2012-09-03,1,Sep,20,1,Mon,0,78,183,261
2012-09-03,1,Sep,21,1,Mon,0,42,142,184
2012-09-03,1,Sep,22,1,Mon,0,17,104,121
2012-09-03,1,Sep,23,1,Mon,0,12,58,70
2012-09-04,1,Sep,0,0,Tue,1,10,19,29
2012-09-04,1,Sep,1,0,Tue,1,15,9,24
2012-09-04,1,Sep,2,0,Tue,1,1,4,5
2012-09-04,1,Sep,3,0,Tue,1,1,9,10
2012-09-04,1,Sep,4,0,Tue,1,0,8,8
2012-09-04,1,Sep,5,0,Tue,1,1,37,38
2012-09-04,1,Sep,6,0,Tue,1,7,165,172
2012-09-04,1,Sep,7,0,Tue,1,13,480,493
2012-09-04,1,Sep,8,0,Tue,1,15,617,632
2012-09-04,1,Sep,9,0,Tue,1,30,293,323
2012-09-04,1,Sep,10,0,Tue,1,42,130,172
2012-09-04,1,Sep,11,0,Tue,1,39,159,198
2012-09-04,1,Sep,12,0,Tue,1,54,233,287
2012-09-04,1,Sep,13,0,Tue,1,72,203,275
2012-09-04,1,Sep,14,0,Tue,1,72,202,274
2012-09-04,1,Sep,15,0,Tue,1,68,224,292
2012-09-04,1,Sep,16,0,Tue,1,61,397,458
2012-09-04,1,Sep,17,0,Tue,1,110,746,856
2012-09-04,1,Sep,18,0,Tue,1,94,745,839
2012-09-04,1,Sep,19,0,Tue,1,50,502,552
2012-09-04,1,Sep,20,0,Tue,1,47,338,385
2012-09-04,1,Sep,21,0,Tue,1,28,240,268
2012-09-04,1,Sep,22,0,Tue,1,25,154,179
2012-09-04,1,Sep,23,0,Tue,1,12,83,95
2012-09-05,1,Sep,0,0,Wed,1,10,27,37
2012-09-05,1,Sep,1,0,Wed,1,2,11,13
2012-09-05,1,Sep,2,0,Wed,1,0,9,9
2012-09-05,1,Sep,3,0,Wed,1,0,4,4
2012-09-05,1,Sep,4,0,Wed,1,2,3,5
2012-09-05,1,Sep,5,0,Wed,1,1,39,40
2012-09-05,1,Sep,6,0,Wed,1,7,203,210
2012-09-05,1,Sep,7,0,Wed,1,11,489,500
2012-09-05,1,Sep,8,0,Wed,1,33,692,725
2012-09-05,1,Sep,9,0,Wed,1,27,263,290
2012-09-05,1,Sep,10,0,Wed,1,54,181,235
2012-09-05,1,Sep,11,0,Wed,1,61,156,217
2012-09-05,1,Sep,12,0,Wed,1,49,217,266
2012-09-05,1,Sep,13,0,Wed,1,50,184,234
2012-09-05,1,Sep,14,0,Wed,1,34,177,211
2012-09-05,1,Sep,15,0,Wed,1,41,204,245
2012-09-05,1,Sep,16,0,Wed,1,86,344,430
2012-09-05,1,Sep,17,0,Wed,1,83,780,863
2012-09-05,1,Sep,18,0,Wed,1,82,757,839
2012-09-05,1,Sep,19,0,Wed,1,64,598,662
2012-09-05,1,Sep,20,0,Wed,1,55,357,412
2012-09-05,1,Sep,21,0,Wed,1,18,278,296
2012-09-05,1,Sep,22,0,Wed,1,38,181,219
2012-09-05,1,Sep,23,0,Wed,1,24,126,150
2012-09-06,1,Sep,0,0,Thur,1,30,35,65
2012-09-06,1,Sep,1,0,Thur,1,2,16,18
2012-09-06,1,Sep,2,0,Thur,1,1,7,8
2012-09-06,1,Sep,3,0,Thur,1,0,9,9
2012-09-06,1,Sep,4,0,Thur,1,0,8,8
2012-09-06,1,Sep,5,0,Thur,1,3,35,38
2012-09-06,1,Sep,6,0,Thur,1,11,189,200
2012-09-06,1,Sep,7,0,Thur,1,21,461,482
2012-09-06,1,Sep,8,0,Thur,1,24,622,646
2012-09-06,1,Sep,9,0,Thur,1,8,115,123
2012-09-06,1,Sep,10,0,Thur,1,9,40,49
2012-09-06,1,Sep,11,0,Thur,1,10,52,62
2012-09-06,1,Sep,12,0,Thur,1,11,126,137
2012-09-06,1,Sep,13,0,Thur,1,39,152,191
2012-09-06,1,Sep,14,0,Thur,1,38,178,216
2012-09-06,1,Sep,15,0,Thur,1,42,228,270
2012-09-06,1,Sep,16,0,Thur,1,42,374,416
2012-09-06,1,Sep,17,0,Thur,1,67,741,808
2012-09-06,1,Sep,18,0,Thur,1,74,761,835
2012-09-06,1,Sep,19,0,Thur,1,54,504,558
2012-09-06,1,Sep,20,0,Thur,1,50,356,406
2012-09-06,1,Sep,21,0,Thur,1,32,240,272
2012-09-06,1,Sep,22,0,Thur,1,24,193,217
2012-09-06,1,Sep,23,0,Thur,1,19,150,169
2012-09-07,1,Sep,0,0,Fri,1,17,79,96
2012-09-07,1,Sep,1,0,Fri,1,10,19,29
2012-09-07,1,Sep,2,0,Fri,1,1,10,11
2012-09-07,1,Sep,3,0,Fri,1,0,9,9
2012-09-07,1,Sep,4,0,Fri,1,1,7,8
2012-09-07,1,Sep,5,0,Fri,1,1,39,40
2012-09-07,1,Sep,6,0,Fri,1,5,135,140
2012-09-07,1,Sep,7,0,Fri,1,21,465,486
2012-09-07,1,Sep,8,0,Fri,1,29,690,719
2012-09-07,1,Sep,9,0,Fri,1,33,311,344
2012-09-07,1,Sep,10,0,Fri,1,53,171,224
2012-09-07,1,Sep,11,0,Fri,1,81,215,296
2012-09-07,1,Sep,12,0,Fri,1,76,247,323
2012-09-07,1,Sep,13,0,Fri,1,71,283,354
2012-09-07,1,Sep,14,0,Fri,1,66,187,253
2012-09-07,1,Sep,15,0,Fri,1,66,265,331
2012-09-07,1,Sep,16,0,Fri,1,75,395,470
2012-09-07,1,Sep,17,0,Fri,1,88,684,772
2012-09-07,1,Sep,18,0,Fri,1,95,697,792
2012-09-07,1,Sep,19,0,Fri,1,70,498,568
2012-09-07,1,Sep,20,0,Fri,1,51,340,391
2012-09-07,1,Sep,21,0,Fri,1,55,246,301
2012-09-07,1,Sep,22,0,Fri,1,52,247,299
2012-09-07,1,Sep,23,0,Fri,1,28,220,248
2012-09-08,1,Sep,0,0,Sat,0,20,130,150
2012-09-08,1,Sep,1,0,Sat,0,10,107,117
2012-09-08,1,Sep,2,0,Sat,0,9,68,77
2012-09-08,1,Sep,3,0,Sat,0,3,40,43
2012-09-08,1,Sep,4,0,Sat,0,3,8,11
2012-09-08,1,Sep,5,0,Sat,0,2,13,15
2012-09-08,1,Sep,6,0,Sat,0,8,26,34
2012-09-08,1,Sep,7,0,Sat,0,11,71,82
2012-09-08,1,Sep,8,0,Sat,0,33,197,230
2012-09-08,1,Sep,9,0,Sat,0,87,261,348
2012-09-08,1,Sep,10,0,Sat,0,100,322,422
2012-09-08,1,Sep,11,0,Sat,0,173,405,578
2012-09-08,1,Sep,12,0,Sat,0,220,474,694
2012-09-08,1,Sep,13,0,Sat,0,233,435,668
2012-09-08,1,Sep,14,0,Sat,0,260,366,626
2012-09-08,1,Sep,15,0,Sat,0,175,337,512
2012-09-08,1,Sep,16,0,Sat,0,19,95,114
2012-09-08,1,Sep,17,0,Sat,0,52,119,171
2012-09-08,1,Sep,18,0,Sat,0,27,140,167
2012-09-08,1,Sep,19,0,Sat,0,28,187,215
2012-09-08,1,Sep,20,0,Sat,0,28,166,194
2012-09-08,1,Sep,21,0,Sat,0,26,155,181
2012-09-08,1,Sep,22,0,Sat,0,18,176,194
2012-09-08,1,Sep,23,0,Sat,0,12,121,133
2012-09-09,1,Sep,0,0,Sun,0,18,106,124
2012-09-09,1,Sep,1,0,Sun,0,20,104,124
2012-09-09,1,Sep,2,0,Sun,0,15,81,96
2012-09-09,1,Sep,3,0,Sun,0,14,32,46
2012-09-09,1,Sep,4,0,Sun,0,12,16,28
2012-09-09,1,Sep,5,0,Sun,0,16,39,55
2012-09-09,1,Sep,6,0,Sun,0,11,24,35
2012-09-09,1,Sep,7,0,Sun,0,20,50,70
2012-09-09,1,Sep,8,0,Sun,0,27,143,170
2012-09-09,1,Sep,9,0,Sun,0,85,214,299
2012-09-09,1,Sep,10,0,Sun,0,172,323,495
2012-09-09,1,Sep,11,0,Sun,0,194,391,585
2012-09-09,1,Sep,12,0,Sun,0,247,510,757
2012-09-09,1,Sep,13,0,Sun,0,238,491,729
2012-09-09,1,Sep,14,0,Sun,0,232,415,647
2012-09-09,1,Sep,15,0,Sun,0,284,412,696
2012-09-09,1,Sep,16,0,Sun,0,228,473,701
2012-09-09,1,Sep,17,0,Sun,0,213,458,671
2012-09-09,1,Sep,18,0,Sun,0,156,404,560
2012-09-09,1,Sep,19,0,Sun,0,134,362,496
2012-09-09,1,Sep,20,0,Sun,0,91,265,356
2012-09-09,1,Sep,21,0,Sun,0,57,149,206
2012-09-09,1,Sep,22,0,Sun,0,64,125,189
2012-09-09,1,Sep,23,0,Sun,0,22,70,92
2012-09-10,1,Sep,0,0,Mon,1,6,35,41
2012-09-10,1,Sep,1,0,Mon,1,7,11,18
2012-09-10,1,Sep,2,0,Mon,1,11,6,17
2012-09-10,1,Sep,3,0,Mon,1,5,7,12
2012-09-10,1,Sep,4,0,Mon,1,1,4,5
2012-09-10,1,Sep,5,0,Mon,1,4,36,40
2012-09-10,1,Sep,6,0,Mon,1,8,172,180
2012-09-10,1,Sep,7,0,Mon,1,20,427,447
2012-09-10,1,Sep,8,0,Mon,1,33,697,730
2012-09-10,1,Sep,9,0,Mon,1,40,321,361
2012-09-10,1,Sep,10,0,Mon,1,42,168,210
2012-09-10,1,Sep,11,0,Mon,1,69,167,236
2012-09-10,1,Sep,12,0,Mon,1,76,256,332
2012-09-10,1,Sep,13,0,Mon,1,72,251,323
2012-09-10,1,Sep,14,0,Mon,1,107,233,340
2012-09-10,1,Sep,15,0,Mon,1,115,231,346
2012-09-10,1,Sep,16,0,Mon,1,108,380,488
2012-09-10,1,Sep,17,0,Mon,1,127,744,871
2012-09-10,1,Sep,18,0,Mon,1,111,857,968
2012-09-10,1,Sep,19,0,Mon,1,71,562,633
2012-09-10,1,Sep,20,0,Mon,1,34,356,390
2012-09-10,1,Sep,21,0,Mon,1,29,256,285
2012-09-10,1,Sep,22,0,Mon,1,15,144,159
2012-09-10,1,Sep,23,0,Mon,1,7,86,93
2012-09-11,1,Sep,0,0,Tue,1,5,27,32
2012-09-11,1,Sep,1,0,Tue,1,0,10,10
2012-09-11,1,Sep,2,0,Tue,1,1,5,6
2012-09-11,1,Sep,3,0,Tue,1,1,7,8
2012-09-11,1,Sep,4,0,Tue,1,1,8,9
2012-09-11,1,Sep,5,0,Tue,1,3,41,44
2012-09-11,1,Sep,6,0,Tue,1,11,200,211
2012-09-11,1,Sep,7,0,Tue,1,24,572,596
2012-09-11,1,Sep,8,0,Tue,1,48,702,750
2012-09-11,1,Sep,9,0,Tue,1,35,323,358
2012-09-11,1,Sep,10,0,Tue,1,54,142,196
2012-09-11,1,Sep,11,0,Tue,1,60,187,247
2012-09-11,1,Sep,12,0,Tue,1,62,254,316
2012-09-11,1,Sep,13,0,Tue,1,72,256,328
2012-09-11,1,Sep,14,0,Tue,1,74,181,255
2012-09-11,1,Sep,15,0,Tue,1,73,253,326
2012-09-11,1,Sep,16,0,Tue,1,99,437,536
2012-09-11,1,Sep,17,0,Tue,1,168,802,970
2012-09-11,1,Sep,18,0,Tue,1,110,767,877
2012-09-11,1,Sep,19,0,Tue,1,56,540,596
2012-09-11,1,Sep,20,0,Tue,1,40,421,461
2012-09-11,1,Sep,21,0,Tue,1,28,282,310
2012-09-11,1,Sep,22,0,Tue,1,27,189,216
2012-09-11,1,Sep,23,0,Tue,1,18,91,109
2012-09-12,1,Sep,0,0,Wed,1,8,41,49
2012-09-12,1,Sep,1,0,Wed,1,2,19,21
2012-09-12,1,Sep,2,0,Wed,1,2,9,11
2012-09-12,1,Sep,3,0,Wed,1,0,7,7
2012-09-12,1,Sep,4,0,Wed,1,0,5,5
2012-09-12,1,Sep,5,0,Wed,1,4,44,48
2012-09-12,1,Sep,6,0,Wed,1,6,199,205
2012-09-12,1,Sep,7,0,Wed,1,24,533,557
2012-09-12,1,Sep,8,0,Wed,1,43,727,770
2012-09-12,1,Sep,9,0,Wed,1,50,278,328
2012-09-12,1,Sep,10,0,Wed,1,57,148,205
2012-09-12,1,Sep,11,0,Wed,1,51,181,232
2012-09-12,1,Sep,12,0,Wed,1,88,264,352
2012-09-12,1,Sep,13,0,Wed,1,85,238,323
2012-09-12,1,Sep,14,0,Wed,1,78,200,278
2012-09-12,1,Sep,15,0,Wed,1,75,243,318
2012-09-12,1,Sep,16,0,Wed,1,90,419,509
2012-09-12,1,Sep,17,0,Wed,1,114,811,925
2012-09-12,1,Sep,18,0,Wed,1,91,886,977
2012-09-12,1,Sep,19,0,Wed,1,78,557,635
2012-09-12,1,Sep,20,0,Wed,1,38,432,470
2012-09-12,1,Sep,21,0,Wed,1,27,279,306
2012-09-12,1,Sep,22,0,Wed,1,23,189,212
2012-09-12,1,Sep,23,0,Wed,1,16,111,127
2012-09-13,1,Sep,0,0,Thur,1,11,46,57
2012-09-13,1,Sep,1,0,Thur,1,6,22,28
2012-09-13,1,Sep,2,0,Thur,1,0,9,9
2012-09-13,1,Sep,3,0,Thur,1,2,9,11
2012-09-13,1,Sep,4,0,Thur,1,0,6,6
2012-09-13,1,Sep,5,0,Thur,1,3,54,57
2012-09-13,1,Sep,6,0,Thur,1,9,186,195
2012-09-13,1,Sep,7,0,Thur,1,22,549,571
2012-09-13,1,Sep,8,0,Thur,1,33,725,758
2012-09-13,1,Sep,9,0,Thur,1,46,292,338
2012-09-13,1,Sep,10,0,Thur,1,63,149,212
2012-09-13,1,Sep,11,0,Thur,1,71,183,254
2012-09-13,1,Sep,12,0,Thur,1,57,240,297
2012-09-13,1,Sep,13,0,Thur,1,60,223,283
2012-09-13,1,Sep,14,0,Thur,1,60,214,274
2012-09-13,1,Sep,15,0,Thur,1,99,253,352
2012-09-13,1,Sep,16,0,Thur,1,85,406,491
2012-09-13,1,Sep,17,0,Thur,1,97,787,884
2012-09-13,1,Sep,18,0,Thur,1,108,744,852
2012-09-13,1,Sep,19,0,Thur,1,80,594,674
2012-09-13,1,Sep,20,0,Thur,1,55,408,463
2012-09-13,1,Sep,21,0,Thur,1,26,291,317
2012-09-13,1,Sep,22,0,Thur,1,28,223,251
2012-09-13,1,Sep,23,0,Thur,1,33,137,170
2012-09-14,1,Sep,0,0,Fri,1,24,63,87
2012-09-14,1,Sep,1,0,Fri,1,6,35,41
2012-09-14,1,Sep,2,0,Fri,1,7,23,30
2012-09-14,1,Sep,3,0,Fri,1,5,9,14
2012-09-14,1,Sep,4,0,Fri,1,1,11,12
2012-09-14,1,Sep,5,0,Fri,1,1,40,41
2012-09-14,1,Sep,6,0,Fri,1,8,144,152
2012-09-14,1,Sep,7,0,Fri,1,17,437,454
2012-09-14,1,Sep,8,0,Fri,1,51,715,766
2012-09-14,1,Sep,9,0,Fri,1,46,301,347
2012-09-14,1,Sep,10,0,Fri,1,75,171,246
2012-09-14,1,Sep,11,0,Fri,1,84,196,280
2012-09-14,1,Sep,12,0,Fri,1,119,290,409
2012-09-14,1,Sep,13,0,Fri,1,107,301,408
2012-09-14,1,Sep,14,0,Fri,1,113,258,371
2012-09-14,1,Sep,15,0,Fri,1,94,273,367
2012-09-14,1,Sep,16,0,Fri,1,109,454,563
2012-09-14,1,Sep,17,0,Fri,1,137,757,894
2012-09-14,1,Sep,18,0,Fri,1,116,692,808
2012-09-14,1,Sep,19,0,Fri,1,83,496,579
2012-09-14,1,Sep,20,0,Fri,1,67,337,404
2012-09-14,1,Sep,21,0,Fri,1,42,270,312
2012-09-14,1,Sep,22,0,Fri,1,40,189,229
2012-09-14,1,Sep,23,0,Fri,1,27,168,195
2012-09-15,1,Sep,0,0,Sat,0,38,169,207
2012-09-15,1,Sep,1,0,Sat,0,8,101,109
2012-09-15,1,Sep,2,0,Sat,0,18,75,93
2012-09-15,1,Sep,3,0,Sat,0,6,31,37
2012-09-15,1,Sep,4,0,Sat,0,3,3,6
2012-09-15,1,Sep,5,0,Sat,0,1,15,16
2012-09-15,1,Sep,6,0,Sat,0,6,27,33
2012-09-15,1,Sep,7,0,Sat,0,10,63,73
2012-09-15,1,Sep,8,0,Sat,0,43,169,212
2012-09-15,1,Sep,9,0,Sat,0,79,263,342
2012-09-15,1,Sep,10,0,Sat,0,119,323,442
2012-09-15,1,Sep,11,0,Sat,0,228,399,627
2012-09-15,1,Sep,12,0,Sat,0,287,419,706
2012-09-15,1,Sep,13,0,Sat,0,327,377,704
2012-09-15,1,Sep,14,0,Sat,0,325,390,715
2012-09-15,1,Sep,15,0,Sat,0,312,342,654
2012-09-15,1,Sep,16,0,Sat,0,350,433,783
2012-09-15,1,Sep,17,0,Sat,0,295,434,729
2012-09-15,1,Sep,18,0,Sat,0,232,382,614
2012-09-15,1,Sep,19,0,Sat,0,169,309,478
2012-09-15,1,Sep,20,0,Sat,0,89,241,330
2012-09-15,1,Sep,21,0,Sat,0,86,210,296
2012-09-15,1,Sep,22,0,Sat,0,82,197,279
2012-09-15,1,Sep,23,0,Sat,0,47,182,229
2012-09-16,1,Sep,0,0,Sun,0,28,123,151
2012-09-16,1,Sep,1,0,Sun,0,35,82,117
2012-09-16,1,Sep,2,0,Sun,0,27,62,89
2012-09-16,1,Sep,3,0,Sun,0,10,38,48
2012-09-16,1,Sep,4,0,Sun,0,2,6,8
2012-09-16,1,Sep,5,0,Sun,0,3,10,13
2012-09-16,1,Sep,6,0,Sun,0,9,26,35
2012-09-16,1,Sep,7,0,Sun,0,28,43,71
2012-09-16,1,Sep,8,0,Sun,0,34,94,128
2012-09-16,1,Sep,9,0,Sun,0,70,226,296
2012-09-16,1,Sep,10,0,Sun,0,160,330,490
2012-09-16,1,Sep,11,0,Sun,0,183,376,559
2012-09-16,1,Sep,12,0,Sun,0,188,468,656
2012-09-16,1,Sep,13,0,Sun,0,240,454,694
2012-09-16,1,Sep,14,0,Sun,0,225,410,635
2012-09-16,1,Sep,15,0,Sun,0,215,342,557
2012-09-16,1,Sep,16,0,Sun,0,194,402,596
2012-09-16,1,Sep,17,0,Sun,0,177,393,570
2012-09-16,1,Sep,18,0,Sun,0,120,361,481
2012-09-16,1,Sep,19,0,Sun,0,91,312,403
2012-09-16,1,Sep,20,0,Sun,0,57,267,324
2012-09-16,1,Sep,21,0,Sun,0,43,148,191
2012-09-16,1,Sep,22,0,Sun,0,18,109,127
2012-09-16,1,Sep,23,0,Sun,0,9,85,94
2012-09-17,1,Sep,0,0,Mon,1,14,31,45
2012-09-17,1,Sep,1,0,Mon,1,9,12,21
2012-09-17,1,Sep,2,0,Mon,1,5,8,13
2012-09-17,1,Sep,3,0,Mon,1,0,7,7
2012-09-17,1,Sep,4,0,Mon,1,2,9,11
2012-09-17,1,Sep,5,0,Mon,1,1,44,45
2012-09-17,1,Sep,6,0,Mon,1,7,157,164
2012-09-17,1,Sep,7,0,Mon,1,18,474,492
2012-09-17,1,Sep,8,0,Mon,1,36,647,683
2012-09-17,1,Sep,9,0,Mon,1,34,265,299
2012-09-17,1,Sep,10,0,Mon,1,73,129,202
2012-09-17,1,Sep,11,0,Mon,1,61,191,252
2012-09-17,1,Sep,12,0,Mon,1,62,233,295
2012-09-17,1,Sep,13,0,Mon,1,112,231,343
2012-09-17,1,Sep,14,0,Mon,1,129,203,332
2012-09-17,1,Sep,15,0,Mon,1,82,256,338
2012-09-17,1,Sep,16,0,Mon,1,74,379,453
2012-09-17,1,Sep,17,0,Mon,1,102,740,842
2012-09-17,1,Sep,18,0,Mon,1,66,708,774
2012-09-17,1,Sep,19,0,Mon,1,51,435,486
2012-09-17,1,Sep,20,0,Mon,1,32,308,340
2012-09-17,1,Sep,21,0,Mon,1,28,205,233
2012-09-17,1,Sep,22,0,Mon,1,20,109,129
2012-09-17,1,Sep,23,0,Mon,1,4,66,70
2012-09-18,1,Sep,0,0,Tue,1,2,11,13
2012-09-18,1,Sep,1,0,Tue,1,0,5,5
2012-09-18,1,Sep,2,0,Tue,1,0,4,4
2012-09-18,1,Sep,3,0,Tue,1,0,6,6
2012-09-18,1,Sep,4,0,Tue,1,2,5,7
2012-09-18,1,Sep,5,0,Tue,1,3,45,48
2012-09-18,1,Sep,6,0,Tue,1,4,163,167
2012-09-18,1,Sep,7,0,Tue,1,13,343,356
2012-09-18,1,Sep,8,0,Tue,1,32,640,672
2012-09-18,1,Sep,9,0,Tue,1,27,266,293
2012-09-18,1,Sep,10,0,Tue,1,30,130,160
2012-09-18,1,Sep,11,0,Tue,1,36,115,151
2012-09-18,1,Sep,12,0,Tue,1,16,72,88
2012-09-18,1,Sep,13,0,Tue,1,17,97,114
2012-09-18,1,Sep,14,0,Tue,1,27,116,143
2012-09-18,1,Sep,15,0,Tue,1,1,35,36
2012-09-18,1,Sep,16,0,Tue,1,19,122,141
2012-09-18,1,Sep,17,0,Tue,1,36,302,338
2012-09-18,1,Sep,18,0,Tue,1,19,262,281
2012-09-18,1,Sep,19,0,Tue,1,22,302,324
2012-09-18,1,Sep,20,0,Tue,1,19,271,290
2012-09-18,1,Sep,21,0,Tue,1,21,186,207
2012-09-18,1,Sep,22,0,Tue,1,14,137,151
2012-09-18,1,Sep,23,0,Tue,1,11,67,78
2012-09-19,1,Sep,0,0,Wed,1,3,23,26
2012-09-19,1,Sep,1,0,Wed,1,0,12,12
2012-09-19,1,Sep,2,0,Wed,1,0,3,3
2012-09-19,1,Sep,3,0,Wed,1,1,4,5
2012-09-19,1,Sep,4,0,Wed,1,0,10,10
2012-09-19,1,Sep,5,0,Wed,1,2,54,56
2012-09-19,1,Sep,6,0,Wed,1,6,166,172
2012-09-19,1,Sep,7,0,Wed,1,16,529,545
2012-09-19,1,Sep,8,0,Wed,1,39,758,797
2012-09-19,1,Sep,9,0,Wed,1,26,336,362
2012-09-19,1,Sep,10,0,Wed,1,23,169,192
2012-09-19,1,Sep,11,0,Wed,1,44,203,247
2012-09-19,1,Sep,12,0,Wed,1,53,260,313
2012-09-19,1,Sep,13,0,Wed,1,55,234,289
2012-09-19,1,Sep,14,0,Wed,1,59,227,286
2012-09-19,1,Sep,15,0,Wed,1,57,254,311
2012-09-19,1,Sep,16,0,Wed,1,69,397,466
2012-09-19,1,Sep,17,0,Wed,1,74,812,886
2012-09-19,1,Sep,18,0,Wed,1,85,807,892
2012-09-19,1,Sep,19,0,Wed,1,72,539,611
2012-09-19,1,Sep,20,0,Wed,1,31,378,409
2012-09-19,1,Sep,21,0,Wed,1,25,324,349
2012-09-19,1,Sep,22,0,Wed,1,31,198,229
2012-09-19,1,Sep,23,0,Wed,1,17,106,123
2012-09-20,1,Sep,0,0,Thur,1,12,46,58
2012-09-20,1,Sep,1,0,Thur,1,4,14,18
2012-09-20,1,Sep,2,0,Thur,1,2,9,11
2012-09-20,1,Sep,3,0,Thur,1,0,6,6
2012-09-20,1,Sep,4,0,Thur,1,0,6,6
2012-09-20,1,Sep,5,0,Thur,1,4,52,56
2012-09-20,1,Sep,6,0,Thur,1,9,161,170
2012-09-20,1,Sep,7,0,Thur,1,20,514,534
2012-09-20,1,Sep,8,0,Thur,1,44,746,790
2012-09-20,1,Sep,9,0,Thur,1,25,330,355
2012-09-20,1,Sep,10,0,Thur,1,33,157,190
2012-09-20,1,Sep,11,0,Thur,1,37,206,243
2012-09-20,1,Sep,12,0,Thur,1,57,233,290
2012-09-20,1,Sep,13,0,Thur,1,68,268,336
2012-09-20,1,Sep,14,0,Thur,1,76,222,298
2012-09-20,1,Sep,15,0,Thur,1,60,231,291
2012-09-20,1,Sep,16,0,Thur,1,72,385,457
2012-09-20,1,Sep,17,0,Thur,1,91,885,976
2012-09-20,1,Sep,18,0,Thur,1,119,781,900
2012-09-20,1,Sep,19,0,Thur,1,69,534,603
2012-09-20,1,Sep,20,0,Thur,1,57,360,417
2012-09-20,1,Sep,21,0,Thur,1,28,246,274
2012-09-20,1,Sep,22,0,Thur,1,35,252,287
2012-09-20,1,Sep,23,0,Thur,1,17,137,154
2012-09-21,1,Sep,0,0,Fri,1,13,53,66
2012-09-21,1,Sep,1,0,Fri,1,11,38,49
2012-09-21,1,Sep,2,0,Fri,1,6,8,14
2012-09-21,1,Sep,3,0,Fri,1,1,11,12
2012-09-21,1,Sep,4,0,Fri,1,1,9,10
2012-09-21,1,Sep,5,0,Fri,1,2,47,49
2012-09-21,1,Sep,6,0,Fri,1,19,146,165
2012-09-21,1,Sep,7,0,Fri,1,35,468,503
2012-09-21,1,Sep,8,0,Fri,1,31,726,757
2012-09-21,1,Sep,9,0,Fri,1,35,348,383
2012-09-21,1,Sep,10,0,Fri,1,44,181,225
2012-09-21,1,Sep,11,0,Fri,1,79,242,321
2012-09-21,1,Sep,12,0,Fri,1,84,305,389
2012-09-21,1,Sep,13,0,Fri,1,105,316,421
2012-09-21,1,Sep,14,0,Fri,1,113,299,412
2012-09-21,1,Sep,15,0,Fri,1,90,333,423
2012-09-21,1,Sep,16,0,Fri,1,103,464,567
2012-09-21,1,Sep,17,0,Fri,1,107,739,846
2012-09-21,1,Sep,18,0,Fri,1,106,699,805
2012-09-21,1,Sep,19,0,Fri,1,95,493,588
2012-09-21,1,Sep,20,0,Fri,1,54,315,369
2012-09-21,1,Sep,21,0,Fri,1,46,266,312
2012-09-21,1,Sep,22,0,Fri,1,47,248,295
2012-09-21,1,Sep,23,0,Fri,1,23,163,186
2012-09-22,1,Sep,0,0,Sat,0,32,140,172
2012-09-22,1,Sep,1,0,Sat,0,18,106,124
2012-09-22,1,Sep,2,0,Sat,0,10,73,83
2012-09-22,1,Sep,3,0,Sat,0,6,39,45
2012-09-22,1,Sep,4,0,Sat,0,5,10,15
2012-09-22,1,Sep,5,0,Sat,0,2,15,17
2012-09-22,1,Sep,6,0,Sat,0,6,35,41
2012-09-22,1,Sep,7,0,Sat,0,7,70,77
2012-09-22,1,Sep,8,0,Sat,0,21,197,218
2012-09-22,1,Sep,9,0,Sat,0,88,289,377
2012-09-22,1,Sep,10,0,Sat,0,124,350,474
2012-09-22,1,Sep,11,0,Sat,0,189,437,626
2012-09-22,1,Sep,12,0,Sat,0,228,460,688
2012-09-22,1,Sep,13,0,Sat,0,273,434,707
2012-09-22,1,Sep,14,0,Sat,0,250,404,654
2012-09-22,1,Sep,15,0,Sat,0,307,443,750
2012-09-22,1,Sep,16,0,Sat,0,253,427,680
2012-09-22,1,Sep,17,0,Sat,0,195,451,646
2012-09-22,1,Sep,18,0,Sat,0,171,427,598
2012-09-22,1,Sep,19,0,Sat,0,99,308,407
2012-09-22,1,Sep,20,0,Sat,0,76,249,325
2012-09-22,1,Sep,21,0,Sat,0,59,202,261
2012-09-22,1,Sep,22,0,Sat,0,59,180,239
2012-09-22,1,Sep,23,0,Sat,0,34,137,171
2012-09-23,1,Sep,0,0,Sun,0,34,146,180
2012-09-23,1,Sep,1,0,Sun,0,23,119,142
2012-09-23,1,Sep,2,0,Sun,0,18,77,95
2012-09-23,1,Sep,3,0,Sun,0,13,41,54
2012-09-23,1,Sep,4,0,Sun,0,1,9,10
2012-09-23,1,Sep,5,0,Sun,0,1,5,6
2012-09-23,1,Sep,6,0,Sun,0,5,11,16
2012-09-23,1,Sep,7,0,Sun,0,9,48,57
2012-09-23,1,Sep,8,0,Sun,0,38,137,175
2012-09-23,1,Sep,9,0,Sun,0,71,205,276
2012-09-23,1,Sep,10,0,Sun,0,138,351,489
2012-09-23,1,Sep,11,0,Sun,0,186,384,570
2012-09-23,1,Sep,12,0,Sun,0,250,526,776
2012-09-23,1,Sep,13,0,Sun,0,257,445,702
2012-09-23,1,Sep,14,0,Sun,0,266,400,666
2012-09-23,1,Sep,15,0,Sun,0,265,375,640
2012-09-23,1,Sep,16,0,Sun,0,254,437,691
2012-09-23,1,Sep,17,0,Sun,0,227,496,723
2012-09-23,1,Sep,18,0,Sun,0,135,405,540
2012-09-23,1,Sep,19,0,Sun,0,82,331,413
2012-09-23,1,Sep,20,0,Sun,0,60,192,252
2012-09-23,1,Sep,21,0,Sun,0,51,145,196
2012-09-23,1,Sep,22,0,Sun,0,40,98,138
2012-09-23,1,Sep,23,0,Sun,0,30,70,100
2012-09-24,1,Sep,0,0,Mon,1,10,54,64
2012-09-24,1,Sep,1,0,Mon,1,6,12,18
2012-09-24,1,Sep,2,0,Mon,1,0,8,8
2012-09-24,1,Sep,3,0,Mon,1,0,5,5
2012-09-24,1,Sep,4,0,Mon,1,0,8,8
2012-09-24,1,Sep,5,0,Mon,1,2,35,37
2012-09-24,1,Sep,6,0,Mon,1,6,162,168
2012-09-24,1,Sep,7,0,Mon,1,17,513,530
2012-09-24,1,Sep,8,0,Mon,1,31,719,750
2012-09-24,1,Sep,9,0,Mon,1,42,286,328
2012-09-24,1,Sep,10,0,Mon,1,52,146,198
2012-09-24,1,Sep,11,0,Mon,1,71,167,238
2012-09-24,1,Sep,12,0,Mon,1,77,265,342
2012-09-24,1,Sep,13,0,Mon,1,80,248,328
2012-09-24,1,Sep,14,0,Mon,1,77,226,303
2012-09-24,1,Sep,15,0,Mon,1,84,216,300
2012-09-24,1,Sep,16,0,Mon,1,99,417,516
2012-09-24,1,Sep,17,0,Mon,1,89,809,898
2012-09-24,1,Sep,18,0,Mon,1,95,758,853
2012-09-24,1,Sep,19,0,Mon,1,56,534,590
2012-09-24,1,Sep,20,0,Mon,1,52,380,432
2012-09-24,1,Sep,21,0,Mon,1,26,230,256
2012-09-24,1,Sep,22,0,Mon,1,18,154,172
2012-09-24,1,Sep,23,0,Mon,1,11,83,94
2012-09-25,1,Sep,0,0,Tue,1,8,56,64
2012-09-25,1,Sep,1,0,Tue,1,2,11,13
2012-09-25,1,Sep,2,0,Tue,1,5,9,14
2012-09-25,1,Sep,3,0,Tue,1,2,3,5
2012-09-25,1,Sep,4,0,Tue,1,2,7,9
2012-09-25,1,Sep,5,0,Tue,1,1,46,47
2012-09-25,1,Sep,6,0,Tue,1,5,189,194
2012-09-25,1,Sep,7,0,Tue,1,17,539,556
2012-09-25,1,Sep,8,0,Tue,1,41,764,805
2012-09-25,1,Sep,9,0,Tue,1,28,381,409
2012-09-25,1,Sep,10,0,Tue,1,45,125,170
2012-09-25,1,Sep,11,0,Tue,1,63,155,218
2012-09-25,1,Sep,12,0,Tue,1,69,233,302
2012-09-25,1,Sep,13,0,Tue,1,48,257,305
2012-09-25,1,Sep,14,0,Tue,1,80,213,293
2012-09-25,1,Sep,15,0,Tue,1,56,247,303
2012-09-25,1,Sep,16,0,Tue,1,59,436,495
2012-09-25,1,Sep,17,0,Tue,1,107,860,967
2012-09-25,1,Sep,18,0,Tue,1,64,758,822
2012-09-25,1,Sep,19,0,Tue,1,49,490,539
2012-09-25,1,Sep,20,0,Tue,1,37,388,425
2012-09-25,1,Sep,21,0,Tue,1,34,263,297
2012-09-25,1,Sep,22,0,Tue,1,14,174,188
2012-09-25,1,Sep,23,0,Tue,1,9,89,98
2012-09-26,1,Sep,0,0,Wed,1,6,34,40
2012-09-26,1,Sep,1,0,Wed,1,10,19,29
2012-09-26,1,Sep,2,0,Wed,1,2,15,17
2012-09-26,1,Sep,3,0,Wed,1,4,6,10
2012-09-26,1,Sep,4,0,Wed,1,2,12,14
2012-09-26,1,Sep,5,0,Wed,1,1,35,36
2012-09-26,1,Sep,6,0,Wed,1,3,179,182
2012-09-26,1,Sep,7,0,Wed,1,9,523,532
2012-09-26,1,Sep,8,0,Wed,1,30,808,838
2012-09-26,1,Sep,9,0,Wed,1,27,307,334
2012-09-26,1,Sep,10,0,Wed,1,29,156,185
2012-09-26,1,Sep,11,0,Wed,1,46,181,227
2012-09-26,1,Sep,12,0,Wed,1,56,260,316
2012-09-26,1,Sep,13,0,Wed,1,67,273,340
2012-09-26,1,Sep,14,0,Wed,1,60,217,277
2012-09-26,1,Sep,15,0,Wed,1,69,231,300
2012-09-26,1,Sep,16,0,Wed,1,71,397,468
2012-09-26,1,Sep,17,0,Wed,1,77,876,953
2012-09-26,1,Sep,18,0,Wed,1,69,815,884
2012-09-26,1,Sep,19,0,Wed,1,38,589,627
2012-09-26,1,Sep,20,0,Wed,1,45,389,434
2012-09-26,1,Sep,21,0,Wed,1,32,328,360
2012-09-26,1,Sep,22,0,Wed,1,21,194,215
2012-09-26,1,Sep,23,0,Wed,1,13,102,115
2012-09-27,1,Sep,0,0,Thur,1,5,60,65
2012-09-27,1,Sep,1,0,Thur,1,5,16,21
2012-09-27,1,Sep,2,0,Thur,1,3,13,16
2012-09-27,1,Sep,3,0,Thur,1,0,7,7
2012-09-27,1,Sep,4,0,Thur,1,2,6,8
2012-09-27,1,Sep,5,0,Thur,1,2,64,66
2012-09-27,1,Sep,6,0,Thur,1,5,164,169
2012-09-27,1,Sep,7,0,Thur,1,12,546,558
2012-09-27,1,Sep,8,0,Thur,1,20,774,794
2012-09-27,1,Sep,9,0,Thur,1,30,305,335
2012-09-27,1,Sep,10,0,Thur,1,40,168,208
2012-09-27,1,Sep,11,0,Thur,1,67,227,294
2012-09-27,1,Sep,12,0,Thur,1,63,272,335
2012-09-27,1,Sep,13,0,Thur,1,61,265,326
2012-09-27,1,Sep,14,0,Thur,1,44,214,258
2012-09-27,1,Sep,15,0,Thur,1,41,255,296
2012-09-27,1,Sep,16,0,Thur,1,73,399,472
2012-09-27,1,Sep,17,0,Thur,1,87,818,905
2012-09-27,1,Sep,18,0,Thur,1,77,822,899
2012-09-27,1,Sep,19,0,Thur,1,48,511,559
2012-09-27,1,Sep,20,0,Thur,1,45,412,457
2012-09-27,1,Sep,21,0,Thur,1,18,235,253
2012-09-27,1,Sep,22,0,Thur,1,2,45,47
2012-09-27,1,Sep,23,0,Thur,1,1,44,45
2012-09-28,1,Sep,0,0,Fri,1,2,15,17
2012-09-28,1,Sep,1,0,Fri,1,0,13,13
2012-09-28,1,Sep,2,0,Fri,1,1,9,10
2012-09-28,1,Sep,3,0,Fri,1,0,7,7
2012-09-28,1,Sep,4,0,Fri,1,2,10,12
2012-09-28,1,Sep,5,0,Fri,1,1,37,38
2012-09-28,1,Sep,6,0,Fri,1,2,136,138
2012-09-28,1,Sep,7,0,Fri,1,10,384,394
2012-09-28,1,Sep,8,0,Fri,1,31,674,705
2012-09-28,1,Sep,9,0,Fri,1,27,399,426
2012-09-28,1,Sep,10,0,Fri,1,51,194,245
2012-09-28,1,Sep,11,0,Fri,1,109,252,361
2012-09-28,1,Sep,12,0,Fri,1,94,286,380
2012-09-28,1,Sep,13,0,Fri,1,106,304,410
2012-09-28,1,Sep,14,0,Fri,1,105,294,399
2012-09-28,1,Sep,15,0,Fri,1,104,288,392
2012-09-28,1,Sep,16,0,Fri,1,83,419,502
2012-09-28,1,Sep,17,0,Fri,1,101,707,808
2012-09-28,1,Sep,18,0,Fri,1,58,609,667
2012-09-28,1,Sep,19,0,Fri,1,38,470,508
2012-09-28,1,Sep,20,0,Fri,1,32,304,336
2012-09-28,1,Sep,21,0,Fri,1,32,205,237
2012-09-28,1,Sep,22,0,Fri,1,30,190,220
2012-09-28,1,Sep,23,0,Fri,1,26,164,190
2012-09-29,1,Sep,0,0,Sat,0,15,134,149
2012-09-29,1,Sep,1,0,Sat,0,12,89,101
2012-09-29,1,Sep,2,0,Sat,0,12,80,92
2012-09-29,1,Sep,3,0,Sat,0,4,25,29
2012-09-29,1,Sep,4,0,Sat,0,6,8,14
2012-09-29,1,Sep,5,0,Sat,0,2,13,15
2012-09-29,1,Sep,6,0,Sat,0,4,33,37
2012-09-29,1,Sep,7,0,Sat,0,12,61,73
2012-09-29,1,Sep,8,0,Sat,0,37,174,211
2012-09-29,1,Sep,9,0,Sat,0,69,263,332
2012-09-29,1,Sep,10,0,Sat,0,134,338,472
2012-09-29,1,Sep,11,0,Sat,0,217,446,663
2012-09-29,1,Sep,12,0,Sat,0,191,491,682
2012-09-29,1,Sep,13,0,Sat,0,233,453,686
2012-09-29,1,Sep,14,0,Sat,0,302,448,750
2012-09-29,1,Sep,15,0,Sat,0,271,456,727
2012-09-29,1,Sep,16,0,Sat,0,275,447,722
2012-09-29,1,Sep,17,0,Sat,0,256,456,712
2012-09-29,1,Sep,18,0,Sat,0,174,420,594
2012-09-29,1,Sep,19,0,Sat,0,119,351,470
2012-09-29,1,Sep,20,0,Sat,0,88,227,315
2012-09-29,1,Sep,21,0,Sat,0,73,219,292
2012-09-29,1,Sep,22,0,Sat,0,48,173,221
2012-09-29,1,Sep,23,0,Sat,0,35,161,196
2012-09-30,1,Sep,0,0,Sun,0,35,112,147
2012-09-30,1,Sep,1,0,Sun,0,31,85,116
2012-09-30,1,Sep,2,0,Sun,0,21,71,92
2012-09-30,1,Sep,3,0,Sun,0,17,41,58
2012-09-30,1,Sep,4,0,Sun,0,1,6,7
2012-09-30,1,Sep,5,0,Sun,0,1,9,10
2012-09-30,1,Sep,6,0,Sun,0,2,20,22
2012-09-30,1,Sep,7,0,Sun,0,14,43,57
2012-09-30,1,Sep,8,0,Sun,0,18,126,144
2012-09-30,1,Sep,9,0,Sun,0,74,211,285
2012-09-30,1,Sep,10,0,Sun,0,160,319,479
2012-09-30,1,Sep,11,0,Sun,0,222,369,591
2012-09-30,1,Sep,12,0,Sun,0,206,474,680
2012-09-30,1,Sep,13,0,Sun,0,180,414,594
2012-09-30,1,Sep,14,0,Sun,0,208,404,612
2012-09-30,1,Sep,15,0,Sun,0,230,419,649
2012-09-30,1,Sep,16,0,Sun,0,202,446,648
2012-09-30,1,Sep,17,0,Sun,0,195,380,575
2012-09-30,1,Sep,18,0,Sun,0,91,310,401
2012-09-30,1,Sep,19,0,Sun,0,34,223,257
2012-09-30,1,Sep,20,0,Sun,0,31,163,194
2012-09-30,1,Sep,21,0,Sun,0,19,104,123
2012-09-30,1,Sep,22,0,Sun,0,15,76,91
2012-09-30,1,Sep,23,0,Sun,0,8,49,57
2012-10-01,1,Oct,0,0,Mon,1,6,39,45
2012-10-01,1,Oct,1,0,Mon,1,5,13,18
2012-10-01,1,Oct,2,0,Mon,1,6,6,12
2012-10-01,1,Oct,3,0,Mon,1,1,6,7
2012-10-01,1,Oct,4,0,Mon,1,0,10,10
2012-10-01,1,Oct,5,0,Mon,1,2,34,36
2012-10-01,1,Oct,6,0,Mon,1,8,147,155
2012-10-01,1,Oct,7,0,Mon,1,13,470,483
2012-10-01,1,Oct,8,0,Mon,1,40,744,784
2012-10-01,1,Oct,9,0,Mon,1,26,314,340
2012-10-01,1,Oct,10,0,Mon,1,44,135,179
2012-10-01,1,Oct,11,0,Mon,1,76,196,272
2012-10-01,1,Oct,12,0,Mon,1,61,262,323
2012-10-01,1,Oct,13,0,Mon,1,80,225,305
2012-10-01,1,Oct,14,0,Mon,1,51,193,244
2012-10-01,1,Oct,15,0,Mon,1,95,234,329
2012-10-01,1,Oct,16,0,Mon,1,51,408,459
2012-10-01,1,Oct,17,0,Mon,1,65,791,856
2012-10-01,1,Oct,18,0,Mon,1,42,571,613
2012-10-01,1,Oct,19,0,Mon,1,33,483,516
2012-10-01,1,Oct,20,0,Mon,1,11,251,262
2012-10-01,1,Oct,21,0,Mon,1,13,205,218
2012-10-01,1,Oct,22,0,Mon,1,17,190,207
2012-10-01,1,Oct,23,0,Mon,1,17,88,105
2012-10-02,1,Oct,0,0,Tue,1,1,30,31
2012-10-02,1,Oct,1,0,Tue,1,0,11,11
2012-10-02,1,Oct,2,0,Tue,1,0,2,2
2012-10-02,1,Oct,3,0,Tue,1,1,4,5
2012-10-02,1,Oct,4,0,Tue,1,2,8,10
2012-10-02,1,Oct,5,0,Tue,1,1,42,43
2012-10-02,1,Oct,6,0,Tue,1,3,176,179
2012-10-02,1,Oct,7,0,Tue,1,4,256,260
2012-10-02,1,Oct,8,0,Tue,1,6,128,134
2012-10-02,1,Oct,9,0,Tue,1,3,83,86
2012-10-02,1,Oct,10,0,Tue,1,3,42,45
2012-10-02,1,Oct,11,0,Tue,1,7,92,99
2012-10-02,1,Oct,12,0,Tue,1,6,98,104
2012-10-02,1,Oct,13,0,Tue,1,6,148,154
2012-10-02,1,Oct,14,0,Tue,1,16,147,163
2012-10-02,1,Oct,15,0,Tue,1,14,195,209
2012-10-02,1,Oct,16,0,Tue,1,46,328,374
2012-10-02,1,Oct,17,0,Tue,1,38,677,715
2012-10-02,1,Oct,18,0,Tue,1,48,639,687
2012-10-02,1,Oct,19,0,Tue,1,27,368,395
2012-10-02,1,Oct,20,0,Tue,1,20,286,306
2012-10-02,1,Oct,21,0,Tue,1,24,265,289
2012-10-02,1,Oct,22,0,Tue,1,28,212,240
2012-10-02,1,Oct,23,0,Tue,1,11,87,98
2012-10-03,1,Oct,0,0,Wed,1,5,47,52
2012-10-03,1,Oct,1,0,Wed,1,3,16,19
2012-10-03,1,Oct,2,0,Wed,1,2,7,9
2012-10-03,1,Oct,3,0,Wed,1,0,7,7
2012-10-03,1,Oct,4,0,Wed,1,2,9,11
2012-10-03,1,Oct,5,0,Wed,1,2,32,34
2012-10-03,1,Oct,6,0,Wed,1,4,173,177
2012-10-03,1,Oct,7,0,Wed,1,11,504,515
2012-10-03,1,Oct,8,0,Wed,1,28,781,809
2012-10-03,1,Oct,9,0,Wed,1,30,332,362
2012-10-03,1,Oct,10,0,Wed,1,29,146,175
2012-10-03,1,Oct,11,0,Wed,1,52,178,230
2012-10-03,1,Oct,12,0,Wed,1,69,289,358
2012-10-03,1,Oct,13,0,Wed,1,55,224,279
2012-10-03,1,Oct,14,0,Wed,1,56,195,251
2012-10-03,1,Oct,15,0,Wed,1,59,260,319
2012-10-03,1,Oct,16,0,Wed,1,42,436,478
2012-10-03,1,Oct,17,0,Wed,1,84,833,917
2012-10-03,1,Oct,18,0,Wed,1,54,756,810
2012-10-03,1,Oct,19,0,Wed,1,49,544,593
2012-10-03,1,Oct,20,0,Wed,1,48,449,497
2012-10-03,1,Oct,21,0,Wed,1,14,195,209
2012-10-03,1,Oct,22,0,Wed,1,9,232,241
2012-10-03,1,Oct,23,0,Wed,1,21,199,220
2012-10-04,1,Oct,0,0,Thur,1,11,65,76
2012-10-04,1,Oct,1,0,Thur,1,2,23,25
2012-10-04,1,Oct,2,0,Thur,1,3,10,13
2012-10-04,1,Oct,3,0,Thur,1,5,6,11
2012-10-04,1,Oct,4,0,Thur,1,0,10,10
2012-10-04,1,Oct,5,0,Thur,1,2,37,39
2012-10-04,1,Oct,6,0,Thur,1,1,132,133
2012-10-04,1,Oct,7,0,Thur,1,12,379,391
2012-10-04,1,Oct,8,0,Thur,1,27,711,738
2012-10-04,1,Oct,9,0,Thur,1,40,319,359
2012-10-04,1,Oct,10,0,Thur,1,27,150,177
2012-10-04,1,Oct,11,0,Thur,1,38,176,214
2012-10-04,1,Oct,12,0,Thur,1,57,231,288
2012-10-04,1,Oct,13,0,Thur,1,63,231,294
2012-10-04,1,Oct,14,0,Thur,1,56,211,267
2012-10-04,1,Oct,15,0,Thur,1,77,248,325
2012-10-04,1,Oct,16,0,Thur,1,86,411,497
2012-10-04,1,Oct,17,0,Thur,1,112,789,901
2012-10-04,1,Oct,18,0,Thur,1,75,812,887
2012-10-04,1,Oct,19,0,Thur,1,67,467,534
2012-10-04,1,Oct,20,0,Thur,1,50,391,441
2012-10-04,1,Oct,21,0,Thur,1,33,288,321
2012-10-04,1,Oct,22,0,Thur,1,29,203,232
2012-10-04,1,Oct,23,0,Thur,1,18,137,155
2012-10-05,1,Oct,0,0,Fri,1,16,86,102
2012-10-05,1,Oct,1,0,Fri,1,3,43,46
2012-10-05,1,Oct,2,0,Fri,1,1,10,11
2012-10-05,1,Oct,3,0,Fri,1,5,11,16
2012-10-05,1,Oct,4,0,Fri,1,0,11,11
2012-10-05,1,Oct,5,0,Fri,1,0,41,41
2012-10-05,1,Oct,6,0,Fri,1,4,133,137
2012-10-05,1,Oct,7,0,Fri,1,11,417,428
2012-10-05,1,Oct,8,0,Fri,1,36,749,785
2012-10-05,1,Oct,9,0,Fri,1,58,326,384
2012-10-05,1,Oct,10,0,Fri,1,68,192,260
2012-10-05,1,Oct,11,0,Fri,1,90,214,304
2012-10-05,1,Oct,12,0,Fri,1,161,307,468
2012-10-05,1,Oct,13,0,Fri,1,117,307,424
2012-10-05,1,Oct,14,0,Fri,1,113,287,400
2012-10-05,1,Oct,15,0,Fri,1,150,320,470
2012-10-05,1,Oct,16,0,Fri,1,153,481,634
2012-10-05,1,Oct,17,0,Fri,1,158,742,900
2012-10-05,1,Oct,18,0,Fri,1,106,655,761
2012-10-05,1,Oct,19,0,Fri,1,67,433,500
2012-10-05,1,Oct,20,0,Fri,1,66,306,372
2012-10-05,1,Oct,21,0,Fri,1,47,220,267
2012-10-05,1,Oct,22,0,Fri,1,63,201,264
2012-10-05,1,Oct,23,0,Fri,1,23,148,171
2012-10-06,1,Oct,0,0,Sat,0,37,154,191
2012-10-06,1,Oct,1,0,Sat,0,25,116,141
2012-10-06,1,Oct,2,0,Sat,0,13,62,75
2012-10-06,1,Oct,3,0,Sat,0,2,54,56
2012-10-06,1,Oct,4,0,Sat,0,4,7,11
2012-10-06,1,Oct,5,0,Sat,0,2,8,10
2012-10-06,1,Oct,6,0,Sat,0,2,28,30
2012-10-06,1,Oct,7,0,Sat,0,13,71,84
2012-10-06,1,Oct,8,0,Sat,0,22,184,206
2012-10-06,1,Oct,9,0,Sat,0,130,265,395
2012-10-06,1,Oct,10,0,Sat,0,198,341,539
2012-10-06,1,Oct,11,0,Sat,0,258,389,647
2012-10-06,1,Oct,12,0,Sat,0,362,381,743
2012-10-06,1,Oct,13,0,Sat,0,310,400,710
2012-10-06,1,Oct,14,0,Sat,0,269,307,576
2012-10-06,1,Oct,15,0,Sat,0,279,341,620
2012-10-06,1,Oct,16,0,Sat,0,317,342,659
2012-10-06,1,Oct,17,0,Sat,0,268,342,610
2012-10-06,1,Oct,18,0,Sat,0,183,312,495
2012-10-06,1,Oct,19,0,Sat,0,102,239,341
2012-10-06,1,Oct,20,0,Sat,0,75,172,247
2012-10-06,1,Oct,21,0,Sat,0,78,137,215
2012-10-06,1,Oct,22,0,Sat,0,45,140,185
2012-10-06,1,Oct,23,0,Sat,0,37,142,179
2012-10-07,1,Oct,0,0,Sun,0,28,99,127
2012-10-07,1,Oct,1,0,Sun,0,29,80,109
2012-10-07,1,Oct,2,0,Sun,0,10,64,74
2012-10-07,1,Oct,3,0,Sun,0,5,17,22
2012-10-07,1,Oct,4,0,Sun,0,5,6,11
2012-10-07,1,Oct,5,0,Sun,0,2,8,10
2012-10-07,1,Oct,6,0,Sun,0,4,19,23
2012-10-07,1,Oct,7,0,Sun,0,6,29,35
2012-10-07,1,Oct,8,0,Sun,0,11,51,62
2012-10-07,1,Oct,9,0,Sun,0,16,70,86
2012-10-07,1,Oct,10,0,Sun,0,41,144,185
2012-10-07,1,Oct,11,0,Sun,0,76,260,336
2012-10-07,1,Oct,12,0,Sun,0,100,292,392
2012-10-07,1,Oct,13,0,Sun,0,80,240,320
2012-10-07,1,Oct,14,0,Sun,0,71,243,314
2012-10-07,1,Oct,15,0,Sun,0,74,232,306
2012-10-07,1,Oct,16,0,Sun,0,87,246,333
2012-10-07,1,Oct,17,0,Sun,0,35,122,157
2012-10-07,1,Oct,18,0,Sun,0,24,82,106
2012-10-07,1,Oct,19,0,Sun,0,17,97,114
2012-10-07,1,Oct,20,0,Sun,0,19,97,116
2012-10-07,1,Oct,21,0,Sun,0,22,91,113
2012-10-07,1,Oct,22,0,Sun,0,7,72,79
2012-10-07,1,Oct,23,0,Sun,0,12,68,80
2012-10-08,1,Oct,0,1,Mon,0,7,44,51
2012-10-08,1,Oct,1,1,Mon,0,2,35,37
2012-10-08,1,Oct,2,1,Mon,0,3,12,15
2012-10-08,1,Oct,3,1,Mon,0,2,8,10
2012-10-08,1,Oct,4,1,Mon,0,1,6,7
2012-10-08,1,Oct,5,1,Mon,0,2,17,19
2012-10-08,1,Oct,6,1,Mon,0,5,54,59
2012-10-08,1,Oct,7,1,Mon,0,3,151,154
2012-10-08,1,Oct,8,1,Mon,0,23,374,397
2012-10-08,1,Oct,9,1,Mon,0,59,273,332
2012-10-08,1,Oct,10,1,Mon,0,69,229,298
2012-10-08,1,Oct,11,1,Mon,0,72,236,308
2012-10-08,1,Oct,12,1,Mon,0,74,267,341
2012-10-08,1,Oct,13,1,Mon,0,82,323,405
2012-10-08,1,Oct,14,1,Mon,0,121,299,420
2012-10-08,1,Oct,15,1,Mon,0,76,294,370
2012-10-08,1,Oct,16,1,Mon,0,61,316,377
2012-10-08,1,Oct,17,1,Mon,0,81,416,497
2012-10-08,1,Oct,18,1,Mon,0,41,415,456
2012-10-08,1,Oct,19,1,Mon,0,38,333,371
2012-10-08,1,Oct,20,1,Mon,0,20,207,227
2012-10-08,1,Oct,21,1,Mon,0,17,134,151
2012-10-08,1,Oct,22,1,Mon,0,6,101,107
2012-10-08,1,Oct,23,1,Mon,0,9,60,69
2012-10-09,1,Oct,0,0,Tue,1,9,22,31
2012-10-09,1,Oct,1,0,Tue,1,0,13,13
2012-10-09,1,Oct,2,0,Tue,1,2,5,7
2012-10-09,1,Oct,3,0,Tue,1,0,3,3
2012-10-09,1,Oct,4,0,Tue,1,1,6,7
2012-10-09,1,Oct,5,0,Tue,1,0,19,19
2012-10-09,1,Oct,6,0,Tue,1,2,141,143
2012-10-09,1,Oct,7,0,Tue,1,5,357,362
2012-10-09,1,Oct,8,0,Tue,1,15,698,713
2012-10-09,1,Oct,9,0,Tue,1,37,345,382
2012-10-09,1,Oct,10,0,Tue,1,33,131,164
2012-10-09,1,Oct,11,0,Tue,1,37,156,193
2012-10-09,1,Oct,12,0,Tue,1,43,217,260
2012-10-09,1,Oct,13,0,Tue,1,54,184,238
2012-10-09,1,Oct,14,0,Tue,1,43,201,244
2012-10-09,1,Oct,15,0,Tue,1,59,195,254
2012-10-09,1,Oct,16,0,Tue,1,70,354,424
2012-10-09,1,Oct,17,0,Tue,1,73,733,806
2012-10-09,1,Oct,18,0,Tue,1,26,758,784
2012-10-09,1,Oct,19,0,Tue,1,31,483,514
2012-10-09,1,Oct,20,0,Tue,1,30,330,360
2012-10-09,1,Oct,21,0,Tue,1,16,209,225
2012-10-09,1,Oct,22,0,Tue,1,7,155,162
2012-10-09,1,Oct,23,0,Tue,1,8,76,84
2012-10-10,1,Oct,0,0,Wed,1,0,33,33
2012-10-10,1,Oct,1,0,Wed,1,2,6,8
2012-10-10,1,Oct,2,0,Wed,1,2,6,8
2012-10-10,1,Oct,3,0,Wed,1,0,6,6
2012-10-10,1,Oct,4,0,Wed,1,0,6,6
2012-10-10,1,Oct,5,0,Wed,1,2,38,40
2012-10-10,1,Oct,6,0,Wed,1,3,172,175
2012-10-10,1,Oct,7,0,Wed,1,9,498,507
2012-10-10,1,Oct,8,0,Wed,1,33,806,839
2012-10-10,1,Oct,9,0,Wed,1,35,331,366
2012-10-10,1,Oct,10,0,Wed,1,27,190,217
2012-10-10,1,Oct,11,0,Wed,1,53,238,291
2012-10-10,1,Oct,12,0,Wed,1,78,312,390
2012-10-10,1,Oct,13,0,Wed,1,60,237,297
2012-10-10,1,Oct,14,0,Wed,1,63,208,271
2012-10-10,1,Oct,15,0,Wed,1,58,261,319
2012-10-10,1,Oct,16,0,Wed,1,92,474,566
2012-10-10,1,Oct,17,0,Wed,1,91,857,948
2012-10-10,1,Oct,18,0,Wed,1,57,787,844
2012-10-10,1,Oct,19,0,Wed,1,32,534,566
2012-10-10,1,Oct,20,0,Wed,1,21,371,392
2012-10-10,1,Oct,21,0,Wed,1,18,251,269
2012-10-10,1,Oct,22,0,Wed,1,27,170,197
2012-10-10,1,Oct,23,0,Wed,1,17,119,136
2012-10-11,1,Oct,0,0,Thur,1,1,41,42
2012-10-11,1,Oct,1,0,Thur,1,1,10,11
2012-10-11,1,Oct,2,0,Thur,1,4,7,11
2012-10-11,1,Oct,3,0,Thur,1,0,3,3
2012-10-11,1,Oct,4,0,Thur,1,0,10,10
2012-10-11,1,Oct,5,0,Thur,1,0,42,42
2012-10-11,1,Oct,6,0,Thur,1,1,158,159
2012-10-11,1,Oct,7,0,Thur,1,11,467,478
2012-10-11,1,Oct,8,0,Thur,1,25,773,798
2012-10-11,1,Oct,9,0,Thur,1,27,328,355
2012-10-11,1,Oct,10,0,Thur,1,39,165,204
2012-10-11,1,Oct,11,0,Thur,1,76,175,251
2012-10-11,1,Oct,12,0,Thur,1,47,279,326
2012-10-11,1,Oct,13,0,Thur,1,48,243,291
2012-10-11,1,Oct,14,0,Thur,1,78,270,348
2012-10-11,1,Oct,15,0,Thur,1,102,358,460
2012-10-11,1,Oct,16,0,Thur,1,68,413,481
2012-10-11,1,Oct,17,0,Thur,1,90,737,827
2012-10-11,1,Oct,18,0,Thur,1,64,628,692
2012-10-11,1,Oct,19,0,Thur,1,81,662,743
2012-10-11,1,Oct,20,0,Thur,1,27,388,415
2012-10-11,1,Oct,21,0,Thur,1,24,236,260
2012-10-11,1,Oct,22,0,Thur,1,10,167,177
2012-10-11,1,Oct,23,0,Thur,1,10,176,186
2012-10-12,1,Oct,0,0,Fri,1,8,60,68
2012-10-12,1,Oct,1,0,Fri,1,8,29,37
2012-10-12,1,Oct,2,0,Fri,1,0,16,16
2012-10-12,1,Oct,3,0,Fri,1,0,6,6
2012-10-12,1,Oct,4,0,Fri,1,0,8,8
2012-10-12,1,Oct,5,0,Fri,1,2,33,35
2012-10-12,1,Oct,6,0,Fri,1,3,140,143
2012-10-12,1,Oct,7,0,Fri,1,8,384,392
2012-10-12,1,Oct,8,0,Fri,1,34,711,745
2012-10-12,1,Oct,9,0,Fri,1,26,374,400
2012-10-12,1,Oct,10,0,Fri,1,75,200,275
2012-10-12,1,Oct,11,0,Fri,1,61,252,313
2012-10-12,1,Oct,12,0,Fri,1,75,312,387
2012-10-12,1,Oct,13,0,Fri,1,81,300,381
2012-10-12,1,Oct,14,0,Fri,1,109,262,371
2012-10-12,1,Oct,15,0,Fri,1,138,317,455
2012-10-12,1,Oct,16,0,Fri,1,108,412,520
2012-10-12,1,Oct,17,0,Fri,1,131,706,837
2012-10-12,1,Oct,18,0,Fri,1,76,566,642
2012-10-12,1,Oct,19,0,Fri,1,40,453,493
2012-10-12,1,Oct,20,0,Fri,1,28,280,308
2012-10-12,1,Oct,21,0,Fri,1,21,169,190
2012-10-12,1,Oct,22,0,Fri,1,17,143,160
2012-10-12,1,Oct,23,0,Fri,1,11,89,100
2012-10-13,1,Oct,0,0,Sat,0,31,218,249
2012-10-13,1,Oct,1,0,Sat,0,23,123,146
2012-10-13,1,Oct,2,0,Sat,0,7,60,67
2012-10-13,1,Oct,3,0,Sat,0,2,13,15
2012-10-13,1,Oct,4,0,Sat,0,2,9,11
2012-10-13,1,Oct,5,0,Sat,0,0,11,11
2012-10-13,1,Oct,6,0,Sat,0,5,23,28
2012-10-13,1,Oct,7,0,Sat,0,10,60,70
2012-10-13,1,Oct,8,0,Sat,0,23,151,174
2012-10-13,1,Oct,9,0,Sat,0,46,220,266
2012-10-13,1,Oct,10,0,Sat,0,82,265,347
2012-10-13,1,Oct,11,0,Sat,0,192,335,527
2012-10-13,1,Oct,12,0,Sat,0,202,371,573
2012-10-13,1,Oct,13,0,Sat,0,235,435,670
2012-10-13,1,Oct,14,0,Sat,0,243,354,597
2012-10-13,1,Oct,15,0,Sat,0,251,364,615
2012-10-13,1,Oct,16,0,Sat,0,294,343,637
2012-10-13,1,Oct,17,0,Sat,0,193,335,528
2012-10-13,1,Oct,18,0,Sat,0,174,299,473
2012-10-13,1,Oct,19,0,Sat,0,73,259,332
2012-10-13,1,Oct,20,0,Sat,0,57,198,255
2012-10-13,1,Oct,21,0,Sat,0,47,157,204
2012-10-13,1,Oct,22,0,Sat,0,33,156,189
2012-10-13,1,Oct,23,0,Sat,0,27,98,125
2012-10-14,1,Oct,0,0,Sun,0,8,103,111
2012-10-14,1,Oct,1,0,Sun,0,16,96,112
2012-10-14,1,Oct,2,0,Sun,0,8,58,66
2012-10-14,1,Oct,3,0,Sun,0,3,25,28
2012-10-14,1,Oct,4,0,Sun,0,2,10,12
2012-10-14,1,Oct,5,0,Sun,0,5,6,11
2012-10-14,1,Oct,6,0,Sun,0,4,20,24
2012-10-14,1,Oct,7,0,Sun,0,7,44,51
2012-10-14,1,Oct,8,0,Sun,0,28,104,132
2012-10-14,1,Oct,9,0,Sun,0,62,161,223
2012-10-14,1,Oct,10,0,Sun,0,150,278,428
2012-10-14,1,Oct,11,0,Sun,0,156,338,494
2012-10-14,1,Oct,12,0,Sun,0,200,362,562
2012-10-14,1,Oct,13,0,Sun,0,218,401,619
2012-10-14,1,Oct,14,0,Sun,0,249,368,617
2012-10-14,1,Oct,15,0,Sun,0,213,355,568
2012-10-14,1,Oct,16,0,Sun,0,203,378,581
2012-10-14,1,Oct,17,0,Sun,0,193,346,539
2012-10-14,1,Oct,18,0,Sun,0,134,319,453
2012-10-14,1,Oct,19,0,Sun,0,68,268,336
2012-10-14,1,Oct,20,0,Sun,0,48,198,246
2012-10-14,1,Oct,21,0,Sun,0,40,156,196
2012-10-14,1,Oct,22,0,Sun,0,38,87,125
2012-10-14,1,Oct,23,0,Sun,0,27,78,105
2012-10-15,1,Oct,0,0,Mon,1,17,31,48
2012-10-15,1,Oct,1,0,Mon,1,5,24,29
2012-10-15,1,Oct,2,0,Mon,1,1,5,6
2012-10-15,1,Oct,3,0,Mon,1,2,2,4
2012-10-15,1,Oct,4,0,Mon,1,1,9,10
2012-10-15,1,Oct,5,0,Mon,1,2,38,40
2012-10-15,1,Oct,6,0,Mon,1,6,141,147
2012-10-15,1,Oct,7,0,Mon,1,15,461,476
2012-10-15,1,Oct,8,0,Mon,1,24,713,737
2012-10-15,1,Oct,9,0,Mon,1,31,328,359
2012-10-15,1,Oct,10,0,Mon,1,43,125,168
2012-10-15,1,Oct,11,0,Mon,1,88,175,263
2012-10-15,1,Oct,12,0,Mon,1,73,211,284
2012-10-15,1,Oct,13,0,Mon,1,37,109,146
2012-10-15,1,Oct,14,0,Mon,1,57,128,185
2012-10-15,1,Oct,15,0,Mon,1,70,190,260
2012-10-15,1,Oct,16,0,Mon,1,76,371,447
2012-10-15,1,Oct,17,0,Mon,1,96,670,766
2012-10-15,1,Oct,18,0,Mon,1,52,540,592
2012-10-15,1,Oct,19,0,Mon,1,12,227,239
2012-10-15,1,Oct,20,0,Mon,1,19,237,256
2012-10-15,1,Oct,21,0,Mon,1,16,190,206
2012-10-15,1,Oct,22,0,Mon,1,8,118,126
2012-10-15,1,Oct,23,0,Mon,1,9,72,81
2012-10-16,1,Oct,0,0,Tue,1,3,45,48
2012-10-16,1,Oct,1,0,Tue,1,4,9,13
2012-10-16,1,Oct,2,0,Tue,1,2,1,3
2012-10-16,1,Oct,3,0,Tue,1,0,2,2
2012-10-16,1,Oct,4,0,Tue,1,0,7,7
2012-10-16,1,Oct,5,0,Tue,1,5,47,52
2012-10-16,1,Oct,6,0,Tue,1,4,168,172
2012-10-16,1,Oct,7,0,Tue,1,20,505,525
2012-10-16,1,Oct,8,0,Tue,1,35,800,835
2012-10-16,1,Oct,9,0,Tue,1,32,323,355
2012-10-16,1,Oct,10,0,Tue,1,65,157,222
2012-10-16,1,Oct,11,0,Tue,1,56,172,228
2012-10-16,1,Oct,12,0,Tue,1,69,256,325
2012-10-16,1,Oct,13,0,Tue,1,68,260,328
2012-10-16,1,Oct,14,0,Tue,1,94,214,308
2012-10-16,1,Oct,15,0,Tue,1,76,270,346
2012-10-16,1,Oct,16,0,Tue,1,79,367,446
2012-10-16,1,Oct,17,0,Tue,1,104,839,943
2012-10-16,1,Oct,18,0,Tue,1,71,767,838
2012-10-16,1,Oct,19,0,Tue,1,40,491,531
2012-10-16,1,Oct,20,0,Tue,1,35,397,432
2012-10-16,1,Oct,21,0,Tue,1,19,176,195
2012-10-16,1,Oct,22,0,Tue,1,18,163,181
2012-10-16,1,Oct,23,0,Tue,1,23,176,199
2012-10-17,1,Oct,0,0,Wed,1,1,48,49
2012-10-17,1,Oct,1,0,Wed,1,3,14,17
2012-10-17,1,Oct,2,0,Wed,1,4,12,16
2012-10-17,1,Oct,3,0,Wed,1,0,7,7
2012-10-17,1,Oct,4,0,Wed,1,0,4,4
2012-10-17,1,Oct,5,0,Wed,1,2,39,41
2012-10-17,1,Oct,6,0,Wed,1,7,171,178
2012-10-17,1,Oct,7,0,Wed,1,15,449,464
2012-10-17,1,Oct,8,0,Wed,1,38,779,817
2012-10-17,1,Oct,9,0,Wed,1,38,344,382
2012-10-17,1,Oct,10,0,Wed,1,60,168,228
2012-10-17,1,Oct,11,0,Wed,1,78,156,234
2012-10-17,1,Oct,12,0,Wed,1,71,261,332
2012-10-17,1,Oct,13,0,Wed,1,73,237,310
2012-10-17,1,Oct,14,0,Wed,1,82,188,270
2012-10-17,1,Oct,15,0,Wed,1,62,239,301
2012-10-17,1,Oct,16,0,Wed,1,70,396,466
2012-10-17,1,Oct,17,0,Wed,1,122,766,888
2012-10-17,1,Oct,18,0,Wed,1,90,794,884
2012-10-17,1,Oct,19,0,Wed,1,49,467,516
2012-10-17,1,Oct,20,0,Wed,1,54,360,414
2012-10-17,1,Oct,21,0,Wed,1,28,301,329
2012-10-17,1,Oct,22,0,Wed,1,17,198,215
2012-10-17,1,Oct,23,0,Wed,1,15,84,99
2012-10-18,1,Oct,0,0,Thur,1,4,53,57
2012-10-18,1,Oct,1,0,Thur,1,0,14,14
2012-10-18,1,Oct,2,0,Thur,1,1,13,14
2012-10-18,1,Oct,3,0,Thur,1,0,5,5
2012-10-18,1,Oct,4,0,Thur,1,0,5,5
2012-10-18,1,Oct,5,0,Thur,1,1,41,42
2012-10-18,1,Oct,6,0,Thur,1,3,150,153
2012-10-18,1,Oct,7,0,Thur,1,20,488,508
2012-10-18,1,Oct,8,0,Thur,1,31,803,834
2012-10-18,1,Oct,9,0,Thur,1,41,346,387
2012-10-18,1,Oct,10,0,Thur,1,60,158,218
2012-10-18,1,Oct,11,0,Thur,1,79,189,268
2012-10-18,1,Oct,12,0,Thur,1,93,284,377
2012-10-18,1,Oct,13,0,Thur,1,96,236,332
2012-10-18,1,Oct,14,0,Thur,1,94,191,285
2012-10-18,1,Oct,15,0,Thur,1,69,284,353
2012-10-18,1,Oct,16,0,Thur,1,94,356,450
2012-10-18,1,Oct,17,0,Thur,1,102,788,890
2012-10-18,1,Oct,18,0,Thur,1,68,720,788
2012-10-18,1,Oct,19,0,Thur,1,42,471,513
2012-10-18,1,Oct,20,0,Thur,1,39,348,387
2012-10-18,1,Oct,21,0,Thur,1,38,245,283
2012-10-18,1,Oct,22,0,Thur,1,27,202,229
2012-10-18,1,Oct,23,0,Thur,1,6,111,117
2012-10-19,1,Oct,0,0,Fri,1,5,51,56
2012-10-19,1,Oct,1,0,Fri,1,4,12,16
2012-10-19,1,Oct,2,0,Fri,1,1,9,10
2012-10-19,1,Oct,3,0,Fri,1,0,5,5
2012-10-19,1,Oct,4,0,Fri,1,1,5,6
2012-10-19,1,Oct,5,0,Fri,1,1,35,36
2012-10-19,1,Oct,6,0,Fri,1,5,126,131
2012-10-19,1,Oct,7,0,Fri,1,5,149,154
2012-10-19,1,Oct,8,0,Fri,1,20,447,467
2012-10-19,1,Oct,9,0,Fri,1,26,363,389
2012-10-19,1,Oct,10,0,Fri,1,26,198,224
2012-10-19,1,Oct,11,0,Fri,1,41,211,252
2012-10-19,1,Oct,12,0,Fri,1,74,258,332
2012-10-19,1,Oct,13,0,Fri,1,87,288,375
2012-10-19,1,Oct,14,0,Fri,1,88,277,365
2012-10-19,1,Oct,15,0,Fri,1,93,302,395
2012-10-19,1,Oct,16,0,Fri,1,131,434,565
2012-10-19,1,Oct,17,0,Fri,1,48,377,425
2012-10-19,1,Oct,18,0,Fri,1,21,212,233
2012-10-19,1,Oct,19,0,Fri,1,19,213,232
2012-10-19,1,Oct,20,0,Fri,1,13,216,229
2012-10-19,1,Oct,21,0,Fri,1,17,189,206
2012-10-19,1,Oct,22,0,Fri,1,14,176,190
2012-10-19,1,Oct,23,0,Fri,1,13,118,131
2012-10-20,1,Oct,0,0,Sat,0,13,110,123
2012-10-20,1,Oct,1,0,Sat,0,2,93,95
2012-10-20,1,Oct,2,0,Sat,0,9,69,78
2012-10-20,1,Oct,3,0,Sat,0,2,27,29
2012-10-20,1,Oct,4,0,Sat,0,9,9,18
2012-10-20,1,Oct,5,0,Sat,0,6,7,13
2012-10-20,1,Oct,6,0,Sat,0,5,26,31
2012-10-20,1,Oct,7,0,Sat,0,6,59,65
2012-10-20,1,Oct,8,0,Sat,0,29,164,193
2012-10-20,1,Oct,9,0,Sat,0,106,257,363
2012-10-20,1,Oct,10,0,Sat,0,111,312,423
2012-10-20,1,Oct,11,0,Sat,0,204,408,612
2012-10-20,1,Oct,12,0,Sat,0,267,436,703
2012-10-20,1,Oct,13,0,Sat,0,273,441,714
2012-10-20,1,Oct,14,0,Sat,0,335,376,711
2012-10-20,1,Oct,15,0,Sat,0,308,403,711
2012-10-20,1,Oct,16,0,Sat,0,325,366,691
2012-10-20,1,Oct,17,0,Sat,0,347,384,731
2012-10-20,1,Oct,18,0,Sat,0,165,356,521
2012-10-20,1,Oct,19,0,Sat,0,77,268,345
2012-10-20,1,Oct,20,0,Sat,0,61,198,259
2012-10-20,1,Oct,21,0,Sat,0,72,224,296
2012-10-20,1,Oct,22,0,Sat,0,47,155,202
2012-10-20,1,Oct,23,0,Sat,0,27,136,163
2012-10-21,1,Oct,0,0,Sun,0,35,119,154
2012-10-21,1,Oct,1,0,Sun,0,20,97,117
2012-10-21,1,Oct,2,0,Sun,0,44,88,132
2012-10-21,1,Oct,3,0,Sun,0,12,29,41
2012-10-21,1,Oct,4,0,Sun,0,8,13,21
2012-10-21,1,Oct,5,0,Sun,0,6,4,10
2012-10-21,1,Oct,6,0,Sun,0,8,18,26
2012-10-21,1,Oct,7,0,Sun,0,13,43,56
2012-10-21,1,Oct,8,0,Sun,0,39,104,143
2012-10-21,1,Oct,9,0,Sun,0,77,192,269
2012-10-21,1,Oct,10,0,Sun,0,167,276,443
2012-10-21,1,Oct,11,0,Sun,0,191,356,547
2012-10-21,1,Oct,12,0,Sun,0,236,439,675
2012-10-21,1,Oct,13,0,Sun,0,243,383,626
2012-10-21,1,Oct,14,0,Sun,0,235,405,640
2012-10-21,1,Oct,15,0,Sun,0,240,383,623
2012-10-21,1,Oct,16,0,Sun,0,182,409,591
2012-10-21,1,Oct,17,0,Sun,0,153,338,491
2012-10-21,1,Oct,18,0,Sun,0,71,342,413
2012-10-21,1,Oct,19,0,Sun,0,50,216,266
2012-10-21,1,Oct,20,0,Sun,0,35,160,195
2012-10-21,1,Oct,21,0,Sun,0,42,124,166
2012-10-21,1,Oct,22,0,Sun,0,18,95,113
2012-10-21,1,Oct,23,0,Sun,0,7,59,66
2012-10-22,1,Oct,0,0,Mon,1,3,28,31
2012-10-22,1,Oct,1,0,Mon,1,0,11,11
2012-10-22,1,Oct,2,0,Mon,1,1,4,5
2012-10-22,1,Oct,3,0,Mon,1,1,5,6
2012-10-22,1,Oct,4,0,Mon,1,1,6,7
2012-10-22,1,Oct,5,0,Mon,1,2,44,46
2012-10-22,1,Oct,6,0,Mon,1,4,140,144
2012-10-22,1,Oct,7,0,Mon,1,15,437,452
2012-10-22,1,Oct,8,0,Mon,1,32,696,728
2012-10-22,1,Oct,9,0,Mon,1,25,335,360
2012-10-22,1,Oct,10,0,Mon,1,51,161,212
2012-10-22,1,Oct,11,0,Mon,1,63,148,211
2012-10-22,1,Oct,12,0,Mon,1,52,231,283
2012-10-22,1,Oct,13,0,Mon,1,88,227,315
2012-10-22,1,Oct,14,0,Mon,1,73,209,282
2012-10-22,1,Oct,15,0,Mon,1,74,222,296
2012-10-22,1,Oct,16,0,Mon,1,80,444,524
2012-10-22,1,Oct,17,0,Mon,1,84,838,922
2012-10-22,1,Oct,18,0,Mon,1,60,726,786
2012-10-22,1,Oct,19,0,Mon,1,36,478,514
2012-10-22,1,Oct,20,0,Mon,1,21,382,403
2012-10-22,1,Oct,21,0,Mon,1,19,155,174
2012-10-22,1,Oct,22,0,Mon,1,25,158,183
2012-10-22,1,Oct,23,0,Mon,1,20,143,163
2012-10-23,1,Oct,0,0,Tue,1,5,32,37
2012-10-23,1,Oct,1,0,Tue,1,1,16,17
2012-10-23,1,Oct,2,0,Tue,1,1,6,7
2012-10-23,1,Oct,3,0,Tue,1,0,1,1
2012-10-23,1,Oct,4,0,Tue,1,1,6,7
2012-10-23,1,Oct,5,0,Tue,1,1,49,50
2012-10-23,1,Oct,6,0,Tue,1,6,152,158
2012-10-23,1,Oct,7,0,Tue,1,12,519,531
2012-10-23,1,Oct,8,0,Tue,1,28,733,761
2012-10-23,1,Oct,9,0,Tue,1,29,305,334
2012-10-23,1,Oct,10,0,Tue,1,50,171,221
2012-10-23,1,Oct,11,0,Tue,1,52,201,253
2012-10-23,1,Oct,12,0,Tue,1,80,298,378
2012-10-23,1,Oct,13,0,Tue,1,59,244,303
2012-10-23,1,Oct,14,0,Tue,1,67,229,296
2012-10-23,1,Oct,15,0,Tue,1,76,270,346
2012-10-23,1,Oct,16,0,Tue,1,108,433,541
2012-10-23,1,Oct,17,0,Tue,1,67,871,938
2012-10-23,1,Oct,18,0,Tue,1,64,762,826
2012-10-23,1,Oct,19,0,Tue,1,25,457,482
2012-10-23,1,Oct,20,0,Tue,1,45,334,379
2012-10-23,1,Oct,21,0,Tue,1,35,260,295
2012-10-23,1,Oct,22,0,Tue,1,20,174,194
2012-10-23,1,Oct,23,0,Tue,1,9,102,111
2012-10-24,1,Oct,0,0,Wed,1,7,39,46
2012-10-24,1,Oct,1,0,Wed,1,4,23,27
2012-10-24,1,Oct,2,0,Wed,1,0,6,6
2012-10-24,1,Oct,3,0,Wed,1,0,4,4
2012-10-24,1,Oct,4,0,Wed,1,1,5,6
2012-10-24,1,Oct,5,0,Wed,1,1,52,53
2012-10-24,1,Oct,6,0,Wed,1,11,162,173
2012-10-24,1,Oct,7,0,Wed,1,20,506,526
2012-10-24,1,Oct,8,0,Wed,1,24,777,801
2012-10-24,1,Oct,9,0,Wed,1,24,349,373
2012-10-24,1,Oct,10,0,Wed,1,29,142,171
2012-10-24,1,Oct,11,0,Wed,1,47,189,236
2012-10-24,1,Oct,12,0,Wed,1,48,268,316
2012-10-24,1,Oct,13,0,Wed,1,65,241,306
2012-10-24,1,Oct,14,0,Wed,1,64,237,301
2012-10-24,1,Oct,15,0,Wed,1,63,245,308
2012-10-24,1,Oct,16,0,Wed,1,67,465,532
2012-10-24,1,Oct,17,0,Wed,1,87,876,963
2012-10-24,1,Oct,18,0,Wed,1,63,795,858
2012-10-24,1,Oct,19,0,Wed,1,50,522,572
2012-10-24,1,Oct,20,0,Wed,1,45,396,441
2012-10-24,1,Oct,21,0,Wed,1,33,280,313
2012-10-24,1,Oct,22,0,Wed,1,30,208,238
2012-10-24,1,Oct,23,0,Wed,1,12,111,123
2012-10-25,1,Oct,0,0,Thur,1,19,57,76
2012-10-25,1,Oct,1,0,Thur,1,6,22,28
2012-10-25,1,Oct,2,0,Thur,1,3,15,18
2012-10-25,1,Oct,3,0,Thur,1,0,8,8
2012-10-25,1,Oct,4,0,Thur,1,1,4,5
2012-10-25,1,Oct,5,0,Thur,1,2,53,55
2012-10-25,1,Oct,6,0,Thur,1,3,168,171
2012-10-25,1,Oct,7,0,Thur,1,18,477,495
2012-10-25,1,Oct,8,0,Thur,1,33,746,779
2012-10-25,1,Oct,9,0,Thur,1,23,320,343
2012-10-25,1,Oct,10,0,Thur,1,53,172,225
2012-10-25,1,Oct,11,0,Thur,1,57,181,238
2012-10-25,1,Oct,12,0,Thur,1,61,258,319
2012-10-25,1,Oct,13,0,Thur,1,49,264,313
2012-10-25,1,Oct,14,0,Thur,1,71,214,285
2012-10-25,1,Oct,15,0,Thur,1,63,242,305
2012-10-25,1,Oct,16,0,Thur,1,92,407,499
2012-10-25,1,Oct,17,0,Thur,1,112,774,886
2012-10-25,1,Oct,18,0,Thur,1,77,732,809
2012-10-25,1,Oct,19,0,Thur,1,45,497,542
2012-10-25,1,Oct,20,0,Thur,1,28,319,347
2012-10-25,1,Oct,21,0,Thur,1,24,247,271
2012-10-25,1,Oct,22,0,Thur,1,22,185,207
2012-10-25,1,Oct,23,0,Thur,1,13,122,135
2012-10-26,1,Oct,0,0,Fri,1,6,65,71
2012-10-26,1,Oct,1,0,Fri,1,4,32,36
2012-10-26,1,Oct,2,0,Fri,1,4,15,19
2012-10-26,1,Oct,3,0,Fri,1,5,8,13
2012-10-26,1,Oct,4,0,Fri,1,1,4,5
2012-10-26,1,Oct,5,0,Fri,1,3,47,50
2012-10-26,1,Oct,6,0,Fri,1,2,142,144
2012-10-26,1,Oct,7,0,Fri,1,13,408,421
2012-10-26,1,Oct,8,0,Fri,1,20,714,734
2012-10-26,1,Oct,9,0,Fri,1,56,347,403
2012-10-26,1,Oct,10,0,Fri,1,41,156,197
2012-10-26,1,Oct,11,0,Fri,1,68,222,290
2012-10-26,1,Oct,12,0,Fri,1,90,302,392
2012-10-26,1,Oct,13,0,Fri,1,77,260,337
2012-10-26,1,Oct,14,0,Fri,1,99,252,351
2012-10-26,1,Oct,15,0,Fri,1,142,306,448
2012-10-26,1,Oct,16,0,Fri,1,137,445,582
2012-10-26,1,Oct,17,0,Fri,1,125,692,817
2012-10-26,1,Oct,18,0,Fri,1,81,584,665
2012-10-26,1,Oct,19,0,Fri,1,72,399,471
2012-10-26,1,Oct,20,0,Fri,1,40,271,311
2012-10-26,1,Oct,21,0,Fri,1,40,252,292
2012-10-26,1,Oct,22,0,Fri,1,37,180,217
2012-10-26,1,Oct,23,0,Fri,1,19,159,178
2012-10-27,1,Oct,0,0,Sat,0,10,132,142
2012-10-27,1,Oct,1,0,Sat,0,23,123,146
2012-10-27,1,Oct,2,0,Sat,0,19,71,90
2012-10-27,1,Oct,3,0,Sat,0,5,21,26
2012-10-27,1,Oct,4,0,Sat,0,1,12,13
2012-10-27,1,Oct,5,0,Sat,0,2,7,9
2012-10-27,1,Oct,6,0,Sat,0,2,29,31
2012-10-27,1,Oct,7,0,Sat,0,7,79,86
2012-10-27,1,Oct,8,0,Sat,0,26,187,213
2012-10-27,1,Oct,9,0,Sat,0,88,240,328
2012-10-27,1,Oct,10,0,Sat,0,165,314,479
2012-10-27,1,Oct,11,0,Sat,0,197,388,585
2012-10-27,1,Oct,12,0,Sat,0,264,404,668
2012-10-27,1,Oct,13,0,Sat,0,310,450,760
2012-10-27,1,Oct,14,0,Sat,0,325,425,750
2012-10-27,1,Oct,15,0,Sat,0,310,401,711
2012-10-27,1,Oct,16,0,Sat,0,257,355,612
2012-10-27,1,Oct,17,0,Sat,0,248,370,618
2012-10-27,1,Oct,18,0,Sat,0,138,318,456
2012-10-27,1,Oct,19,0,Sat,0,67,233,300
2012-10-27,1,Oct,20,0,Sat,0,58,238,296
2012-10-27,1,Oct,21,0,Sat,0,49,160,209
2012-10-27,1,Oct,22,0,Sat,0,41,116,157
2012-10-27,1,Oct,23,0,Sat,0,31,136,167
2012-10-28,1,Oct,0,0,Sun,0,20,97,117
2012-10-28,1,Oct,1,0,Sun,0,22,111,133
2012-10-28,1,Oct,2,0,Sun,0,17,99,116
2012-10-28,1,Oct,3,0,Sun,0,18,61,79
2012-10-28,1,Oct,4,0,Sun,0,1,19,20
2012-10-28,1,Oct,5,0,Sun,0,6,22,28
2012-10-28,1,Oct,6,0,Sun,0,7,32,39
2012-10-28,1,Oct,7,0,Sun,0,17,48,65
2012-10-28,1,Oct,8,0,Sun,0,55,118,173
2012-10-28,1,Oct,9,0,Sun,0,124,206,330
2012-10-28,1,Oct,10,0,Sun,0,120,314,434
2012-10-28,1,Oct,11,0,Sun,0,110,352,462
2012-10-28,1,Oct,12,0,Sun,0,118,373,491
2012-10-28,1,Oct,13,0,Sun,0,75,316,391
2012-10-28,1,Oct,14,0,Sun,0,98,304,402
2012-10-28,1,Oct,15,0,Sun,0,76,225,301
2012-10-28,1,Oct,16,0,Sun,0,42,251,293
2012-10-28,1,Oct,17,0,Sun,0,37,188,225
2012-10-28,1,Oct,18,0,Sun,0,18,136,154
2012-10-28,1,Oct,19,0,Sun,0,7,47,54
2012-10-28,1,Oct,20,0,Sun,0,4,51,55
2012-10-28,1,Oct,21,0,Sun,0,2,44,46
2012-10-28,1,Oct,22,0,Sun,0,2,35,37
2012-10-28,1,Oct,23,0,Sun,0,2,12,14
2012-10-29,1,Oct,0,0,Mon,1,2,20,22
2012-10-30,1,Oct,13,0,Tue,1,11,105,116
2012-10-30,1,Oct,14,0,Tue,1,8,118,126
2012-10-30,1,Oct,15,0,Tue,1,10,114,124
2012-10-30,1,Oct,16,0,Tue,1,15,83,98
2012-10-30,1,Oct,17,0,Tue,1,19,105,124
2012-10-30,1,Oct,18,0,Tue,1,4,139,143
2012-10-30,1,Oct,19,0,Tue,1,6,109,115
2012-10-30,1,Oct,20,0,Tue,1,5,76,81
2012-10-30,1,Oct,21,0,Tue,1,4,60,64
2012-10-30,1,Oct,22,0,Tue,1,2,64,66
2012-10-30,1,Oct,23,0,Tue,1,3,36,39
2012-10-31,1,Oct,0,0,Wed,1,0,16,16
2012-10-31,1,Oct,1,0,Wed,1,0,8,8
2012-10-31,1,Oct,2,0,Wed,1,0,7,7
2012-10-31,1,Oct,3,0,Wed,1,0,3,3
2012-10-31,1,Oct,4,0,Wed,1,0,5,5
2012-10-31,1,Oct,5,0,Wed,1,0,24,24
2012-10-31,1,Oct,6,0,Wed,1,0,116,116
2012-10-31,1,Oct,7,0,Wed,1,3,334,337
2012-10-31,1,Oct,8,0,Wed,1,6,615,621
2012-10-31,1,Oct,9,0,Wed,1,17,280,297
2012-10-31,1,Oct,10,0,Wed,1,21,147,168
2012-10-31,1,Oct,11,0,Wed,1,37,152,189
2012-10-31,1,Oct,12,0,Wed,1,44,197,241
2012-10-31,1,Oct,13,0,Wed,1,22,191,213
2012-10-31,1,Oct,14,0,Wed,1,45,179,224
2012-10-31,1,Oct,15,0,Wed,1,33,197,230
2012-10-31,1,Oct,16,0,Wed,1,51,373,424
2012-10-31,1,Oct,17,0,Wed,1,39,684,723
2012-10-31,1,Oct,18,0,Wed,1,28,556,584
2012-10-31,1,Oct,19,0,Wed,1,27,383,410
2012-10-31,1,Oct,20,0,Wed,1,9,259,268
2012-10-31,1,Oct,21,0,Wed,1,12,180,192
2012-10-31,1,Oct,22,0,Wed,1,18,147,165
2012-10-31,1,Oct,23,0,Wed,1,7,94,101
2012-11-01,1,Nov,0,0,Thur,1,8,52,60
2012-11-01,1,Nov,1,0,Thur,1,8,22,30
2012-11-01,1,Nov,2,0,Thur,1,10,10,20
2012-11-01,1,Nov,3,0,Thur,1,5,10,15
2012-11-01,1,Nov,4,0,Thur,1,2,8,10
2012-11-01,1,Nov,5,0,Thur,1,1,39,40
2012-11-01,1,Nov,6,0,Thur,1,2,146,148
2012-11-01,1,Nov,7,0,Thur,1,6,414,420
2012-11-01,1,Nov,8,0,Thur,1,12,668,680
2012-11-01,1,Nov,9,0,Thur,1,21,310,331
2012-11-01,1,Nov,10,0,Thur,1,13,133,146
2012-11-01,1,Nov,11,0,Thur,1,14,156,170
2012-11-01,1,Nov,12,0,Thur,1,23,198,221
2012-11-01,1,Nov,13,0,Thur,1,49,199,248
2012-11-01,1,Nov,14,0,Thur,1,31,154,185
2012-11-01,1,Nov,15,0,Thur,1,35,179,214
2012-11-01,1,Nov,16,0,Thur,1,31,313,344
2012-11-01,1,Nov,17,0,Thur,1,37,652,689
2012-11-01,1,Nov,18,0,Thur,1,50,628,678
2012-11-01,1,Nov,19,0,Thur,1,28,424,452
2012-11-01,1,Nov,20,0,Thur,1,16,280,296
2012-11-01,1,Nov,21,0,Thur,1,29,238,267
2012-11-01,1,Nov,22,0,Thur,1,27,175,202
2012-11-01,1,Nov,23,0,Thur,1,8,112,120
2012-11-02,1,Nov,0,0,Fri,1,10,40,50
2012-11-02,1,Nov,1,0,Fri,1,5,19,24
2012-11-02,1,Nov,2,0,Fri,1,3,7,10
2012-11-02,1,Nov,3,0,Fri,1,0,3,3
2012-11-02,1,Nov,4,0,Fri,1,1,6,7
2012-11-02,1,Nov,5,0,Fri,1,1,25,26
2012-11-02,1,Nov,6,0,Fri,1,2,120,122
2012-11-02,1,Nov,7,0,Fri,1,8,349,357
2012-11-02,1,Nov,8,0,Fri,1,31,656,687
2012-11-02,1,Nov,9,0,Fri,1,27,355,382
2012-11-02,1,Nov,10,0,Fri,1,21,183,204
2012-11-02,1,Nov,11,0,Fri,1,42,179,221
2012-11-02,1,Nov,12,0,Fri,1,52,240,292
2012-11-02,1,Nov,13,0,Fri,1,64,230,294
2012-11-02,1,Nov,14,0,Fri,1,63,199,262
2012-11-02,1,Nov,15,0,Fri,1,51,255,306
2012-11-02,1,Nov,16,0,Fri,1,48,373,421
2012-11-02,1,Nov,17,0,Fri,1,57,581,638
2012-11-02,1,Nov,18,0,Fri,1,32,490,522
2012-11-02,1,Nov,19,0,Fri,1,38,336,374
2012-11-02,1,Nov,20,0,Fri,1,14,207,221
2012-11-02,1,Nov,21,0,Fri,1,23,133,156
2012-11-02,1,Nov,22,0,Fri,1,14,135,149
2012-11-02,1,Nov,23,0,Fri,1,11,108,119
2012-11-03,1,Nov,0,0,Sat,0,9,99,108
2012-11-03,1,Nov,1,0,Sat,0,6,83,89
2012-11-03,1,Nov,2,0,Sat,0,10,36,46
2012-11-03,1,Nov,3,0,Sat,0,6,22,28
2012-11-03,1,Nov,4,0,Sat,0,8,8,16
2012-11-03,1,Nov,5,0,Sat,0,1,8,9
2012-11-03,1,Nov,6,0,Sat,0,4,17,21
2012-11-03,1,Nov,7,0,Sat,0,1,58,59
2012-11-03,1,Nov,8,0,Sat,0,10,132,142
2012-11-03,1,Nov,9,0,Sat,0,31,188,219
2012-11-03,1,Nov,10,0,Sat,0,68,260,328
2012-11-03,1,Nov,11,0,Sat,0,56,284,340
2012-11-03,1,Nov,12,0,Sat,0,74,320,394
2012-11-03,1,Nov,13,0,Sat,0,110,339,449
2012-11-03,1,Nov,14,0,Sat,0,136,319,455
2012-11-03,1,Nov,15,0,Sat,0,117,331,448
2012-11-03,1,Nov,16,0,Sat,0,108,292,400
2012-11-03,1,Nov,17,0,Sat,0,112,298,410
2012-11-03,1,Nov,18,0,Sat,0,58,239,297
2012-11-03,1,Nov,19,0,Sat,0,22,217,239
2012-11-03,1,Nov,20,0,Sat,0,23,158,181
2012-11-03,1,Nov,21,0,Sat,0,31,135,166
2012-11-03,1,Nov,22,0,Sat,0,13,133,146
2012-11-03,1,Nov,23,0,Sat,0,15,133,148
2012-11-04,1,Nov,0,0,Sun,0,5,97,102
2012-11-04,1,Nov,1,0,Sun,0,26,139,165
2012-11-04,1,Nov,2,0,Sun,0,6,31,37
2012-11-04,1,Nov,3,0,Sun,0,1,10,11
2012-11-04,1,Nov,4,0,Sun,0,2,7,9
2012-11-04,1,Nov,5,0,Sun,0,0,5,5
2012-11-04,1,Nov,6,0,Sun,0,2,14,16
2012-11-04,1,Nov,7,0,Sun,0,11,39,50
2012-11-04,1,Nov,8,0,Sun,0,34,115,149
2012-11-04,1,Nov,9,0,Sun,0,56,161,217
2012-11-04,1,Nov,10,0,Sun,0,73,287,360
2012-11-04,1,Nov,11,0,Sun,0,134,311,445
2012-11-04,1,Nov,12,0,Sun,0,150,354,504
2012-11-04,1,Nov,13,0,Sun,0,122,371,493
2012-11-04,1,Nov,14,0,Sun,0,149,360,509
2012-11-04,1,Nov,15,0,Sun,0,149,300,449
2012-11-04,1,Nov,16,0,Sun,0,119,316,435
2012-11-04,1,Nov,17,0,Sun,0,57,270,327
2012-11-04,1,Nov,18,0,Sun,0,31,206,237
2012-11-04,1,Nov,19,0,Sun,0,24,203,227
2012-11-04,1,Nov,20,0,Sun,0,7,134,141
2012-11-04,1,Nov,21,0,Sun,0,16,71,87
2012-11-04,1,Nov,22,0,Sun,0,15,64,79
2012-11-04,1,Nov,23,0,Sun,0,12,41,53
2012-11-05,1,Nov,0,0,Mon,1,3,20,23
2012-11-05,1,Nov,1,0,Mon,1,0,8,8
2012-11-05,1,Nov,2,0,Mon,1,2,4,6
2012-11-05,1,Nov,3,0,Mon,1,1,3,4
2012-11-05,1,Nov,4,0,Mon,1,5,11,16
2012-11-05,1,Nov,5,0,Mon,1,1,38,39
2012-11-05,1,Nov,6,0,Mon,1,4,135,139
2012-11-05,1,Nov,7,0,Mon,1,8,453,461
2012-11-05,1,Nov,8,0,Mon,1,19,629,648
2012-11-05,1,Nov,9,0,Mon,1,18,239,257
2012-11-05,1,Nov,10,0,Mon,1,30,112,142
2012-11-05,1,Nov,11,0,Mon,1,31,119,150
2012-11-05,1,Nov,12,0,Mon,1,38,206,244
2012-11-05,1,Nov,13,0,Mon,1,39,183,222
2012-11-05,1,Nov,14,0,Mon,1,31,165,196
2012-11-05,1,Nov,15,0,Mon,1,24,207,231
2012-11-05,1,Nov,16,0,Mon,1,35,325,360
2012-11-05,1,Nov,17,0,Mon,1,34,604,638
2012-11-05,1,Nov,18,0,Mon,1,19,523,542
2012-11-05,1,Nov,19,0,Mon,1,11,361,372
2012-11-05,1,Nov,20,0,Mon,1,13,228,241
2012-11-05,1,Nov,21,0,Mon,1,8,144,152
2012-11-05,1,Nov,22,0,Mon,1,4,111,115
2012-11-05,1,Nov,23,0,Mon,1,0,53,53
2012-11-06,1,Nov,0,0,Tue,1,1,18,19
2012-11-06,1,Nov,1,0,Tue,1,0,8,8
2012-11-06,1,Nov,2,0,Tue,1,0,2,2
2012-11-06,1,Nov,3,0,Tue,1,0,4,4
2012-11-06,1,Nov,4,0,Tue,1,0,7,7
2012-11-06,1,Nov,5,0,Tue,1,1,40,41
2012-11-06,1,Nov,6,0,Tue,1,6,143,149
2012-11-06,1,Nov,7,0,Tue,1,9,378,387
2012-11-06,1,Nov,8,0,Tue,1,20,568,588
2012-11-06,1,Nov,9,0,Tue,1,25,338,363
2012-11-06,1,Nov,10,0,Tue,1,41,189,230
2012-11-06,1,Nov,11,0,Tue,1,39,177,216
2012-11-06,1,Nov,12,0,Tue,1,31,217,248
2012-11-06,1,Nov,13,0,Tue,1,46,232,278
2012-11-06,1,Nov,14,0,Tue,1,44,196,240
2012-11-06,1,Nov,15,0,Tue,1,45,227,272
2012-11-06,1,Nov,16,0,Tue,1,33,369,402
2012-11-06,1,Nov,17,0,Tue,1,30,597,627
2012-11-06,1,Nov,18,0,Tue,1,20,477,497
2012-11-06,1,Nov,19,0,Tue,1,15,356,371
2012-11-06,1,Nov,20,0,Tue,1,10,218,228
2012-11-06,1,Nov,21,0,Tue,1,14,137,151
2012-11-06,1,Nov,22,0,Tue,1,17,136,153
2012-11-06,1,Nov,23,0,Tue,1,19,186,205
2012-11-07,1,Nov,0,0,Wed,1,49,234,283
2012-11-07,1,Nov,1,0,Wed,1,6,86,92
2012-11-07,1,Nov,2,0,Wed,1,6,68,74
2012-11-07,1,Nov,3,0,Wed,1,2,9,11
2012-11-07,1,Nov,4,0,Wed,1,0,9,9
2012-11-07,1,Nov,5,0,Wed,1,0,27,27
2012-11-07,1,Nov,6,0,Wed,1,3,115,118
2012-11-07,1,Nov,7,0,Wed,1,5,314,319
2012-11-07,1,Nov,8,0,Wed,1,18,583,601
2012-11-07,1,Nov,9,0,Wed,1,17,351,368
2012-11-07,1,Nov,10,0,Wed,1,27,151,178
2012-11-07,1,Nov,11,0,Wed,1,15,132,147
2012-11-07,1,Nov,12,0,Wed,1,24,188,212
2012-11-07,1,Nov,13,0,Wed,1,23,158,181
2012-11-07,1,Nov,14,0,Wed,1,19,142,161
2012-11-07,1,Nov,15,0,Wed,1,20,178,198
2012-11-07,1,Nov,16,0,Wed,1,23,250,273
2012-11-07,1,Nov,17,0,Wed,1,16,501,517
2012-11-07,1,Nov,18,0,Wed,1,17,448,465
2012-11-07,1,Nov,19,0,Wed,1,17,302,319
2012-11-07,1,Nov,20,0,Wed,1,7,249,256
2012-11-07,1,Nov,21,0,Wed,1,5,121,126
2012-11-07,1,Nov,22,0,Wed,1,4,56,60
2012-11-07,1,Nov,23,0,Wed,1,3,37,40
2012-11-08,1,Nov,0,0,Thur,1,1,14,15
2012-11-08,1,Nov,1,0,Thur,1,1,11,12
2012-11-08,1,Nov,2,0,Thur,1,1,5,6
2012-11-08,1,Nov,4,0,Thur,1,1,9,10
2012-11-08,1,Nov,5,0,Thur,1,0,35,35
2012-11-08,1,Nov,6,0,Thur,1,2,122,124
2012-11-08,1,Nov,7,0,Thur,1,12,411,423
2012-11-08,1,Nov,8,0,Thur,1,16,652,668
2012-11-08,1,Nov,9,0,Thur,1,22,253,275
2012-11-08,1,Nov,10,0,Thur,1,13,148,161
2012-11-08,1,Nov,11,0,Thur,1,16,155,171
2012-11-08,1,Nov,12,0,Thur,1,33,202,235
2012-11-08,1,Nov,13,0,Thur,1,33,195,228
2012-11-08,1,Nov,14,0,Thur,1,33,149,182
2012-11-08,1,Nov,15,0,Thur,1,32,201,233
2012-11-08,1,Nov,16,0,Thur,1,18,321,339
2012-11-08,1,Nov,17,0,Thur,1,36,556,592
2012-11-08,1,Nov,18,0,Thur,1,16,491,507
2012-11-08,1,Nov,19,0,Thur,1,14,359,373
2012-11-08,1,Nov,20,0,Thur,1,10,235,245
2012-11-08,1,Nov,21,0,Thur,1,11,222,233
2012-11-08,1,Nov,22,0,Thur,1,14,147,161
2012-11-08,1,Nov,23,0,Thur,1,5,82,87
2012-11-09,1,Nov,0,0,Fri,1,9,46,55
2012-11-09,1,Nov,1,0,Fri,1,3,17,20
2012-11-09,1,Nov,2,0,Fri,1,1,11,12
2012-11-09,1,Nov,3,0,Fri,1,3,6,9
2012-11-09,1,Nov,4,0,Fri,1,0,14,14
2012-11-09,1,Nov,5,0,Fri,1,2,25,27
2012-11-09,1,Nov,6,0,Fri,1,5,126,131
2012-11-09,1,Nov,7,0,Fri,1,9,332,341
2012-11-09,1,Nov,8,0,Fri,1,25,668,693
2012-11-09,1,Nov,9,0,Fri,1,23,304,327
2012-11-09,1,Nov,10,0,Fri,1,34,163,197
2012-11-09,1,Nov,11,0,Fri,1,66,185,251
2012-11-09,1,Nov,12,0,Fri,1,48,214,262
2012-11-09,1,Nov,13,0,Fri,1,62,237,299
2012-11-09,1,Nov,14,0,Fri,1,67,207,274
2012-11-09,1,Nov,15,0,Fri,1,78,278,356
2012-11-09,1,Nov,16,0,Fri,1,57,377,434
2012-11-09,1,Nov,17,0,Fri,1,61,593,654
2012-11-09,1,Nov,18,0,Fri,1,46,450,496
2012-11-09,1,Nov,19,0,Fri,1,30,331,361
2012-11-09,1,Nov,20,0,Fri,1,20,235,255
2012-11-09,1,Nov,21,0,Fri,1,23,176,199
2012-11-09,1,Nov,22,0,Fri,1,17,146,163
2012-11-09,1,Nov,23,0,Fri,1,20,142,162
2012-11-10,1,Nov,0,0,Sat,0,16,106,122
2012-11-10,1,Nov,1,0,Sat,0,8,68,76
2012-11-10,1,Nov,2,0,Sat,0,2,42,44
2012-11-10,1,Nov,3,0,Sat,0,9,11,20
2012-11-10,1,Nov,4,0,Sat,0,2,4,6
2012-11-10,1,Nov,5,0,Sat,0,1,9,10
2012-11-10,1,Nov,6,0,Sat,0,5,11,16
2012-11-10,1,Nov,7,0,Sat,0,14,57,71
2012-11-10,1,Nov,8,0,Sat,0,16,130,146
2012-11-10,1,Nov,9,0,Sat,0,43,216,259
2012-11-10,1,Nov,10,0,Sat,0,86,264,350
2012-11-10,1,Nov,11,0,Sat,0,143,323,466
2012-11-10,1,Nov,12,0,Sat,0,258,348,606
2012-11-10,1,Nov,13,0,Sat,0,268,383,651
2012-11-10,1,Nov,14,0,Sat,0,280,347,627
2012-11-10,1,Nov,15,0,Sat,0,216,351,567
2012-11-10,1,Nov,16,0,Sat,0,227,378,605
2012-11-10,1,Nov,17,0,Sat,0,183,318,501
2012-11-10,1,Nov,18,0,Sat,0,103,256,359
2012-11-10,1,Nov,19,0,Sat,0,55,228,283
2012-11-10,1,Nov,20,0,Sat,0,39,153,192
2012-11-10,1,Nov,21,0,Sat,0,51,169,220
2012-11-10,1,Nov,22,0,Sat,0,39,154,193
2012-11-10,1,Nov,23,0,Sat,0,26,120,146
2012-11-11,1,Nov,0,0,Sun,0,14,110,124
2012-11-11,1,Nov,1,0,Sun,0,26,82,108
2012-11-11,1,Nov,2,0,Sun,0,12,58,70
2012-11-11,1,Nov,3,0,Sun,0,9,39,48
2012-11-11,1,Nov,4,0,Sun,0,5,6,11
2012-11-11,1,Nov,5,0,Sun,0,0,12,12
2012-11-11,1,Nov,6,0,Sun,0,3,16,19
2012-11-11,1,Nov,7,0,Sun,0,12,56,68
2012-11-11,1,Nov,8,0,Sun,0,32,87,119
2012-11-11,1,Nov,9,0,Sun,0,94,179,273
2012-11-11,1,Nov,10,0,Sun,0,133,272,405
2012-11-11,1,Nov,11,0,Sun,0,180,324,504
2012-11-11,1,Nov,12,0,Sun,0,195,390,585
2012-11-11,1,Nov,13,0,Sun,0,262,424,686
2012-11-11,1,Nov,14,0,Sun,0,292,362,654
2012-11-11,1,Nov,15,0,Sun,0,304,420,724
2012-11-11,1,Nov,16,0,Sun,0,260,393,653
2012-11-11,1,Nov,17,0,Sun,0,151,342,493
2012-11-11,1,Nov,18,0,Sun,0,102,303,405
2012-11-11,1,Nov,19,0,Sun,0,69,208,277
2012-11-11,1,Nov,20,0,Sun,0,54,146,200
2012-11-11,1,Nov,21,0,Sun,0,44,127,171
2012-11-11,1,Nov,22,0,Sun,0,21,113,134
2012-11-11,1,Nov,23,0,Sun,0,16,93,109
2012-11-12,1,Nov,0,1,Mon,0,6,43,49
2012-11-12,1,Nov,1,1,Mon,0,4,26,30
2012-11-12,1,Nov,2,1,Mon,0,6,14,20
2012-11-12,1,Nov,3,1,Mon,0,1,3,4
2012-11-12,1,Nov,4,1,Mon,0,1,3,4
2012-11-12,1,Nov,5,1,Mon,0,1,23,24
2012-11-12,1,Nov,6,1,Mon,0,7,64,71
2012-11-12,1,Nov,7,1,Mon,0,16,248,264
2012-11-12,1,Nov,8,1,Mon,0,50,490,540
2012-11-12,1,Nov,9,1,Mon,0,60,337,397
2012-11-12,1,Nov,10,1,Mon,0,82,184,266
2012-11-12,1,Nov,11,1,Mon,0,112,255,367
2012-11-12,1,Nov,12,1,Mon,0,105,314,419
2012-11-12,1,Nov,13,1,Mon,0,108,312,420
2012-11-12,1,Nov,14,1,Mon,0,134,310,444
2012-11-12,1,Nov,15,1,Mon,0,102,280,382
2012-11-12,1,Nov,16,1,Mon,0,87,347,434
2012-11-12,1,Nov,17,1,Mon,0,66,530,596
2012-11-12,1,Nov,18,1,Mon,0,65,486,551
2012-11-12,1,Nov,19,1,Mon,0,30,323,353
2012-11-12,1,Nov,20,1,Mon,0,31,273,304
2012-11-12,1,Nov,21,1,Mon,0,10,145,155
2012-11-12,1,Nov,22,1,Mon,0,12,100,112
2012-11-12,1,Nov,23,1,Mon,0,1,62,63
2012-11-13,1,Nov,0,0,Tue,1,5,18,23
2012-11-13,1,Nov,1,0,Tue,1,0,5,5
2012-11-13,1,Nov,2,0,Tue,1,7,4,11
2012-11-13,1,Nov,3,0,Tue,1,2,3,5
2012-11-13,1,Nov,4,0,Tue,1,0,9,9
2012-11-13,1,Nov,5,0,Tue,1,0,18,18
2012-11-13,1,Nov,6,0,Tue,1,2,48,50
2012-11-13,1,Nov,7,0,Tue,1,1,106,107
2012-11-13,1,Nov,8,0,Tue,1,4,207,211
2012-11-13,1,Nov,9,0,Tue,1,1,109,110
2012-11-13,1,Nov,10,0,Tue,1,10,84,94
2012-11-13,1,Nov,11,0,Tue,1,22,133,155
2012-11-13,1,Nov,12,0,Tue,1,16,180,196
2012-11-13,1,Nov,13,0,Tue,1,30,188,218
2012-11-13,1,Nov,14,0,Tue,1,34,169,203
2012-11-13,1,Nov,15,0,Tue,1,33,184,217
2012-11-13,1,Nov,16,0,Tue,1,28,282,310
2012-11-13,1,Nov,17,0,Tue,1,33,575,608
2012-11-13,1,Nov,18,0,Tue,1,45,514,559
2012-11-13,1,Nov,19,0,Tue,1,12,344,356
2012-11-13,1,Nov,20,0,Tue,1,12,211,223
2012-11-13,1,Nov,21,0,Tue,1,9,178,187
2012-11-13,1,Nov,22,0,Tue,1,15,120,135
2012-11-13,1,Nov,23,0,Tue,1,6,78,84
2012-11-14,1,Nov,0,0,Wed,1,4,20,24
2012-11-14,1,Nov,1,0,Wed,1,2,10,12
2012-11-14,1,Nov,2,0,Wed,1,0,1,1
2012-11-14,1,Nov,3,0,Wed,1,0,5,5
2012-11-14,1,Nov,4,0,Wed,1,0,6,6
2012-11-14,1,Nov,5,0,Wed,1,0,39,39
2012-11-14,1,Nov,6,0,Wed,1,4,142,146
2012-11-14,1,Nov,7,0,Wed,1,10,405,415
2012-11-14,1,Nov,8,0,Wed,1,27,664,691
2012-11-14,1,Nov,9,0,Wed,1,22,310,332
2012-11-14,1,Nov,10,0,Wed,1,18,153,171
2012-11-14,1,Nov,11,0,Wed,1,25,126,151
2012-11-14,1,Nov,12,0,Wed,1,40,200,240
2012-11-14,1,Nov,13,0,Wed,1,32,182,214
2012-11-14,1,Nov,14,0,Wed,1,20,161,181
2012-11-14,1,Nov,15,0,Wed,1,32,228,260
2012-11-14,1,Nov,16,0,Wed,1,31,290,321
2012-11-14,1,Nov,17,0,Wed,1,19,564,583
2012-11-14,1,Nov,18,0,Wed,1,24,543,567
2012-11-14,1,Nov,19,0,Wed,1,28,368,396
2012-11-14,1,Nov,20,0,Wed,1,15,252,267
2012-11-14,1,Nov,21,0,Wed,1,5,208,213
2012-11-14,1,Nov,22,0,Wed,1,6,167,173
2012-11-14,1,Nov,23,0,Wed,1,9,78,87
2012-11-15,1,Nov,0,0,Thur,1,1,33,34
2012-11-15,1,Nov,1,0,Thur,1,2,14,16
2012-11-15,1,Nov,2,0,Thur,1,0,7,7
2012-11-15,1,Nov,3,0,Thur,1,0,2,2
2012-11-15,1,Nov,4,0,Thur,1,0,5,5
2012-11-15,1,Nov,5,0,Thur,1,3,34,37
2012-11-15,1,Nov,6,0,Thur,1,1,146,147
2012-11-15,1,Nov,7,0,Thur,1,7,403,410
2012-11-15,1,Nov,8,0,Thur,1,21,625,646
2012-11-15,1,Nov,9,0,Thur,1,17,306,323
2012-11-15,1,Nov,10,0,Thur,1,11,142,153
2012-11-15,1,Nov,11,0,Thur,1,28,138,166
2012-11-15,1,Nov,12,0,Thur,1,29,184,213
2012-11-15,1,Nov,13,0,Thur,1,20,197,217
2012-11-15,1,Nov,14,0,Thur,1,27,174,201
2012-11-15,1,Nov,15,0,Thur,1,26,191,217
2012-11-15,1,Nov,16,0,Thur,1,24,318,342
2012-11-15,1,Nov,17,0,Thur,1,22,541,563
2012-11-15,1,Nov,18,0,Thur,1,10,563,573
2012-11-15,1,Nov,19,0,Thur,1,11,375,386
2012-11-15,1,Nov,20,0,Thur,1,23,262,285
2012-11-15,1,Nov,21,0,Thur,1,20,204,224
2012-11-15,1,Nov,22,0,Thur,1,10,143,153
2012-11-15,1,Nov,23,0,Thur,1,7,118,125
2012-11-16,1,Nov,0,0,Fri,1,7,58,65
2012-11-16,1,Nov,1,0,Fri,1,5,16,21
2012-11-16,1,Nov,2,0,Fri,1,0,9,9
2012-11-16,1,Nov,3,0,Fri,1,0,6,6
2012-11-16,1,Nov,4,0,Fri,1,0,5,5
2012-11-16,1,Nov,5,0,Fri,1,2,34,36
2012-11-16,1,Nov,6,0,Fri,1,4,126,130
2012-11-16,1,Nov,7,0,Fri,1,5,362,367
2012-11-16,1,Nov,8,0,Fri,1,17,694,711
2012-11-16,1,Nov,9,0,Fri,1,21,330,351
2012-11-16,1,Nov,10,0,Fri,1,33,165,198
2012-11-16,1,Nov,11,0,Fri,1,33,185,218
2012-11-16,1,Nov,12,0,Fri,1,28,262,290
2012-11-16,1,Nov,13,0,Fri,1,52,226,278
2012-11-16,1,Nov,14,0,Fri,1,47,204,251
2012-11-16,1,Nov,15,0,Fri,1,30,237,267
2012-11-16,1,Nov,16,0,Fri,1,33,350,383
2012-11-16,1,Nov,17,0,Fri,1,41,539,580
2012-11-16,1,Nov,18,0,Fri,1,22,483,505
2012-11-16,1,Nov,19,0,Fri,1,26,306,332
2012-11-16,1,Nov,20,0,Fri,1,20,207,227
2012-11-16,1,Nov,21,0,Fri,1,21,157,178
2012-11-16,1,Nov,22,0,Fri,1,23,139,162
2012-11-16,1,Nov,23,0,Fri,1,14,114,128
2012-11-17,1,Nov,0,0,Sat,0,11,95,106
2012-11-17,1,Nov,1,0,Sat,0,13,74,87
2012-11-17,1,Nov,2,0,Sat,0,8,41,49
2012-11-17,1,Nov,3,0,Sat,0,2,19,21
2012-11-17,1,Nov,4,0,Sat,0,1,6,7
2012-11-17,1,Nov,5,0,Sat,0,1,10,11
2012-11-17,1,Nov,6,0,Sat,0,0,21,21
2012-11-17,1,Nov,7,0,Sat,0,8,70,78
2012-11-17,1,Nov,8,0,Sat,0,30,138,168
2012-11-17,1,Nov,9,0,Sat,0,48,200,248
2012-11-17,1,Nov,10,0,Sat,0,62,258,320
2012-11-17,1,Nov,11,0,Sat,0,80,343,423
2012-11-17,1,Nov,12,0,Sat,0,117,359,476
2012-11-17,1,Nov,13,0,Sat,0,179,346,525
2012-11-17,1,Nov,14,0,Sat,0,175,380,555
2012-11-17,1,Nov,15,0,Sat,0,175,374,549
2012-11-17,1,Nov,16,0,Sat,0,144,325,469
2012-11-17,1,Nov,17,0,Sat,0,101,302,403
2012-11-17,1,Nov,18,0,Sat,0,34,237,271
2012-11-17,1,Nov,19,0,Sat,0,45,208,253
2012-11-17,1,Nov,20,0,Sat,0,30,142,172
2012-11-17,1,Nov,21,0,Sat,0,15,124,139
2012-11-17,1,Nov,22,0,Sat,0,15,130,145
2012-11-17,1,Nov,23,0,Sat,0,19,114,133
2012-11-18,1,Nov,0,0,Sun,0,11,118,129
2012-11-18,1,Nov,1,0,Sun,0,14,81,95
2012-11-18,1,Nov,2,0,Sun,0,8,65,73
2012-11-18,1,Nov,3,0,Sun,0,9,37,46
2012-11-18,1,Nov,4,0,Sun,0,4,8,12
2012-11-18,1,Nov,5,0,Sun,0,5,7,12
2012-11-18,1,Nov,6,0,Sun,0,2,13,15
2012-11-18,1,Nov,7,0,Sun,0,3,39,42
2012-11-18,1,Nov,8,0,Sun,0,19,100,119
2012-11-18,1,Nov,9,0,Sun,0,49,155,204
2012-11-18,1,Nov,10,0,Sun,0,79,250,329
2012-11-18,1,Nov,11,0,Sun,0,92,267,359
2012-11-18,1,Nov,12,0,Sun,0,101,341,442
2012-11-18,1,Nov,13,0,Sun,0,113,334,447
2012-11-18,1,Nov,14,0,Sun,0,125,303,428
2012-11-18,1,Nov,15,0,Sun,0,89,318,407
2012-11-18,1,Nov,16,0,Sun,0,59,313,372
2012-11-18,1,Nov,17,0,Sun,0,48,232,280
2012-11-18,1,Nov,18,0,Sun,0,36,240,276
2012-11-18,1,Nov,19,0,Sun,0,16,194,210
2012-11-18,1,Nov,20,0,Sun,0,9,120,129
2012-11-18,1,Nov,21,0,Sun,0,17,93,110
2012-11-18,1,Nov,22,0,Sun,0,8,66,74
2012-11-18,1,Nov,23,0,Sun,0,6,53,59
2012-11-19,1,Nov,0,0,Mon,1,5,22,27
2012-11-19,1,Nov,1,0,Mon,1,0,19,19
2012-11-19,1,Nov,2,0,Mon,1,0,5,5
2012-11-19,1,Nov,3,0,Mon,1,0,2,2
2012-11-19,1,Nov,4,0,Mon,1,1,11,12
2012-11-19,1,Nov,5,0,Mon,1,1,38,39
2012-11-19,1,Nov,6,0,Mon,1,3,128,131
2012-11-19,1,Nov,7,0,Mon,1,5,381,386
2012-11-19,1,Nov,8,0,Mon,1,13,650,663
2012-11-19,1,Nov,9,0,Mon,1,18,260,278
2012-11-19,1,Nov,10,0,Mon,1,33,106,139
2012-11-19,1,Nov,11,0,Mon,1,33,164,197
2012-11-19,1,Nov,12,0,Mon,1,35,207,242
2012-11-19,1,Nov,13,0,Mon,1,46,205,251
2012-11-19,1,Nov,14,0,Mon,1,47,170,217
2012-11-19,1,Nov,15,0,Mon,1,44,213,257
2012-11-19,1,Nov,16,0,Mon,1,55,325,380
2012-11-19,1,Nov,17,0,Mon,1,33,586,619
2012-11-19,1,Nov,18,0,Mon,1,21,559,580
2012-11-19,1,Nov,19,0,Mon,1,25,381,406
2012-11-19,1,Nov,20,0,Mon,1,7,252,259
2012-11-19,1,Nov,21,0,Mon,1,15,188,203
2012-11-19,1,Nov,22,0,Mon,1,7,106,113
2012-11-19,1,Nov,23,0,Mon,1,2,72,74
2012-11-20,1,Nov,0,0,Tue,1,3,26,29
2012-11-20,1,Nov,1,0,Tue,1,3,10,13
2012-11-20,1,Nov,2,0,Tue,1,0,5,5
2012-11-20,1,Nov,3,0,Tue,1,0,2,2
2012-11-20,1,Nov,4,0,Tue,1,0,6,6
2012-11-20,1,Nov,5,0,Tue,1,2,32,34
2012-11-20,1,Nov,6,0,Tue,1,2,146,148
2012-11-20,1,Nov,7,0,Tue,1,7,411,418
2012-11-20,1,Nov,8,0,Tue,1,16,649,665
2012-11-20,1,Nov,9,0,Tue,1,28,298,326
2012-11-20,1,Nov,10,0,Tue,1,32,144,176
2012-11-20,1,Nov,11,0,Tue,1,45,160,205
2012-11-20,1,Nov,12,0,Tue,1,70,243,313
2012-11-20,1,Nov,13,0,Tue,1,49,218,267
2012-11-20,1,Nov,14,0,Tue,1,47,177,224
2012-11-20,1,Nov,15,0,Tue,1,61,226,287
2012-11-20,1,Nov,16,0,Tue,1,60,335,395
2012-11-20,1,Nov,17,0,Tue,1,37,553,590
2012-11-20,1,Nov,18,0,Tue,1,16,534,550
2012-11-20,1,Nov,19,0,Tue,1,23,361,384
2012-11-20,1,Nov,20,0,Tue,1,11,224,235
2012-11-20,1,Nov,21,0,Tue,1,14,143,157
2012-11-20,1,Nov,22,0,Tue,1,7,115,122
2012-11-20,1,Nov,23,0,Tue,1,1,82,83
2012-11-21,1,Nov,0,0,Wed,1,1,25,26
2012-11-21,1,Nov,1,0,Wed,1,1,13,14
2012-11-21,1,Nov,2,0,Wed,1,2,6,8
2012-11-21,1,Nov,3,0,Wed,1,0,2,2
2012-11-21,1,Nov,4,0,Wed,1,0,10,10
2012-11-21,1,Nov,5,0,Wed,1,1,28,29
2012-11-21,1,Nov,6,0,Wed,1,2,99,101
2012-11-21,1,Nov,7,0,Wed,1,11,262,273
2012-11-21,1,Nov,8,0,Wed,1,12,539,551
2012-11-21,1,Nov,9,0,Wed,1,45,320,365
2012-11-21,1,Nov,10,0,Wed,1,22,150,172
2012-11-21,1,Nov,11,0,Wed,1,43,198,241
2012-11-21,1,Nov,12,0,Wed,1,74,270,344
2012-11-21,1,Nov,13,0,Wed,1,70,295,365
2012-11-21,1,Nov,14,0,Wed,1,84,329,413
2012-11-21,1,Nov,15,0,Wed,1,68,381,449
2012-11-21,1,Nov,16,0,Wed,1,59,410,469
2012-11-21,1,Nov,17,0,Wed,1,41,333,374
2012-11-21,1,Nov,18,0,Wed,1,24,287,311
2012-11-21,1,Nov,19,0,Wed,1,23,220,243
2012-11-21,1,Nov,20,0,Wed,1,11,125,136
2012-11-21,1,Nov,21,0,Wed,1,8,97,105
2012-11-21,1,Nov,22,0,Wed,1,6,82,88
2012-11-21,1,Nov,23,0,Wed,1,7,50,57
2012-11-22,1,Nov,0,1,Thur,0,3,43,46
2012-11-22,1,Nov,1,1,Thur,0,5,37,42
2012-11-22,1,Nov,2,1,Thur,0,3,15,18
2012-11-22,1,Nov,3,1,Thur,0,0,6,6
2012-11-22,1,Nov,4,1,Thur,0,1,2,3
2012-11-22,1,Nov,5,1,Thur,0,2,6,8
2012-11-22,1,Nov,6,1,Thur,0,2,15,17
2012-11-22,1,Nov,7,1,Thur,0,7,49,56
2012-11-22,1,Nov,8,1,Thur,0,20,77,97
2012-11-22,1,Nov,9,1,Thur,0,25,94,119
2012-11-22,1,Nov,10,1,Thur,0,65,154,219
2012-11-22,1,Nov,11,1,Thur,0,89,143,232
2012-11-22,1,Nov,12,1,Thur,0,117,145,262
2012-11-22,1,Nov,13,1,Thur,0,125,144,269
2012-11-22,1,Nov,14,1,Thur,0,125,95,220
2012-11-22,1,Nov,15,1,Thur,0,132,96,228
2012-11-22,1,Nov,16,1,Thur,0,101,81,182
2012-11-22,1,Nov,17,1,Thur,0,66,43,109
2012-11-22,1,Nov,18,1,Thur,0,16,54,70
2012-11-22,1,Nov,19,1,Thur,0,13,31,44
2012-11-22,1,Nov,20,1,Thur,0,15,37,52
2012-11-22,1,Nov,21,1,Thur,0,7,39,46
2012-11-22,1,Nov,22,1,Thur,0,8,36,44
2012-11-22,1,Nov,23,1,Thur,0,8,28,36
2012-11-23,1,Nov,0,0,Fri,1,0,32,32
2012-11-23,1,Nov,1,0,Fri,1,2,11,13
2012-11-23,1,Nov,2,0,Fri,1,1,4,5
2012-11-23,1,Nov,3,0,Fri,1,1,0,1
2012-11-23,1,Nov,4,0,Fri,1,1,3,4
2012-11-23,1,Nov,5,0,Fri,1,0,10,10
2012-11-23,1,Nov,6,0,Fri,1,0,20,20
2012-11-23,1,Nov,7,0,Fri,1,5,72,77
2012-11-23,1,Nov,8,0,Fri,1,11,83,94
2012-11-23,1,Nov,9,0,Fri,1,32,80,112
2012-11-23,1,Nov,10,0,Fri,1,87,114,201
2012-11-23,1,Nov,11,0,Fri,1,121,130,251
2012-11-23,1,Nov,12,0,Fri,1,186,193,379
2012-11-23,1,Nov,13,0,Fri,1,224,200,424
2012-11-23,1,Nov,14,0,Fri,1,240,195,435
2012-11-23,1,Nov,15,0,Fri,1,233,214,447
2012-11-23,1,Nov,16,0,Fri,1,158,199,357
2012-11-23,1,Nov,17,0,Fri,1,117,183,300
2012-11-23,1,Nov,18,0,Fri,1,50,158,208
2012-11-23,1,Nov,19,0,Fri,1,33,121,154
2012-11-23,1,Nov,20,0,Fri,1,42,100,142
2012-11-23,1,Nov,21,0,Fri,1,23,75,98
2012-11-23,1,Nov,22,0,Fri,1,16,63,79
2012-11-23,1,Nov,23,0,Fri,1,20,47,67
2012-11-24,1,Nov,0,0,Sat,0,9,33,42
2012-11-24,1,Nov,1,0,Sat,0,1,19,20
2012-11-24,1,Nov,2,0,Sat,0,10,22,32
2012-11-24,1,Nov,3,0,Sat,0,6,5,11
2012-11-24,1,Nov,4,0,Sat,0,1,2,3
2012-11-24,1,Nov,5,0,Sat,0,1,2,3
2012-11-24,1,Nov,6,0,Sat,0,1,9,10
2012-11-24,1,Nov,7,0,Sat,0,4,21,25
2012-11-24,1,Nov,8,0,Sat,0,7,55,62
2012-11-24,1,Nov,9,0,Sat,0,26,96,122
2012-11-24,1,Nov,10,0,Sat,0,46,96,142
2012-11-24,1,Nov,11,0,Sat,0,55,131,186
2012-11-24,1,Nov,12,0,Sat,0,53,146,199
2012-11-24,1,Nov,13,0,Sat,0,64,161,225
2012-11-24,1,Nov,14,0,Sat,0,58,149,207
2012-11-24,1,Nov,15,0,Sat,0,59,139,198
2012-11-24,1,Nov,16,0,Sat,0,43,127,170
2012-11-24,1,Nov,17,0,Sat,0,29,97,126
2012-11-24,1,Nov,18,0,Sat,0,22,123,145
2012-11-24,1,Nov,19,0,Sat,0,9,74,83
2012-11-24,1,Nov,20,0,Sat,0,3,55,58
2012-11-24,1,Nov,21,0,Sat,0,9,66,75
2012-11-24,1,Nov,22,0,Sat,0,7,69,76
2012-11-24,1,Nov,23,0,Sat,0,9,48,57
2012-11-25,1,Nov,0,0,Sun,0,3,31,34
2012-11-25,1,Nov,1,0,Sun,0,4,32,36
2012-11-25,1,Nov,2,0,Sun,0,1,27,28
2012-11-25,1,Nov,3,0,Sun,0,0,8,8
2012-11-25,1,Nov,4,0,Sun,0,1,1,2
2012-11-25,1,Nov,5,0,Sun,0,0,3,3
2012-11-25,1,Nov,6,0,Sun,0,1,10,11
2012-11-25,1,Nov,7,0,Sun,0,2,19,21
2012-11-25,1,Nov,8,0,Sun,0,2,32,34
2012-11-25,1,Nov,9,0,Sun,0,13,83,96
2012-11-25,1,Nov,10,0,Sun,0,15,124,139
2012-11-25,1,Nov,11,0,Sun,0,49,155,204
2012-11-25,1,Nov,12,0,Sun,0,37,165,202
2012-11-25,1,Nov,13,0,Sun,0,37,158,195
2012-11-25,1,Nov,14,0,Sun,0,33,170,203
2012-11-25,1,Nov,15,0,Sun,0,36,209,245
2012-11-25,1,Nov,16,0,Sun,0,25,203,228
2012-11-25,1,Nov,17,0,Sun,0,11,170,181
2012-11-25,1,Nov,18,0,Sun,0,9,132,141
2012-11-25,1,Nov,19,0,Sun,0,13,114,127
2012-11-25,1,Nov,20,0,Sun,0,9,110,119
2012-11-25,1,Nov,21,0,Sun,0,4,60,64
2012-11-25,1,Nov,22,0,Sun,0,3,59,62
2012-11-25,1,Nov,23,0,Sun,0,1,40,41
2012-11-26,1,Nov,0,0,Mon,1,4,19,23
2012-11-26,1,Nov,1,0,Mon,1,1,9,10
2012-11-26,1,Nov,2,0,Mon,1,0,5,5
2012-11-26,1,Nov,3,0,Mon,1,1,4,5
2012-11-26,1,Nov,4,0,Mon,1,0,10,10
2012-11-26,1,Nov,5,0,Mon,1,0,41,41
2012-11-26,1,Nov,6,0,Mon,1,1,123,124
2012-11-26,1,Nov,7,0,Mon,1,2,363,365
2012-11-26,1,Nov,8,0,Mon,1,9,629,638
2012-11-26,1,Nov,9,0,Mon,1,10,276,286
2012-11-26,1,Nov,10,0,Mon,1,20,127,147
2012-11-26,1,Nov,11,0,Mon,1,18,112,130
2012-11-26,1,Nov,12,0,Mon,1,22,188,210
2012-11-26,1,Nov,13,0,Mon,1,20,197,217
2012-11-26,1,Nov,14,0,Mon,1,51,177,228
2012-11-26,1,Nov,15,0,Mon,1,49,181,230
2012-11-26,1,Nov,16,0,Mon,1,49,297,346
2012-11-26,1,Nov,17,0,Mon,1,13,540,553
2012-11-26,1,Nov,18,0,Mon,1,19,502,521
2012-11-26,1,Nov,19,0,Mon,1,16,355,371
2012-11-26,1,Nov,20,0,Mon,1,12,265,277
2012-11-26,1,Nov,21,0,Mon,1,9,172,181
2012-11-26,1,Nov,22,0,Mon,1,3,101,104
2012-11-26,1,Nov,23,0,Mon,1,8,57,65
2012-11-27,1,Nov,0,0,Tue,1,2,24,26
2012-11-27,1,Nov,1,0,Tue,1,0,6,6
2012-11-27,1,Nov,2,0,Tue,1,0,5,5
2012-11-27,1,Nov,3,0,Tue,1,1,3,4
2012-11-27,1,Nov,4,0,Tue,1,0,5,5
2012-11-27,1,Nov,5,0,Tue,1,0,31,31
2012-11-27,1,Nov,6,0,Tue,1,3,97,100
2012-11-27,1,Nov,7,0,Tue,1,4,289,293
2012-11-27,1,Nov,8,0,Tue,1,6,494,500
2012-11-27,1,Nov,9,0,Tue,1,11,257,268
2012-11-27,1,Nov,10,0,Tue,1,5,52,57
2012-11-27,1,Nov,11,0,Tue,1,6,59,65
2012-11-27,1,Nov,12,0,Tue,1,6,70,76
2012-11-27,1,Nov,13,0,Tue,1,4,73,77
2012-11-27,1,Nov,14,0,Tue,1,8,86,94
2012-11-27,1,Nov,15,0,Tue,1,9,146,155
2012-11-27,1,Nov,16,0,Tue,1,5,252,257
2012-11-27,1,Nov,17,0,Tue,1,13,514,527
2012-11-27,1,Nov,18,0,Tue,1,13,469,482
2012-11-27,1,Nov,19,0,Tue,1,12,338,350
2012-11-27,1,Nov,20,0,Tue,1,4,228,232
2012-11-27,1,Nov,21,0,Tue,1,6,179,185
2012-11-27,1,Nov,22,0,Tue,1,2,95,97
2012-11-27,1,Nov,23,0,Tue,1,3,64,67
2012-11-28,1,Nov,0,0,Wed,1,1,22,23
2012-11-28,1,Nov,1,0,Wed,1,0,12,12
2012-11-28,1,Nov,2,0,Wed,1,0,1,1
2012-11-28,1,Nov,3,0,Wed,1,0,3,3
2012-11-28,1,Nov,4,0,Wed,1,0,4,4
2012-11-28,1,Nov,5,0,Wed,1,0,39,39
2012-11-28,1,Nov,6,0,Wed,1,4,132,136
2012-11-28,1,Nov,7,0,Wed,1,6,403,409
2012-11-28,1,Nov,8,0,Wed,1,9,683,692
2012-11-28,1,Nov,9,0,Wed,1,13,309,322
2012-11-28,1,Nov,10,0,Wed,1,17,144,161
2012-11-28,1,Nov,11,0,Wed,1,19,127,146
2012-11-28,1,Nov,12,0,Wed,1,19,189,208
2012-11-28,1,Nov,13,0,Wed,1,21,193,214
2012-11-28,1,Nov,14,0,Wed,1,15,161,176
2012-11-28,1,Nov,15,0,Wed,1,7,172,179
2012-11-28,1,Nov,16,0,Wed,1,9,316,325
2012-11-28,1,Nov,17,0,Wed,1,17,546,563
2012-11-28,1,Nov,18,0,Wed,1,12,530,542
2012-11-28,1,Nov,19,0,Wed,1,9,378,387
2012-11-28,1,Nov,20,0,Wed,1,5,258,263
2012-11-28,1,Nov,21,0,Wed,1,4,219,223
2012-11-28,1,Nov,22,0,Wed,1,6,148,154
2012-11-28,1,Nov,23,0,Wed,1,5,73,78
2012-11-29,1,Nov,0,0,Thur,1,4,25,29
2012-11-29,1,Nov,1,0,Thur,1,1,15,16
2012-11-29,1,Nov,2,0,Thur,1,1,6,7
2012-11-29,1,Nov,4,0,Thur,1,0,7,7
2012-11-29,1,Nov,5,0,Thur,1,0,42,42
2012-11-29,1,Nov,6,0,Thur,1,1,120,121
2012-11-29,1,Nov,7,0,Thur,1,8,354,362
2012-11-29,1,Nov,8,0,Thur,1,15,664,679
2012-11-29,1,Nov,9,0,Thur,1,13,286,299
2012-11-29,1,Nov,10,0,Thur,1,25,153,178
2012-11-29,1,Nov,11,0,Thur,1,13,150,163
2012-11-29,1,Nov,12,0,Thur,1,11,225,236
2012-11-29,1,Nov,13,0,Thur,1,15,209,224
2012-11-29,1,Nov,14,0,Thur,1,13,174,187
2012-11-29,1,Nov,15,0,Thur,1,19,201,220
2012-11-29,1,Nov,16,0,Thur,1,24,346,370
2012-11-29,1,Nov,17,0,Thur,1,17,544,561
2012-11-29,1,Nov,18,0,Thur,1,17,520,537
2012-11-29,1,Nov,19,0,Thur,1,18,326,344
2012-11-29,1,Nov,20,0,Thur,1,11,241,252
2012-11-29,1,Nov,21,0,Thur,1,7,201,208
2012-11-29,1,Nov,22,0,Thur,1,4,147,151
2012-11-29,1,Nov,23,0,Thur,1,6,124,130
2012-11-30,1,Nov,0,0,Fri,1,4,48,52
2012-11-30,1,Nov,1,0,Fri,1,2,17,19
2012-11-30,1,Nov,2,0,Fri,1,2,10,12
2012-11-30,1,Nov,3,0,Fri,1,0,4,4
2012-11-30,1,Nov,4,0,Fri,1,0,3,3
2012-11-30,1,Nov,5,0,Fri,1,1,39,40
2012-11-30,1,Nov,6,0,Fri,1,2,104,106
2012-11-30,1,Nov,7,0,Fri,1,6,346,352
2012-11-30,1,Nov,8,0,Fri,1,20,709,729
2012-11-30,1,Nov,9,0,Fri,1,17,313,330
2012-11-30,1,Nov,10,0,Fri,1,10,159,169
2012-11-30,1,Nov,11,0,Fri,1,31,170,201
2012-11-30,1,Nov,12,0,Fri,1,25,243,268
2012-11-30,1,Nov,13,0,Fri,1,21,241,262
2012-11-30,1,Nov,14,0,Fri,1,26,225,251
2012-11-30,1,Nov,15,0,Fri,1,34,262,296
2012-11-30,1,Nov,16,0,Fri,1,37,368,405
2012-11-30,1,Nov,17,0,Fri,1,31,551,582
2012-11-30,1,Nov,18,0,Fri,1,20,489,509
2012-11-30,1,Nov,19,0,Fri,1,18,359,377
2012-11-30,1,Nov,20,0,Fri,1,12,233,245
2012-11-30,1,Nov,21,0,Fri,1,14,169,183
2012-11-30,1,Nov,22,0,Fri,1,18,145,163
2012-11-30,1,Nov,23,0,Fri,1,11,99,110
2012-12-01,1,Dec,0,0,Sat,0,9,99,108
2012-12-01,1,Dec,1,0,Sat,0,5,64,69
2012-12-01,1,Dec,2,0,Sat,0,3,47,50
2012-12-01,1,Dec,3,0,Sat,0,1,14,15
2012-12-01,1,Dec,4,0,Sat,0,0,5,5
2012-12-01,1,Dec,5,0,Sat,0,1,12,13
2012-12-01,1,Dec,6,0,Sat,0,7,20,27
2012-12-01,1,Dec,7,0,Sat,0,7,56,63
2012-12-01,1,Dec,8,0,Sat,0,11,133,144
2012-12-01,1,Dec,9,0,Sat,0,34,159,193
2012-12-01,1,Dec,10,0,Sat,0,45,211,256
2012-12-01,1,Dec,11,0,Sat,0,74,318,392
2012-12-01,1,Dec,12,0,Sat,0,119,327,446
2012-12-01,1,Dec,13,0,Sat,0,123,386,509
2012-12-01,1,Dec,14,0,Sat,0,110,369,479
2012-12-01,1,Dec,15,0,Sat,0,113,371,484
2012-12-01,1,Dec,16,0,Sat,0,89,354,443
2012-12-01,1,Dec,17,0,Sat,0,50,270,320
2012-12-01,1,Dec,18,0,Sat,0,42,255,297
2012-12-01,1,Dec,19,0,Sat,0,30,219,249
2012-12-01,1,Dec,20,0,Sat,0,28,170,198
2012-12-01,1,Dec,21,0,Sat,0,23,135,158
2012-12-01,1,Dec,22,0,Sat,0,17,130,147
2012-12-01,1,Dec,23,0,Sat,0,10,116,126
2012-12-02,1,Dec,0,0,Sun,0,9,108,117
2012-12-02,1,Dec,1,0,Sun,0,10,84,94
2012-12-02,1,Dec,2,0,Sun,0,2,72,74
2012-12-02,1,Dec,3,0,Sun,0,4,21,25
2012-12-02,1,Dec,4,0,Sun,0,1,6,7
2012-12-02,1,Dec,5,0,Sun,0,1,7,8
2012-12-02,1,Dec,6,0,Sun,0,1,15,16
2012-12-02,1,Dec,7,0,Sun,0,5,26,31
2012-12-02,1,Dec,8,0,Sun,0,12,81,93
2012-12-02,1,Dec,9,0,Sun,0,37,135,172
2012-12-02,1,Dec,10,0,Sun,0,63,230,293
2012-12-02,1,Dec,11,0,Sun,0,81,274,355
2012-12-02,1,Dec,12,0,Sun,0,111,409,520
2012-12-02,1,Dec,13,0,Sun,0,84,347,431
2012-12-02,1,Dec,14,0,Sun,0,142,331,473
2012-12-02,1,Dec,15,0,Sun,0,106,311,417
2012-12-02,1,Dec,16,0,Sun,0,85,358,443
2012-12-02,1,Dec,17,0,Sun,0,59,244,303
2012-12-02,1,Dec,18,0,Sun,0,25,178,203
2012-12-02,1,Dec,19,0,Sun,0,16,158,174
2012-12-02,1,Dec,20,0,Sun,0,12,142,154
2012-12-02,1,Dec,21,0,Sun,0,8,91,99
2012-12-02,1,Dec,22,0,Sun,0,11,85,96
2012-12-02,1,Dec,23,0,Sun,0,7,44,51
2012-12-03,1,Dec,0,0,Mon,1,3,18,21
2012-12-03,1,Dec,1,0,Mon,1,2,11,13
2012-12-03,1,Dec,2,0,Mon,1,1,9,10
2012-12-03,1,Dec,3,0,Mon,1,2,6,8
2012-12-03,1,Dec,4,0,Mon,1,1,4,5
2012-12-03,1,Dec,5,0,Mon,1,0,38,38
2012-12-03,1,Dec,6,0,Mon,1,2,136,138
2012-12-03,1,Dec,7,0,Mon,1,9,387,396
2012-12-03,1,Dec,8,0,Mon,1,19,712,731
2012-12-03,1,Dec,9,0,Mon,1,19,289,308
2012-12-03,1,Dec,10,0,Mon,1,31,105,136
2012-12-03,1,Dec,11,0,Mon,1,51,182,233
2012-12-03,1,Dec,12,0,Mon,1,40,228,268
2012-12-03,1,Dec,13,0,Mon,1,81,240,321
2012-12-03,1,Dec,14,0,Mon,1,51,209,260
2012-12-03,1,Dec,15,0,Mon,1,58,210,268
2012-12-03,1,Dec,16,0,Mon,1,45,397,442
2012-12-03,1,Dec,17,0,Mon,1,43,665,708
2012-12-03,1,Dec,18,0,Mon,1,26,666,692
2012-12-03,1,Dec,19,0,Mon,1,27,444,471
2012-12-03,1,Dec,20,0,Mon,1,16,284,300
2012-12-03,1,Dec,21,0,Mon,1,14,207,221
2012-12-03,1,Dec,22,0,Mon,1,5,139,144
2012-12-03,1,Dec,23,0,Mon,1,9,93,102
2012-12-04,1,Dec,0,0,Tue,1,6,49,55
2012-12-04,1,Dec,1,0,Tue,1,3,22,25
2012-12-04,1,Dec,2,0,Tue,1,3,5,8
2012-12-04,1,Dec,3,0,Tue,1,1,3,4
2012-12-04,1,Dec,4,0,Tue,1,0,7,7
2012-12-04,1,Dec,5,0,Tue,1,1,45,46
2012-12-04,1,Dec,6,0,Tue,1,3,150,153
2012-12-04,1,Dec,7,0,Tue,1,7,495,502
2012-12-04,1,Dec,8,0,Tue,1,21,700,721
2012-12-04,1,Dec,9,0,Tue,1,19,317,336
2012-12-04,1,Dec,10,0,Tue,1,26,130,156
2012-12-04,1,Dec,11,0,Tue,1,24,183,207
2012-12-04,1,Dec,12,0,Tue,1,39,273,312
2012-12-04,1,Dec,13,0,Tue,1,39,233,272
2012-12-04,1,Dec,14,0,Tue,1,39,231,270
2012-12-04,1,Dec,15,0,Tue,1,56,244,300
2012-12-04,1,Dec,16,0,Tue,1,44,391,435
2012-12-04,1,Dec,17,0,Tue,1,43,700,743
2012-12-04,1,Dec,18,0,Tue,1,38,693,731
2012-12-04,1,Dec,19,0,Tue,1,46,414,460
2012-12-04,1,Dec,20,0,Tue,1,34,272,306
2012-12-04,1,Dec,21,0,Tue,1,28,252,280
2012-12-04,1,Dec,22,0,Tue,1,26,155,181
2012-12-04,1,Dec,23,0,Tue,1,5,91,96
2012-12-05,1,Dec,0,0,Wed,1,6,31,37
2012-12-05,1,Dec,1,0,Wed,1,0,11,11
2012-12-05,1,Dec,2,0,Wed,1,2,7,9
2012-12-05,1,Dec,3,0,Wed,1,0,7,7
2012-12-05,1,Dec,4,0,Wed,1,1,9,10
2012-12-05,1,Dec,5,0,Wed,1,1,48,49
2012-12-05,1,Dec,6,0,Wed,1,5,119,124
2012-12-05,1,Dec,7,0,Wed,1,9,389,398
2012-12-05,1,Dec,8,0,Wed,1,22,737,759
2012-12-05,1,Dec,9,0,Wed,1,26,362,388
2012-12-05,1,Dec,10,0,Wed,1,14,127,141
2012-12-05,1,Dec,11,0,Wed,1,11,161,172
2012-12-05,1,Dec,12,0,Wed,1,24,208,232
2012-12-05,1,Dec,13,0,Wed,1,14,200,214
2012-12-05,1,Dec,14,0,Wed,1,39,179,218
2012-12-05,1,Dec,15,0,Wed,1,20,265,285
2012-12-05,1,Dec,16,0,Wed,1,23,354,377
2012-12-05,1,Dec,17,0,Wed,1,29,576,605
2012-12-05,1,Dec,18,0,Wed,1,29,580,609
2012-12-05,1,Dec,19,0,Wed,1,14,400,414
2012-12-05,1,Dec,20,0,Wed,1,19,274,293
2012-12-05,1,Dec,21,0,Wed,1,14,184,198
2012-12-05,1,Dec,22,0,Wed,1,4,101,105
2012-12-05,1,Dec,23,0,Wed,1,5,69,74
2012-12-06,1,Dec,0,0,Thur,1,1,43,44
2012-12-06,1,Dec,1,0,Thur,1,0,16,16
2012-12-06,1,Dec,2,0,Thur,1,0,9,9
2012-12-06,1,Dec,3,0,Thur,1,0,2,2
2012-12-06,1,Dec,4,0,Thur,1,1,8,9
2012-12-06,1,Dec,5,0,Thur,1,0,32,32
2012-12-06,1,Dec,6,0,Thur,1,2,122,124
2012-12-06,1,Dec,7,0,Thur,1,8,381,389
2012-12-06,1,Dec,8,0,Thur,1,13,646,659
2012-12-06,1,Dec,9,0,Thur,1,19,257,276
2012-12-06,1,Dec,10,0,Thur,1,23,122,145
2012-12-06,1,Dec,11,0,Thur,1,16,162,178
2012-12-06,1,Dec,12,0,Thur,1,29,206,235
2012-12-06,1,Dec,13,0,Thur,1,33,212,245
2012-12-06,1,Dec,14,0,Thur,1,37,175,212
2012-12-06,1,Dec,15,0,Thur,1,38,232,270
2012-12-06,1,Dec,16,0,Thur,1,39,292,331
2012-12-06,1,Dec,17,0,Thur,1,31,586,617
2012-12-06,1,Dec,18,0,Thur,1,23,542,565
2012-12-06,1,Dec,19,0,Thur,1,13,360,373
2012-12-06,1,Dec,20,0,Thur,1,5,222,227
2012-12-06,1,Dec,21,0,Thur,1,7,184,191
2012-12-06,1,Dec,22,0,Thur,1,2,131,133
2012-12-06,1,Dec,23,0,Thur,1,0,93,93
2012-12-07,1,Dec,0,0,Fri,1,3,45,48
2012-12-07,1,Dec,1,0,Fri,1,2,26,28
2012-12-07,1,Dec,2,0,Fri,1,0,11,11
2012-12-07,1,Dec,3,0,Fri,1,0,5,5
2012-12-07,1,Dec,4,0,Fri,1,0,10,10
2012-12-07,1,Dec,5,0,Fri,1,1,25,26
2012-12-07,1,Dec,6,0,Fri,1,0,84,84
2012-12-07,1,Dec,7,0,Fri,1,3,212,215
2012-12-07,1,Dec,8,0,Fri,1,11,430,441
2012-12-07,1,Dec,9,0,Fri,1,10,291,301
2012-12-07,1,Dec,10,0,Fri,1,16,150,166
2012-12-07,1,Dec,11,0,Fri,1,20,183,203
2012-12-07,1,Dec,12,0,Fri,1,36,204,240
2012-12-07,1,Dec,13,0,Fri,1,23,197,220
2012-12-07,1,Dec,14,0,Fri,1,40,175,215
2012-12-07,1,Dec,15,0,Fri,1,34,269,303
2012-12-07,1,Dec,16,0,Fri,1,39,336,375
2012-12-07,1,Dec,17,0,Fri,1,29,539,568
2012-12-07,1,Dec,18,0,Fri,1,25,473,498
2012-12-07,1,Dec,19,0,Fri,1,15,337,352
2012-12-07,1,Dec,20,0,Fri,1,12,229,241
2012-12-07,1,Dec,21,0,Fri,1,9,162,171
2012-12-07,1,Dec,22,0,Fri,1,15,150,165
2012-12-07,1,Dec,23,0,Fri,1,6,116,122
2012-12-08,1,Dec,0,0,Sat,0,5,98,103
2012-12-08,1,Dec,1,0,Sat,0,16,84,100
2012-12-08,1,Dec,2,0,Sat,0,3,67,70
2012-12-08,1,Dec,3,0,Sat,0,6,23,29
2012-12-08,1,Dec,4,0,Sat,0,3,9,12
2012-12-08,1,Dec,5,0,Sat,0,2,4,6
2012-12-08,1,Dec,6,0,Sat,0,1,19,20
2012-12-08,1,Dec,7,0,Sat,0,3,36,39
2012-12-08,1,Dec,8,0,Sat,0,5,106,111
2012-12-08,1,Dec,9,0,Sat,0,17,153,170
2012-12-08,1,Dec,10,0,Sat,0,43,244,287
2012-12-08,1,Dec,11,0,Sat,0,63,341,404
2012-12-08,1,Dec,12,0,Sat,0,122,364,486
2012-12-08,1,Dec,13,0,Sat,0,148,399,547
2012-12-08,1,Dec,14,0,Sat,0,164,378,542
2012-12-08,1,Dec,15,0,Sat,0,167,374,541
2012-12-08,1,Dec,16,0,Sat,0,139,368,507
2012-12-08,1,Dec,17,0,Sat,0,77,268,345
2012-12-08,1,Dec,18,0,Sat,0,40,264,304
2012-12-08,1,Dec,19,0,Sat,0,34,212,246
2012-12-08,1,Dec,20,0,Sat,0,20,162,182
2012-12-08,1,Dec,21,0,Sat,0,34,175,209
2012-12-08,1,Dec,22,0,Sat,0,23,137,160
2012-12-08,1,Dec,23,0,Sat,0,18,144,162
2012-12-09,1,Dec,0,0,Sun,0,15,103,118
2012-12-09,1,Dec,1,0,Sun,0,17,85,102
2012-12-09,1,Dec,2,0,Sun,0,8,70,78
2012-12-09,1,Dec,3,0,Sun,0,14,34,48
2012-12-09,1,Dec,4,0,Sun,0,1,11,12
2012-12-09,1,Dec,5,0,Sun,0,0,8,8
2012-12-09,1,Dec,6,0,Sun,0,0,6,6
2012-12-09,1,Dec,7,0,Sun,0,1,22,23
2012-12-09,1,Dec,8,0,Sun,0,1,68,69
2012-12-09,1,Dec,9,0,Sun,0,9,94,103
2012-12-09,1,Dec,10,0,Sun,0,39,180,219
2012-12-09,1,Dec,11,0,Sun,0,40,210,250
2012-12-09,1,Dec,12,0,Sun,0,60,255,315
2012-12-09,1,Dec,13,0,Sun,0,65,220,285
2012-12-09,1,Dec,14,0,Sun,0,42,190,232
2012-12-09,1,Dec,15,0,Sun,0,25,200,225
2012-12-09,1,Dec,16,0,Sun,0,33,220,253
2012-12-09,1,Dec,17,0,Sun,0,20,209,229
2012-12-09,1,Dec,18,0,Sun,0,17,181,198
2012-12-09,1,Dec,19,0,Sun,0,12,110,122
2012-12-09,1,Dec,20,0,Sun,0,6,102,108
2012-12-09,1,Dec,21,0,Sun,0,10,86,96
2012-12-09,1,Dec,22,0,Sun,0,3,75,78
2012-12-09,1,Dec,23,0,Sun,0,3,48,51
2012-12-10,1,Dec,0,0,Mon,1,0,20,20
2012-12-10,1,Dec,1,0,Mon,1,0,4,4
2012-12-10,1,Dec,2,0,Mon,1,2,3,5
2012-12-10,1,Dec,3,0,Mon,1,0,4,4
2012-12-10,1,Dec,4,0,Mon,1,3,9,12
2012-12-10,1,Dec,5,0,Mon,1,0,27,27
2012-12-10,1,Dec,6,0,Mon,1,2,121,123
2012-12-10,1,Dec,7,0,Mon,1,3,291,294
2012-12-10,1,Dec,8,0,Mon,1,9,575,584
2012-12-10,1,Dec,9,0,Mon,1,11,273,284
2012-12-10,1,Dec,10,0,Mon,1,12,121,133
2012-12-10,1,Dec,11,0,Mon,1,8,126,134
2012-12-10,1,Dec,12,0,Mon,1,23,150,173
2012-12-10,1,Dec,13,0,Mon,1,30,190,220
2012-12-10,1,Dec,14,0,Mon,1,31,179,210
2012-12-10,1,Dec,15,0,Mon,1,29,207,236
2012-12-10,1,Dec,16,0,Mon,1,37,308,345
2012-12-10,1,Dec,17,0,Mon,1,38,578,616
2012-12-10,1,Dec,18,0,Mon,1,20,544,564
2012-12-10,1,Dec,19,0,Mon,1,18,409,427
2012-12-10,1,Dec,20,0,Mon,1,13,287,300
2012-12-10,1,Dec,21,0,Mon,1,21,224,245
2012-12-10,1,Dec,22,0,Mon,1,11,115,126
2012-12-10,1,Dec,23,0,Mon,1,8,76,84
2012-12-11,1,Dec,0,0,Tue,1,2,29,31
2012-12-11,1,Dec,1,0,Tue,1,1,7,8
2012-12-11,1,Dec,2,0,Tue,1,0,1,1
2012-12-11,1,Dec,3,0,Tue,1,0,3,3
2012-12-11,1,Dec,4,0,Tue,1,0,8,8
2012-12-11,1,Dec,5,0,Tue,1,1,40,41
2012-12-11,1,Dec,6,0,Tue,1,0,118,118
2012-12-11,1,Dec,7,0,Tue,1,8,372,380
2012-12-11,1,Dec,8,0,Tue,1,16,708,724
2012-12-11,1,Dec,9,0,Tue,1,12,322,334
2012-12-11,1,Dec,10,0,Tue,1,12,142,154
2012-12-11,1,Dec,11,0,Tue,1,28,145,173
2012-12-11,1,Dec,12,0,Tue,1,13,213,226
2012-12-11,1,Dec,13,0,Tue,1,28,226,254
2012-12-11,1,Dec,14,0,Tue,1,19,185,204
2012-12-11,1,Dec,15,0,Tue,1,20,250,270
2012-12-11,1,Dec,16,0,Tue,1,24,334,358
2012-12-11,1,Dec,17,0,Tue,1,21,580,601
2012-12-11,1,Dec,18,0,Tue,1,23,523,546
2012-12-11,1,Dec,19,0,Tue,1,21,412,433
2012-12-11,1,Dec,20,0,Tue,1,9,248,257
2012-12-11,1,Dec,21,0,Tue,1,14,193,207
2012-12-11,1,Dec,22,0,Tue,1,6,100,106
2012-12-11,1,Dec,23,0,Tue,1,4,60,64
2012-12-12,1,Dec,0,0,Wed,1,1,33,34
2012-12-12,1,Dec,1,0,Wed,1,3,18,21
2012-12-12,1,Dec,2,0,Wed,1,5,4,9
2012-12-12,1,Dec,3,0,Wed,1,3,7,10
2012-12-12,1,Dec,4,0,Wed,1,0,4,4
2012-12-12,1,Dec,5,0,Wed,1,0,37,37
2012-12-12,1,Dec,6,0,Wed,1,2,126,128
2012-12-12,1,Dec,7,0,Wed,1,3,366,369
2012-12-12,1,Dec,8,0,Wed,1,18,670,688
2012-12-12,1,Dec,9,0,Wed,1,13,272,285
2012-12-12,1,Dec,10,0,Wed,1,20,116,136
2012-12-12,1,Dec,11,0,Wed,1,24,148,172
2012-12-12,1,Dec,12,0,Wed,1,14,218,232
2012-12-12,1,Dec,13,0,Wed,1,18,220,238
2012-12-12,1,Dec,14,0,Wed,1,34,191,225
2012-12-12,1,Dec,15,0,Wed,1,21,207,228
2012-12-12,1,Dec,16,0,Wed,1,19,310,329
2012-12-12,1,Dec,17,0,Wed,1,21,540,561
2012-12-12,1,Dec,18,0,Wed,1,25,515,540
2012-12-12,1,Dec,19,0,Wed,1,18,384,402
2012-12-12,1,Dec,20,0,Wed,1,25,243,268
2012-12-12,1,Dec,21,0,Wed,1,16,186,202
2012-12-12,1,Dec,22,0,Wed,1,4,118,122
2012-12-12,1,Dec,23,0,Wed,1,3,76,79
2012-12-13,1,Dec,0,0,Thur,1,1,31,32
2012-12-13,1,Dec,1,0,Thur,1,4,19,23
2012-12-13,1,Dec,2,0,Thur,1,3,5,8
2012-12-13,1,Dec,3,0,Thur,1,0,2,2
2012-12-13,1,Dec,4,0,Thur,1,0,8,8
2012-12-13,1,Dec,5,0,Thur,1,2,31,33
2012-12-13,1,Dec,6,0,Thur,1,2,112,114
2012-12-13,1,Dec,7,0,Thur,1,5,380,385
2012-12-13,1,Dec,8,0,Thur,1,24,655,679
2012-12-13,1,Dec,9,0,Thur,1,25,300,325
2012-12-13,1,Dec,10,0,Thur,1,28,139,167
2012-12-13,1,Dec,11,0,Thur,1,25,164,189
2012-12-13,1,Dec,12,0,Thur,1,30,252,282
2012-12-13,1,Dec,13,0,Thur,1,41,230,271
2012-12-13,1,Dec,14,0,Thur,1,31,211,242
2012-12-13,1,Dec,15,0,Thur,1,40,240,280
2012-12-13,1,Dec,16,0,Thur,1,50,356,406
2012-12-13,1,Dec,17,0,Thur,1,43,507,550
2012-12-13,1,Dec,18,0,Thur,1,20,446,466
2012-12-13,1,Dec,19,0,Thur,1,20,328,348
2012-12-13,1,Dec,20,0,Thur,1,6,235,241
2012-12-13,1,Dec,21,0,Thur,1,13,200,213
2012-12-13,1,Dec,22,0,Thur,1,7,141,148
2012-12-13,1,Dec,23,0,Thur,1,5,115,120
2012-12-14,1,Dec,0,0,Fri,1,4,43,47
2012-12-14,1,Dec,1,0,Fri,1,0,26,26
2012-12-14,1,Dec,2,0,Fri,1,3,6,9
2012-12-14,1,Dec,3,0,Fri,1,0,12,12
2012-12-14,1,Dec,4,0,Fri,1,1,9,10
2012-12-14,1,Dec,5,0,Fri,1,0,34,34
2012-12-14,1,Dec,6,0,Fri,1,1,112,113
2012-12-14,1,Dec,7,0,Fri,1,3,305,308
2012-12-14,1,Dec,8,0,Fri,1,13,623,636
2012-12-14,1,Dec,9,0,Fri,1,13,330,343
2012-12-14,1,Dec,10,0,Fri,1,28,162,190
2012-12-14,1,Dec,11,0,Fri,1,31,180,211
2012-12-14,1,Dec,12,0,Fri,1,29,244,273
2012-12-14,1,Dec,13,0,Fri,1,39,274,313
2012-12-14,1,Dec,14,0,Fri,1,48,251,299
2012-12-14,1,Dec,15,0,Fri,1,57,252,309
2012-12-14,1,Dec,16,0,Fri,1,45,372,417
2012-12-14,1,Dec,17,0,Fri,1,40,582,622
2012-12-14,1,Dec,18,0,Fri,1,23,432,455
2012-12-14,1,Dec,19,0,Fri,1,17,302,319
2012-12-14,1,Dec,20,0,Fri,1,12,209,221
2012-12-14,1,Dec,21,0,Fri,1,7,165,172
2012-12-14,1,Dec,22,0,Fri,1,4,134,138
2012-12-14,1,Dec,23,0,Fri,1,11,123,134
2012-12-15,1,Dec,0,0,Sat,0,4,90,94
2012-12-15,1,Dec,1,0,Sat,0,9,86,95
2012-12-15,1,Dec,2,0,Sat,0,6,63,69
2012-12-15,1,Dec,3,0,Sat,0,5,18,23
2012-12-15,1,Dec,4,0,Sat,0,1,5,6
2012-12-15,1,Dec,5,0,Sat,0,0,3,3
2012-12-15,1,Dec,6,0,Sat,0,0,11,11
2012-12-15,1,Dec,7,0,Sat,0,1,47,48
2012-12-15,1,Dec,8,0,Sat,0,8,111,119
2012-12-15,1,Dec,9,0,Sat,0,17,203,220
2012-12-15,1,Dec,10,0,Sat,0,23,250,273
2012-12-15,1,Dec,11,0,Sat,0,66,327,393
2012-12-15,1,Dec,12,0,Sat,0,89,364,453
2012-12-15,1,Dec,13,0,Sat,0,88,368,456
2012-12-15,1,Dec,14,0,Sat,0,92,334,426
2012-12-15,1,Dec,15,0,Sat,0,95,352,447
2012-12-15,1,Dec,16,0,Sat,0,85,328,413
2012-12-15,1,Dec,17,0,Sat,0,35,274,309
2012-12-15,1,Dec,18,0,Sat,0,40,232,272
2012-12-15,1,Dec,19,0,Sat,0,32,225,257
2012-12-15,1,Dec,20,0,Sat,0,23,178,201
2012-12-15,1,Dec,21,0,Sat,0,15,169,184
2012-12-15,1,Dec,22,0,Sat,0,22,134,156
2012-12-15,1,Dec,23,0,Sat,0,11,108,119
2012-12-16,1,Dec,0,0,Sun,0,8,102,110
2012-12-16,1,Dec,1,0,Sun,0,14,82,96
2012-12-16,1,Dec,2,0,Sun,0,8,79,87
2012-12-16,1,Dec,3,0,Sun,0,1,37,38
2012-12-16,1,Dec,4,0,Sun,0,1,10,11
2012-12-16,1,Dec,5,0,Sun,0,0,9,9
2012-12-16,1,Dec,6,0,Sun,0,0,6,6
2012-12-16,1,Dec,7,0,Sun,0,5,22,27
2012-12-16,1,Dec,8,0,Sun,0,12,76,88
2012-12-16,1,Dec,9,0,Sun,0,19,113,132
2012-12-16,1,Dec,10,0,Sun,0,42,215,257
2012-12-16,1,Dec,11,0,Sun,0,47,248,295
2012-12-16,1,Dec,12,0,Sun,0,67,350,417
2012-12-16,1,Dec,13,0,Sun,0,67,289,356
2012-12-16,1,Dec,14,0,Sun,0,50,260,310
2012-12-16,1,Dec,15,0,Sun,0,46,292,338
2012-12-16,1,Dec,16,0,Sun,0,66,334,400
2012-12-16,1,Dec,17,0,Sun,0,29,214,243
2012-12-16,1,Dec,18,0,Sun,0,8,99,107
2012-12-16,1,Dec,19,0,Sun,0,10,99,109
2012-12-16,1,Dec,20,0,Sun,0,14,108,122
2012-12-16,1,Dec,21,0,Sun,0,14,92,106
2012-12-16,1,Dec,22,0,Sun,0,6,83,89
2012-12-16,1,Dec,23,0,Sun,0,4,29,33
2012-12-17,1,Dec,0,0,Mon,1,2,26,28
2012-12-17,1,Dec,1,0,Mon,1,1,14,15
2012-12-17,1,Dec,2,0,Mon,1,1,4,5
2012-12-17,1,Dec,3,0,Mon,1,0,3,3
2012-12-17,1,Dec,4,0,Mon,1,2,3,5
2012-12-17,1,Dec,5,0,Mon,1,0,24,24
2012-12-17,1,Dec,6,0,Mon,1,1,107,108
2012-12-17,1,Dec,7,0,Mon,1,5,314,319
2012-12-17,1,Dec,8,0,Mon,1,10,582,592
2012-12-17,1,Dec,9,0,Mon,1,11,271,282
2012-12-17,1,Dec,10,0,Mon,1,15,120,135
2012-12-17,1,Dec,11,0,Mon,1,22,148,170
2012-12-17,1,Dec,12,0,Mon,1,21,211,232
2012-12-17,1,Dec,13,0,Mon,1,16,194,210
2012-12-17,1,Dec,14,0,Mon,1,12,169,181
2012-12-17,1,Dec,15,0,Mon,1,15,196,211
2012-12-17,1,Dec,16,0,Mon,1,15,287,302
2012-12-17,1,Dec,17,0,Mon,1,17,478,495
2012-12-17,1,Dec,18,0,Mon,1,14,493,507
2012-12-17,1,Dec,19,0,Mon,1,7,333,340
2012-12-17,1,Dec,20,0,Mon,1,8,192,200
2012-12-17,1,Dec,21,0,Mon,1,6,114,120
2012-12-17,1,Dec,22,0,Mon,1,5,49,54
2012-12-17,1,Dec,23,0,Mon,1,6,41,47
2012-12-18,1,Dec,0,0,Tue,1,0,18,18
2012-12-18,1,Dec,1,0,Tue,1,0,15,15
2012-12-18,1,Dec,2,0,Tue,1,2,5,7
2012-12-18,1,Dec,3,0,Tue,1,0,5,5
2012-12-18,1,Dec,4,0,Tue,1,3,5,8
2012-12-18,1,Dec,5,0,Tue,1,0,36,36
2012-12-18,1,Dec,6,0,Tue,1,1,117,118
2012-12-18,1,Dec,7,0,Tue,1,4,351,355
2012-12-18,1,Dec,8,0,Tue,1,10,652,662
2012-12-18,1,Dec,9,0,Tue,1,19,307,326
2012-12-18,1,Dec,10,0,Tue,1,22,162,184
2012-12-18,1,Dec,11,0,Tue,1,58,211,269
2012-12-18,1,Dec,12,0,Tue,1,49,264,313
2012-12-18,1,Dec,13,0,Tue,1,51,235,286
2012-12-18,1,Dec,14,0,Tue,1,56,191,247
2012-12-18,1,Dec,15,0,Tue,1,28,218,246
2012-12-18,1,Dec,16,0,Tue,1,40,323,363
2012-12-18,1,Dec,17,0,Tue,1,39,533,572
2012-12-18,1,Dec,18,0,Tue,1,13,512,525
2012-12-18,1,Dec,19,0,Tue,1,19,334,353
2012-12-18,1,Dec,20,0,Tue,1,4,264,268
2012-12-18,1,Dec,21,0,Tue,1,9,159,168
2012-12-18,1,Dec,22,0,Tue,1,5,127,132
2012-12-18,1,Dec,23,0,Tue,1,1,80,81
2012-12-19,1,Dec,0,0,Wed,1,6,35,41
2012-12-19,1,Dec,1,0,Wed,1,1,14,15
2012-12-19,1,Dec,2,0,Wed,1,1,2,3
2012-12-19,1,Dec,3,0,Wed,1,0,5,5
2012-12-19,1,Dec,4,0,Wed,1,1,6,7
2012-12-19,1,Dec,5,0,Wed,1,2,29,31
2012-12-19,1,Dec,6,0,Wed,1,3,109,112
2012-12-19,1,Dec,7,0,Wed,1,3,360,363
2012-12-19,1,Dec,8,0,Wed,1,13,665,678
2012-12-19,1,Dec,9,0,Wed,1,8,309,317
2012-12-19,1,Dec,10,0,Wed,1,17,147,164
2012-12-19,1,Dec,11,0,Wed,1,31,169,200
2012-12-19,1,Dec,12,0,Wed,1,33,203,236
2012-12-19,1,Dec,13,0,Wed,1,30,183,213
2012-12-19,1,Dec,14,0,Wed,1,33,185,218
2012-12-19,1,Dec,15,0,Wed,1,28,209,237
2012-12-19,1,Dec,16,0,Wed,1,37,297,334
2012-12-19,1,Dec,17,0,Wed,1,26,536,562
2012-12-19,1,Dec,18,0,Wed,1,23,546,569
2012-12-19,1,Dec,19,0,Wed,1,7,329,336
2012-12-19,1,Dec,20,0,Wed,1,10,231,241
2012-12-19,1,Dec,21,0,Wed,1,4,164,168
2012-12-19,1,Dec,22,0,Wed,1,12,117,129
2012-12-19,1,Dec,23,0,Wed,1,4,84,88
2012-12-20,1,Dec,0,0,Thur,1,2,40,42
2012-12-20,1,Dec,1,0,Thur,1,1,19,20
2012-12-20,1,Dec,2,0,Thur,1,2,6,8
2012-12-20,1,Dec,3,0,Thur,1,1,3,4
2012-12-20,1,Dec,4,0,Thur,1,0,6,6
2012-12-20,1,Dec,5,0,Thur,1,0,35,35
2012-12-20,1,Dec,6,0,Thur,1,4,114,118
2012-12-20,1,Dec,7,0,Thur,1,4,346,350
2012-12-20,1,Dec,8,0,Thur,1,14,585,599
2012-12-20,1,Dec,9,0,Thur,1,14,303,317
2012-12-20,1,Dec,10,0,Thur,1,23,138,161
2012-12-20,1,Dec,11,0,Thur,1,22,168,190
2012-12-20,1,Dec,12,0,Thur,1,31,181,212
2012-12-20,1,Dec,13,0,Thur,1,46,171,217
2012-12-20,1,Dec,14,0,Thur,1,43,171,214
2012-12-20,1,Dec,15,0,Thur,1,33,216,249
2012-12-20,1,Dec,16,0,Thur,1,21,281,302
2012-12-20,1,Dec,17,0,Thur,1,25,450,475
2012-12-20,1,Dec,18,0,Thur,1,22,359,381
2012-12-20,1,Dec,19,0,Thur,1,3,115,118
2012-12-20,1,Dec,20,0,Thur,1,1,49,50
2012-12-20,1,Dec,21,0,Thur,1,1,25,26
2012-12-20,1,Dec,22,0,Thur,1,1,20,21
2012-12-20,1,Dec,23,0,Thur,1,0,13,13
2012-12-21,1,Dec,0,0,Fri,1,0,17,17
2012-12-21,1,Dec,1,0,Fri,1,2,7,9
2012-12-21,1,Dec,2,0,Fri,1,0,3,3
2012-12-21,1,Dec,3,0,Fri,1,0,3,3
2012-12-21,1,Dec,4,0,Fri,1,1,5,6
2012-12-21,1,Dec,5,0,Fri,1,0,13,13
2012-12-21,1,Dec,6,0,Fri,1,4,76,80
2012-12-21,1,Dec,7,0,Fri,1,3,205,208
2012-12-21,1,Dec,8,0,Fri,1,8,464,472
2012-12-21,1,Dec,9,0,Fri,1,2,265,267
2012-12-21,1,Dec,10,0,Fri,1,8,146,154
2012-12-21,1,Dec,11,0,Fri,1,12,150,162
2012-12-21,1,Dec,12,0,Fri,1,25,199,224
2012-12-21,1,Dec,13,0,Fri,1,26,214,240
2012-12-21,1,Dec,14,0,Fri,1,20,199,219
2012-12-21,1,Dec,15,0,Fri,1,29,234,263
2012-12-21,1,Dec,16,0,Fri,1,28,253,281
2012-12-21,1,Dec,17,0,Fri,1,24,297,321
2012-12-21,1,Dec,18,0,Fri,1,7,236,243
2012-12-21,1,Dec,19,0,Fri,1,5,148,153
2012-12-21,1,Dec,20,0,Fri,1,8,104,112
2012-12-21,1,Dec,21,0,Fri,1,2,68,70
2012-12-21,1,Dec,22,0,Fri,1,6,57,63
2012-12-21,1,Dec,23,0,Fri,1,1,39,40
2012-12-22,1,Dec,0,0,Sat,0,1,30,31
2012-12-22,1,Dec,1,0,Sat,0,1,34,35
2012-12-22,1,Dec,2,0,Sat,0,0,23,23
2012-12-22,1,Dec,3,0,Sat,0,0,7,7
2012-12-22,1,Dec,4,0,Sat,0,3,2,5
2012-12-22,1,Dec,5,0,Sat,0,0,5,5
2012-12-22,1,Dec,6,0,Sat,0,0,13,13
2012-12-22,1,Dec,7,0,Sat,0,2,18,20
2012-12-22,1,Dec,8,0,Sat,0,0,29,29
2012-12-22,1,Dec,9,0,Sat,0,13,77,90
2012-12-22,1,Dec,10,0,Sat,0,13,105,118
2012-12-22,1,Dec,11,0,Sat,0,29,130,159
2012-12-22,1,Dec,12,0,Sat,0,18,128,146
2012-12-22,1,Dec,13,0,Sat,0,23,135,158
2012-12-22,1,Dec,14,0,Sat,0,20,141,161
2012-12-22,1,Dec,15,0,Sat,0,14,139,153
2012-12-22,1,Dec,16,0,Sat,0,23,124,147
2012-12-22,1,Dec,17,0,Sat,0,15,99,114
2012-12-22,1,Dec,18,0,Sat,0,7,75,82
2012-12-22,1,Dec,19,0,Sat,0,9,51,60
2012-12-22,1,Dec,20,0,Sat,0,6,55,61
2012-12-22,1,Dec,21,0,Sat,0,4,49,53
2012-12-22,1,Dec,22,0,Sat,0,1,38,39
2012-12-22,1,Dec,23,0,Sat,0,3,37,40
2012-12-23,1,Dec,0,0,Sun,0,3,24,27
2012-12-23,1,Dec,1,0,Sun,0,1,19,20
2012-12-23,1,Dec,2,0,Sun,0,1,17,18
2012-12-23,1,Dec,3,0,Sun,0,0,9,9
2012-12-23,1,Dec,4,0,Sun,0,1,3,4
2012-12-23,1,Dec,5,0,Sun,0,0,6,6
2012-12-23,1,Dec,6,0,Sun,0,4,5,9
2012-12-23,1,Dec,7,0,Sun,0,3,16,19
2012-12-23,1,Dec,8,0,Sun,0,5,43,48
2012-12-23,1,Dec,9,0,Sun,0,7,49,56
2012-12-23,1,Dec,10,0,Sun,0,26,67,93
2012-12-23,1,Dec,11,0,Sun,0,48,104,152
2012-12-23,1,Dec,12,0,Sun,0,52,144,196
2012-12-23,1,Dec,13,0,Sun,0,63,123,186
2012-12-23,1,Dec,14,0,Sun,0,57,118,175
2012-12-23,1,Dec,15,0,Sun,0,39,98,137
2012-12-23,1,Dec,16,0,Sun,0,53,137,190
2012-12-23,1,Dec,17,0,Sun,0,21,93,114
2012-12-23,1,Dec,18,0,Sun,0,8,85,93
2012-12-23,1,Dec,19,0,Sun,0,4,54,58
2012-12-23,1,Dec,20,0,Sun,0,0,52,52
2012-12-23,1,Dec,21,0,Sun,0,4,38,42
2012-12-23,1,Dec,22,0,Sun,0,5,53,58
2012-12-23,1,Dec,23,0,Sun,0,3,22,25
2012-12-24,1,Dec,0,0,Mon,1,0,12,12
2012-12-24,1,Dec,1,0,Mon,1,0,11,11
2012-12-24,1,Dec,2,0,Mon,1,0,5,5
2012-12-24,1,Dec,3,0,Mon,1,1,2,3
2012-12-24,1,Dec,5,0,Mon,1,0,9,9
2012-12-24,1,Dec,6,0,Mon,1,1,16,17
2012-12-24,1,Dec,7,0,Mon,1,3,27,30
2012-12-24,1,Dec,8,0,Mon,1,4,62,66
2012-12-24,1,Dec,9,0,Mon,1,17,68,85
2012-12-24,1,Dec,10,0,Mon,1,21,82,103
2012-12-24,1,Dec,11,0,Mon,1,20,104,124
2012-12-24,1,Dec,12,0,Mon,1,22,113,135
2012-12-24,1,Dec,13,0,Mon,1,16,54,70
2012-12-24,1,Dec,14,0,Mon,1,13,33,46
2012-12-24,1,Dec,15,0,Mon,1,6,27,33
2012-12-24,1,Dec,16,0,Mon,1,6,27,33
2012-12-24,1,Dec,17,0,Mon,1,7,19,26
2012-12-24,1,Dec,18,0,Mon,1,6,20,26
2012-12-24,1,Dec,19,0,Mon,1,4,14,18
2012-12-24,1,Dec,20,0,Mon,1,6,17,23
2012-12-24,1,Dec,21,0,Mon,1,13,9,22
2012-12-24,1,Dec,22,0,Mon,1,7,5,12
2012-12-24,1,Dec,23,0,Mon,1,1,10,11
2012-12-25,1,Dec,0,1,Tue,0,3,10,13
2012-12-25,1,Dec,1,1,Tue,0,0,13,13
2012-12-25,1,Dec,2,1,Tue,0,0,7,7
2012-12-25,1,Dec,4,1,Tue,0,0,1,1
2012-12-25,1,Dec,5,1,Tue,0,2,1,3
2012-12-25,1,Dec,6,1,Tue,0,1,6,7
2012-12-25,1,Dec,7,1,Tue,0,0,6,6
2012-12-25,1,Dec,8,1,Tue,0,1,10,11
2012-12-25,1,Dec,9,1,Tue,0,7,21,28
2012-12-25,1,Dec,10,1,Tue,0,11,21,32
2012-12-25,1,Dec,11,1,Tue,0,43,43,86
2012-12-25,1,Dec,12,1,Tue,0,62,52,114
2012-12-25,1,Dec,13,1,Tue,0,75,46,121
2012-12-25,1,Dec,14,1,Tue,0,58,68,126
2012-12-25,1,Dec,15,1,Tue,0,51,56,107
2012-12-25,1,Dec,16,1,Tue,0,48,38,86
2012-12-25,1,Dec,17,1,Tue,0,16,34,50
2012-12-25,1,Dec,18,1,Tue,0,20,23,43
2012-12-25,1,Dec,19,1,Tue,0,16,20,36
2012-12-25,1,Dec,20,1,Tue,0,11,29,40
2012-12-25,1,Dec,21,1,Tue,0,8,26,34
2012-12-25,1,Dec,22,1,Tue,0,3,16,19
2012-12-25,1,Dec,23,1,Tue,0,4,26,30
2012-12-26,1,Dec,0,0,Wed,1,1,8,9
2012-12-26,1,Dec,1,0,Wed,1,0,7,7
2012-12-26,1,Dec,2,0,Wed,1,0,1,1
2012-12-26,1,Dec,3,0,Wed,1,0,2,2
2012-12-26,1,Dec,4,0,Wed,1,0,2,2
2012-12-26,1,Dec,5,0,Wed,1,0,11,11
2012-12-26,1,Dec,6,0,Wed,1,0,36,36
2012-12-26,1,Dec,7,0,Wed,1,0,26,26
2012-12-26,1,Dec,8,0,Wed,1,0,31,31
2012-12-26,1,Dec,9,0,Wed,1,1,22,23
2012-12-26,1,Dec,10,0,Wed,1,0,8,8
2012-12-26,1,Dec,11,0,Wed,1,0,10,10
2012-12-26,1,Dec,12,0,Wed,1,0,10,10
2012-12-26,1,Dec,13,0,Wed,1,0,15,15
2012-12-26,1,Dec,14,0,Wed,1,0,20,20
2012-12-26,1,Dec,15,0,Wed,1,0,13,13
2012-12-26,1,Dec,16,0,Wed,1,0,13,13
2012-12-26,1,Dec,17,0,Wed,1,2,51,53
2012-12-26,1,Dec,18,0,Wed,1,1,42,43
2012-12-26,1,Dec,19,0,Wed,1,2,33,35
2012-12-26,1,Dec,20,0,Wed,1,0,32,32
2012-12-26,1,Dec,21,0,Wed,1,0,20,20
2012-12-26,1,Dec,22,0,Wed,1,0,11,11
2012-12-26,1,Dec,23,0,Wed,1,2,8,10
2012-12-27,1,Dec,0,0,Thur,1,0,3,3
2012-12-27,1,Dec,1,0,Thur,1,0,5,5
2012-12-27,1,Dec,2,0,Thur,1,0,2,2
2012-12-27,1,Dec,3,0,Thur,1,0,1,1
2012-12-27,1,Dec,4,0,Thur,1,0,3,3
2012-12-27,1,Dec,5,0,Thur,1,1,10,11
2012-12-27,1,Dec,6,0,Thur,1,0,45,45
2012-12-27,1,Dec,7,0,Thur,1,0,90,90
2012-12-27,1,Dec,8,0,Thur,1,2,206,208
2012-12-27,1,Dec,9,0,Thur,1,6,127,133
2012-12-27,1,Dec,10,0,Thur,1,8,67,75
2012-12-27,1,Dec,11,0,Thur,1,23,80,103
2012-12-27,1,Dec,12,0,Thur,1,22,87,109
2012-12-27,1,Dec,13,0,Thur,1,19,99,118
2012-12-27,1,Dec,14,0,Thur,1,25,94,119
2012-12-27,1,Dec,15,0,Thur,1,31,89,120
2012-12-27,1,Dec,16,0,Thur,1,23,151,174
2012-12-27,1,Dec,17,0,Thur,1,30,227,257
2012-12-27,1,Dec,18,0,Thur,1,9,188,197
2012-12-27,1,Dec,19,0,Thur,1,11,106,117
2012-12-27,1,Dec,20,0,Thur,1,12,79,91
2012-12-27,1,Dec,21,0,Thur,1,12,51,63
2012-12-27,1,Dec,22,0,Thur,1,11,33,44
2012-12-27,1,Dec,23,0,Thur,1,2,24,26
2012-12-28,1,Dec,0,0,Fri,1,3,22,25
2012-12-28,1,Dec,1,0,Fri,1,0,9,9
2012-12-28,1,Dec,2,0,Fri,1,0,5,5
2012-12-28,1,Dec,3,0,Fri,1,0,2,2
2012-12-28,1,Dec,4,0,Fri,1,0,4,4
2012-12-28,1,Dec,5,0,Fri,1,0,15,15
2012-12-28,1,Dec,6,0,Fri,1,2,49,51
2012-12-28,1,Dec,7,0,Fri,1,1,111,112
2012-12-28,1,Dec,8,0,Fri,1,1,238,239
2012-12-28,1,Dec,9,0,Fri,1,18,173,191
2012-12-28,1,Dec,10,0,Fri,1,77,85,162
2012-12-28,1,Dec,11,0,Fri,1,71,107,178
2012-12-28,1,Dec,12,0,Fri,1,72,150,222
2012-12-28,1,Dec,13,0,Fri,1,76,146,222
2012-12-28,1,Dec,14,0,Fri,1,84,177,261
2012-12-28,1,Dec,15,0,Fri,1,74,151,225
2012-12-28,1,Dec,16,0,Fri,1,42,208,250
2012-12-28,1,Dec,17,0,Fri,1,43,228,271
2012-12-28,1,Dec,18,0,Fri,1,16,197,213
2012-12-28,1,Dec,19,0,Fri,1,15,113,128
2012-12-28,1,Dec,20,0,Fri,1,14,83,97
2012-12-28,1,Dec,21,0,Fri,1,17,75,92
2012-12-28,1,Dec,22,0,Fri,1,13,49,62
2012-12-28,1,Dec,23,0,Fri,1,5,54,59
2012-12-29,1,Dec,0,0,Sat,0,1,25,26
2012-12-29,1,Dec,1,0,Sat,0,6,31,37
2012-12-29,1,Dec,2,0,Sat,0,1,18,19
2012-12-29,1,Dec,3,0,Sat,0,1,5,6
2012-12-29,1,Dec,4,0,Sat,0,0,3,3
2012-12-29,1,Dec,5,0,Sat,0,0,3,3
2012-12-29,1,Dec,6,0,Sat,0,0,7,7
2012-12-29,1,Dec,7,0,Sat,0,1,17,18
2012-12-29,1,Dec,8,0,Sat,0,9,35,44
2012-12-29,1,Dec,9,0,Sat,0,16,33,49
2012-12-29,1,Dec,10,0,Sat,0,6,35,41
2012-12-29,1,Dec,11,0,Sat,0,7,38,45
2012-12-29,1,Dec,12,0,Sat,0,5,43,48
2012-12-29,1,Dec,13,0,Sat,0,13,71,84
2012-12-29,1,Dec,14,0,Sat,0,10,88,98
2012-12-29,1,Dec,15,0,Sat,0,19,110,129
2012-12-29,1,Dec,16,0,Sat,0,22,125,147
2012-12-29,1,Dec,17,0,Sat,0,18,100,118
2012-12-29,1,Dec,18,0,Sat,0,8,102,110
2012-12-29,1,Dec,19,0,Sat,0,7,90,97
2012-12-29,1,Dec,20,0,Sat,0,2,64,66
2012-12-29,1,Dec,21,0,Sat,0,4,56,60
2012-12-29,1,Dec,22,0,Sat,0,3,51,54
2012-12-29,1,Dec,23,0,Sat,0,0,32,32
2012-12-30,1,Dec,0,0,Sun,0,0,41,41
2012-12-30,1,Dec,1,0,Sun,0,1,27,28
2012-12-30,1,Dec,2,0,Sun,0,0,19,19
2012-12-30,1,Dec,3,0,Sun,0,1,14,15
2012-12-30,1,Dec,4,0,Sun,0,0,7,7
2012-12-30,1,Dec,5,0,Sun,0,0,2,2
2012-12-30,1,Dec,6,0,Sun,0,1,7,8
2012-12-30,1,Dec,7,0,Sun,0,0,13,13
2012-12-30,1,Dec,8,0,Sun,0,1,32,33
2012-12-30,1,Dec,9,0,Sun,0,9,65,74
2012-12-30,1,Dec,10,0,Sun,0,31,91,122
2012-12-30,1,Dec,11,0,Sun,0,33,103,136
2012-12-30,1,Dec,12,0,Sun,0,47,97,144
2012-12-30,1,Dec,13,0,Sun,0,49,120,169
2012-12-30,1,Dec,14,0,Sun,0,39,121,160
2012-12-30,1,Dec,15,0,Sun,0,37,101,138
2012-12-30,1,Dec,16,0,Sun,0,31,102,133
2012-12-30,1,Dec,17,0,Sun,0,26,97,123
2012-12-30,1,Dec,18,0,Sun,0,12,113,125
2012-12-30,1,Dec,19,0,Sun,0,16,86,102
2012-12-30,1,Dec,20,0,Sun,0,9,63,72
2012-12-30,1,Dec,21,0,Sun,0,5,42,47
2012-12-30,1,Dec,22,0,Sun,0,6,30,36
2012-12-30,1,Dec,23,0,Sun,0,10,39,49
2012-12-31,1,Dec,0,0,Mon,1,4,30,34
2012-12-31,1,Dec,1,0,Mon,1,6,13,19
2012-12-31,1,Dec,2,0,Mon,1,3,8,11
2012-12-31,1,Dec,3,0,Mon,1,0,1,1
2012-12-31,1,Dec,4,0,Mon,1,0,3,3
2012-12-31,1,Dec,5,0,Mon,1,0,9,9
2012-12-31,1,Dec,6,0,Mon,1,0,40,40
2012-12-31,1,Dec,7,0,Mon,1,2,83,85
2012-12-31,1,Dec,8,0,Mon,1,9,187,196
2012-12-31,1,Dec,9,0,Mon,1,13,144,157
2012-12-31,1,Dec,10,0,Mon,1,33,87,120
2012-12-31,1,Dec,11,0,Mon,1,43,114,157
2012-12-31,1,Dec,12,0,Mon,1,52,172,224
2012-12-31,1,Dec,13,0,Mon,1,38,165,203
2012-12-31,1,Dec,14,0,Mon,1,62,185,247
2012-12-31,1,Dec,15,0,Mon,1,69,246,315
2012-12-31,1,Dec,16,0,Mon,1,30,184,214
2012-12-31,1,Dec,17,0,Mon,1,14,150,164
2012-12-31,1,Dec,18,0,Mon,1,10,112,122
2012-12-31,1,Dec,19,0,Mon,1,11,108,119
2012-12-31,1,Dec,20,0,Mon,1,8,81,89
2012-12-31,1,Dec,21,0,Mon,1,7,83,90
2012-12-31,1,Dec,22,0,Mon,1,13,48,61
2012-12-31,1,Dec,23,0,Mon,1,12,37,49
